Rk,Player,From,To,School,Conf,G,MP,FG,FGA,2P,2PA,3P,3PA,FT,FTA,ORB,DRB,TRB,AST,STL,BLK,TOV,PF,PTS
1,Chris Clemons,2016,2019,Campbell,Big South,130,4433,1024,2307,580,1083,444,1224,733,860,63,524,587,335,213,47,324,265,3225
2,Doug McDermott,2011,2014,Creighton,Total,145,4569,1141,2075,867,1477,274,598,594,715,281,807,1088,194,34,14,321,265,3150
3,Mike Daum,2016,2019,South Dakota State,Summit,137,4038,1005,1994,734,1333,271,661,786,927,289,947,1236,179,78,84,299,337,3067
4,Tyler Haws,2010,2015,Brigham Young,Total,139,4427,917,1916,755,1489,162,427,724,820,177,416,593,257,138,28,244,230,2720
5,Jon Elmore,2016,2019,Marshall,CUSA,132,4767,793,1934,438,941,355,993,678,839,67,563,630,780,181,42,417,253,2619
6,Jimmer Fredette,2008,2011,Brigham Young,MWC,139,4119,838,1843,542,1091,296,752,627,711,75,292,367,515,167,12,350,172,2599
7,Andrew Goudelock,2008,2011,College of Charleston,Southern,140,4588,956,2092,560,1134,396,958,263,314,88,376,464,424,130,37,311,212,2571
8,Jordan Howard,2015,2018,Central Arkansas,Southland,124,4311,790,1823,404,889,386,934,558,643,43,364,407,320,104,4,298,146,2524
9,Tyler Hall,2016,2019,Montana State,Big Sky,126,4160,849,1895,418,818,431,1077,389,453,87,515,602,316,122,41,245,260,2518
10,Fletcher Magee,2016,2019,Wofford,Southern,134,4261,807,1766,298,597,509,1169,393,433,44,352,396,221,93,14,208,205,2516
11,Charles Jenkins,2008,2011,Hofstra,CAA,128,4592,847,1856,667,1385,180,471,639,788,130,421,551,489,213,71,385,317,2513
12,Garrison Mathews,2016,2019,Lipscomb,A-Sun,133,3738,754,1684,395,726,359,958,598,761,139,520,659,252,117,31,271,306,2465
13,D.J. Balentine,2013,2016,Evansville,MVC,139,4644,824,1910,561,1208,263,702,553,698,66,311,377,472,86,26,295,181,2464
14,Dallas Moore,2014,2017,North Florida,A-Sun,135,4463,904,1870,629,1165,275,705,354,463,91,328,419,551,123,12,302,159,2437
15,Kevin Foster,2009,2013,Santa Clara,WCC,133,4212,771,1975,340,791,431,1184,450,577,60,299,359,464,233,21,401,304,2423
16,Kyle Singler,2008,2011,Duke,ACC,148,4887,814,1879,547,1143,267,736,497,643,360,655,1015,293,168,107,316,387,2392
17,Chasson Randle,2012,2015,Stanford,Pac-12,144,4791,760,1775,456,988,304,787,551,684,75,396,471,354,167,11,324,385,2375
18,C.J. McCollum,2010,2013,Lehigh,Patriot,111,3657,767,1746,550,1170,217,576,610,739,167,529,696,304,228,51,267,195,2361
19,Nate Wolters,2010,2013,South Dakota State,Summit,127,4204,773,1716,615,1254,158,462,648,807,120,481,601,668,192,21,280,229,2352
20,Travis Bader,2011,2014,Oakland,Total,137,4705,703,1726,199,480,504,1246,441,502,60,317,377,171,106,14,150,349,2351
21,Alec Peters,2014,2017,Valparaiso,Horizon,134,4250,790,1623,501,929,289,694,479,566,264,732,996,204,102,38,248,283,2348
22,Shawn Long,2013,2016,Louisiana,Sun Belt,135,4017,871,1732,759,1404,112,328,488,722,463,984,1447,148,96,273,328,415,2342
23,Randy Culpepper,2008,2011,Texas-El Paso,CUSA,138,4283,782,1825,464,902,318,923,456,614,100,273,373,274,251,35,272,312,2338
24,Matt Morgan,2016,2019,Cornell,Ivy,114,3704,743,1581,409,696,334,885,513,615,42,442,484,296,125,34,296,217,2333
25,Andrew Rowsey,2014,2018,Total,Total,130,3976,693,1645,289,656,404,989,541,606,53,314,367,425,139,13,313,279,2331
26,Justin Wright-Foreman,2016,2019,Hofstra,CAA,125,3507,819,1694,542,976,277,718,412,508,44,323,367,258,83,19,212,201,2327
27,Juan'ya Green,2012,2016,Total,Total,134,5002,695,1752,449,1033,246,719,681,842,90,441,531,773,230,51,391,281,2317
28,Nick Mayo,2016,2019,Eastern Kentucky,OVC,124,4156,829,1612,695,1266,134,346,524,636,210,623,833,259,109,177,339,319,2316
29,Jared Brownridge,2014,2017,Santa Clara,WCC,129,4519,729,1723,344,767,385,956,470,560,43,321,364,322,112,18,208,258,2313
30,Antoine Mason,2011,2015,Total,Total,124,4282,727,1734,558,1191,169,543,685,941,128,334,462,192,140,16,288,314,2308
31,Trey Freeman,2012,2016,Total,Total,135,4619,858,1969,720,1597,138,372,450,554,69,439,508,541,163,13,266,260,2304
32,Joe Young,2012,2015,Total,Total,132,4333,778,1718,490,979,288,739,460,519,85,391,476,351,130,8,221,194,2304
33,Buddy Hield,2013,2016,Oklahoma,Big 12,132,4182,783,1748,434,854,349,894,376,450,209,452,661,254,168,38,285,259,2291
34,Tookie Brown,2016,2019,Georgia Southern,Sun Belt,129,4277,741,1598,542,1066,199,532,609,788,70,409,479,527,198,28,299,301,2290
35,Alex Young,2009,2012,IUPUI,Summit,131,4103,833,1816,631,1230,202,586,418,573,204,464,668,213,173,89,318,314,2286
36,LaceDarius Dunn,2008,2011,Baylor,Big 12,134,3961,724,1664,336,679,388,985,449,537,137,455,592,175,158,18,307,353,2285
37,Colt Ryan,2010,2013,Evansville,MVC,128,4379,708,1699,446,1043,262,656,601,697,85,406,491,406,183,20,295,321,2279
38,Jordan Davis,2016,2019,Northern Colorado,Big Sky,130,3988,819,1662,713,1327,106,335,526,765,106,480,586,499,156,52,417,359,2270
39,Trevon Bluiett,2015,2018,Xavier,Big East,142,4553,717,1662,398,831,319,831,508,648,156,606,762,307,112,26,255,324,2261
40,Malcolm Delaney,2008,2011,Virginia Tech,ACC,136,4692,635,1585,371,858,264,727,721,853,113,364,477,543,175,24,377,363,2255
41,Jonathan Stark,2014,2018,Total,Total,130,4621,749,1762,456,1007,293,755,440,547,50,329,379,578,154,15,333,255,2231
42,John Brown,2013,2016,High Point,Big South,119,3535,858,1550,857,1538,1,12,512,712,381,420,801,180,182,167,187,277,2229
43,Georges Niang,2013,2016,Iowa State,Big 12,138,4110,849,1697,661,1195,188,502,342,448,162,552,714,421,92,67,318,422,2228
44,Devon Saddler,2011,2014,Delaware,CAA,124,4449,748,1750,556,1181,192,569,534,713,108,423,531,336,101,28,368,270,2222
45,Talor Battle,2008,2011,Penn State,Big Ten,134,4799,722,1791,405,861,317,930,452,634,95,530,625,517,145,12,301,233,2213
46,John Holland,2008,2011,Boston University,AEC,129,4195,723,1667,468,949,255,718,511,633,219,506,725,154,200,41,249,324,2212
47,Orlando Johnson,2008,2012,Total,Total,124,3878,738,1615,516,1047,222,568,510,708,222,469,691,319,112,68,324,276,2208
48,QJ Peterson,2014,2017,Virginia Military Institute,Total,113,3681,715,1794,432,949,283,845,487,614,190,478,668,300,177,33,300,243,2200
49,Reggie Hamilton,2008,2012,Total,Summit,123,3852,687,1546,410,833,277,713,534,644,103,276,379,548,185,15,427,322,2185
50,Donald Sims,2008,2011,Appalachian State,Southern,130,4058,641,1477,283,594,358,883,545,611,42,304,346,346,132,14,291,179,2185
51,D'Angelo Harrison,2012,2015,St. John's (NY),Big East,125,4311,660,1686,396,943,264,743,594,732,137,445,582,253,158,46,231,362,2178
52,Marcus Thornton,2012,2015,William & Mary,CAA,127,4328,709,1649,384,840,325,809,435,551,39,285,324,308,92,31,324,190,2178
53,Anthony Ireland,2011,2014,Loyola Marymount,WCC,132,4633,736,1774,540,1206,196,568,504,633,160,357,517,557,200,11,363,282,2172
54,Tyler Nelson,2015,2018,Fairfield,MAAC,127,4308,681,1586,366,742,315,844,495,568,71,326,397,358,145,7,244,190,2172
55,Peyton Aldridge,2015,2018,Davidson,A-10,130,4540,775,1602,536,985,239,617,382,462,226,666,892,275,73,116,166,295,2171
56,Bogdan Bliznyuk,2015,2018,Eastern Washington,Big Sky,138,4265,776,1553,626,1156,150,397,467,556,169,662,831,414,126,55,355,364,2169
57,Kevin Anderson,2008,2011,Richmond,A-10,139,5041,769,1759,593,1246,176,513,453,583,94,312,406,410,217,24,307,262,2167
58,Marcus Foster,2014,2018,Total,Total,130,3901,784,1758,478,944,306,814,293,407,65,337,402,312,91,15,284,259,2167
59,Damon Lynn,2014,2017,NJIT,Total,118,4225,657,1769,223,544,434,1225,405,498,50,280,330,369,188,8,266,174,2153
60,Jeremy Hazell,2008,2011,Seton Hall,Big East,114,3684,701,1676,373,722,328,954,416,554,115,256,371,133,191,12,172,192,2146
61,Stan Okoye,2010,2013,Virginia Military Institute,Big South,123,3471,788,1590,659,1203,129,387,441,665,296,666,962,212,152,103,305,317,2146
62,Sean Kilpatrick,2011,2014,Cincinnati,Total,140,4315,707,1687,394,786,313,901,418,536,175,427,602,279,166,23,236,182,2145
63,Francis Alonso,2016,2019,North Carolina-Greensboro,Southern,140,4031,661,1541,265,564,396,977,426,489,53,240,293,326,120,15,309,310,2144
64,E'Twaun Moore,2008,2011,Purdue,Big Ten,140,4517,780,1774,537,1135,243,639,333,457,151,459,610,400,164,59,289,325,2136
65,Jacob Pullen,2008,2011,Kansas State,Big 12,135,3978,653,1600,354,772,299,828,527,684,69,253,322,455,210,9,355,274,2132
66,Jameel Warney,2013,2016,Stony Brook,AEC,135,4140,884,1482,884,1482,0,0,364,615,474,801,1275,220,105,275,184,277,2132
67,Ethan Happ,2016,2019,Wisconsin,Big Ten,139,4120,880,1618,879,1602,1,16,369,682,360,857,1217,423,217,154,353,382,2130
68,Torrey Craig,2011,2014,South Carolina Upstate,A-Sun,131,4061,747,1808,450,909,297,899,337,502,277,667,944,236,138,101,347,326,2128
69,James Daniel,2014,2018,Total,Total,125,3740,591,1613,301,761,290,852,656,803,67,188,255,314,182,12,379,252,2128
70,Nick Barbour,2009,2012,High Point,Big South,119,3525,660,1582,346,802,314,780,487,620,79,262,341,137,129,33,265,294,2121
71,Chavaughn Lewis,2012,2015,Marist,MAAC,123,4140,728,1756,608,1370,120,386,543,810,130,506,636,308,243,75,407,316,2119
72,Luke Harangody,2008,2010,Notre Dame,Big East,97,3111,803,1678,761,1550,42,128,469,605,303,722,1025,172,71,80,192,232,2117
73,Jon Davis,2016,2019,Charlotte,CUSA,121,4247,681,1567,481,992,200,575,551,691,66,371,437,547,124,37,415,207,2113
74,DeAndre Kane,2011,2014,Total,Total,132,4511,732,1694,578,1183,154,511,492,817,205,538,743,645,173,30,438,363,2110
75,D.J. Newbill,2011,2015,Total,Total,131,4542,727,1621,594,1226,133,395,518,715,243,438,681,340,131,29,342,348,2105
76,Andrew Nicholson,2009,2012,St. Bonaventure,A-10,123,3672,809,1407,780,1330,29,77,456,633,271,616,887,87,61,244,296,371,2103
77,Deonte Burton,2011,2014,Nevada,Total,130,4393,649,1479,465,933,184,546,620,826,54,320,374,515,169,53,280,307,2102
78,Seth Curry,2009,2013,Total,Total,141,4357,682,1582,357,757,325,825,412,498,84,314,398,290,173,27,225,249,2101
79,Keifer Sykes,2012,2015,Green Bay,Horizon,127,4236,713,1570,600,1224,113,346,557,712,82,385,467,522,155,11,286,284,2096
80,Alex Francis,2011,2014,Bryant,NEC,123,4141,791,1457,778,1404,13,53,490,815,320,670,990,172,109,52,457,315,2085
81,Dominique Morrison,2009,2012,Oral Roberts,Summit,129,4295,687,1476,524,1052,163,424,543,668,141,429,570,246,95,52,206,349,2080
82,Clifford Reed,2009,2013,Total,Total,133,4917,685,1869,476,1196,209,673,501,643,78,393,471,553,179,7,411,279,2080
83,Shane Gibson,2009,2013,Sacred Heart,NEC,121,3707,728,1562,442,871,286,691,337,395,105,352,457,203,156,52,330,291,2079
84,Jeremy Senglin,2014,2017,Weber State,Big Sky,124,4183,668,1444,323,621,345,823,397,545,38,361,399,345,110,11,269,255,2078
85,Keon Johnson,2014,2017,Winthrop,Big South,128,3940,632,1474,337,734,295,740,517,610,48,350,398,270,91,0,219,238,2076
86,D.J. Cooper,2010,2013,Ohio,MAC,143,4835,648,1707,374,856,274,851,505,681,153,467,620,934,327,29,447,254,2075
87,Ronshad Shabazz,2016,2019,Appalachian State,Sun Belt,126,3824,712,1737,443,973,269,764,374,517,86,320,406,273,104,8,268,212,2067
88,Drew McDonald,2016,2019,Northern Kentucky,Horizon,131,3652,717,1520,535,1024,182,496,450,586,265,816,1081,262,56,58,267,277,2066
89,John Konchar,2016,2019,Purdue-Fort Wayne,Summit,133,4675,759,1364,566,900,193,464,354,508,309,840,1149,553,272,78,247,272,2065
90,Wesley Person,2015,2018,Troy,Sun Belt,130,4382,642,1522,281,575,361,947,418,521,80,302,382,192,65,10,197,210,2063
91,Justin James,2016,2019,Wyoming,MWC,132,3707,692,1565,534,1096,158,469,519,710,105,609,714,344,123,65,328,291,2061
92,LaDontae Henton,2012,2015,Providence,Big East,135,4909,724,1655,537,1100,187,555,424,560,324,730,1054,158,158,91,246,327,2059
93,Anatoly Bose,2008,2011,Nicholls State,Southland,120,3763,629,1453,358,731,271,722,521,672,178,483,661,210,128,19,312,260,2050
94,Isaiah Canaan,2010,2013,Murray State,OVC,132,3876,635,1411,331,686,304,725,476,593,73,293,366,385,157,10,311,241,2050
95,Cameron Wells,2008,2011,Citadel,Southern,127,4463,753,1754,664,1440,89,314,454,565,105,552,657,485,186,43,307,288,2049
96,Markeith Cummings,2010,2013,Kennesaw State,A-Sun,121,4160,723,1590,635,1297,88,293,514,752,252,381,633,227,135,32,342,324,2048
97,Kelan Martin,2015,2018,Butler,Big East,136,3656,713,1631,489,987,224,644,397,505,140,569,709,161,79,56,237,283,2047
98,Johnny Dee,2012,2015,San Diego,WCC,131,4081,666,1542,333,707,333,835,381,419,47,318,365,157,121,3,169,193,2046
99,Jordan Caroline,2015,2019,Total,Total,138,4535,688,1492,576,1170,112,322,557,862,382,782,1164,242,109,35,268,310,2045
100,Tim Kempton,2014,2017,Lehigh,Patriot,123,3586,744,1404,715,1331,29,73,526,719,261,834,1095,131,86,76,349,372,2043
101,Thomas Wilder,2015,2018,Western Michigan,MAC,130,3775,641,1458,473,1012,168,446,590,729,61,435,496,413,190,28,266,288,2040
102,John Shurna,2009,2012,Northwestern,Big Ten,130,4132,704,1509,430,825,274,684,356,478,170,474,644,295,119,135,215,224,2038
103,Jack Gibbs,2014,2017,Davidson,Total,119,3618,647,1494,392,804,255,690,487,594,79,327,406,466,161,2,284,235,2036
104,Mike Muscala,2010,2013,Bucknell,Patriot,133,3815,723,1443,702,1376,21,67,569,695,301,792,1093,211,56,271,217,312,2036
105,Rashawn Thomas,2014,2017,Texas A&M-Corpus Christi,Southland,125,3475,737,1348,716,1278,21,70,539,802,308,653,961,173,118,217,381,434,2034
106,Kenny Boynton,2010,2013,Florida,SEC,145,4674,666,1671,333,693,333,978,368,468,91,257,348,392,128,19,221,172,2033
107,Zeek Woodley,2014,2017,Northwestern State,Southland,105,3092,743,1336,610,1012,133,324,414,492,179,317,496,109,83,65,145,243,2033
108,Marvelle Harris,2013,2016,Fresno State,MWC,136,4524,667,1595,476,1027,191,568,506,678,96,509,605,396,207,47,264,347,2031
109,Chris Warren,2008,2011,Mississippi,SEC,115,3812,634,1563,300,663,334,900,419,487,24,209,233,452,125,13,281,216,2021
110,Kevin Murphy,2009,2012,Tennessee Tech,OVC,128,3718,706,1594,515,1081,191,513,416,567,108,426,534,249,102,24,381,273,2019
111,Damion Lee,2012,2016,Total,Total,125,4104,636,1468,379,758,257,710,487,578,112,486,598,244,142,26,217,298,2016
112,Noah Dahlman,2008,2011,Wofford,Southern,128,3636,764,1276,764,1270,0,6,485,693,400,386,786,97,90,43,149,244,2013
113,Marcquise Reed,2015,2019,Total,Total,134,4003,682,1524,501,1038,181,486,468,557,85,416,501,347,237,3,293,255,2013
114,Quinndary Weatherspoon,2016,2019,Mississippi State,SEC,131,4081,706,1471,519,963,187,508,413,524,188,487,675,315,201,47,307,301,2012
115,Kenneth Faried,2008,2011,Morehead State,OVC,136,3964,783,1376,780,1364,3,12,440,755,602,1071,1673,117,228,241,304,416,2009
116,Troy Huff,2011,2014,North Dakota,Total,125,3596,698,1609,557,1130,141,479,468,686,265,485,750,172,229,43,271,205,2005
117,A.J. English,2013,2016,Iona,MAAC,112,3855,612,1447,299,611,313,836,467,590,74,413,487,510,140,52,330,261,2004
118,Javon McCrea,2011,2014,Buffalo,MAC,128,3473,798,1386,797,1382,1,4,407,653,411,577,988,249,164,250,309,368,2004
119,Justin Robinson,2014,2017,Monmouth,MAAC,131,4002,635,1512,378,848,257,664,476,574,70,373,443,497,211,4,288,194,2003
120,Adnan Hodzic,2008,2011,Lipscomb,A-Sun,121,3252,799,1363,798,1355,1,8,403,576,293,547,840,80,36,33,273,278,2002
121,Cory Higgins,2008,2011,Colorado,Big 12,132,4478,653,1397,528,1037,125,360,570,691,92,455,547,320,192,47,305,304,2001
122,Kyle Wilson,2013,2016,Army,Patriot,124,3781,686,1676,412,922,274,754,355,446,56,252,308,211,67,15,257,201,2001
123,Reed Timmer,2015,2018,Drake,MVC,127,4003,618,1404,404,853,214,551,550,654,56,344,400,287,88,6,254,209,2000
124,Grayson Allen,2015,2018,Duke,ACC,142,3965,606,1409,315,643,291,766,493,591,76,374,450,432,147,14,240,297,1996
125,Kalin Lucas,2008,2011,Michigan State,Big Ten,141,4278,670,1575,521,1180,149,395,507,637,79,192,271,558,144,11,324,233,1996
126,Trey Sumler,2011,2014,Western Carolina,Southern,132,4648,645,1490,428,926,217,564,489,599,128,446,574,496,182,5,379,291,1996
127,Langston Galloway,2011,2014,Saint Joseph's,A-10,133,4720,657,1501,314,695,343,806,334,407,130,467,597,296,171,66,156,327,1991
128,Kendrick Perry,2011,2014,Youngstown State,Horizon,123,4183,643,1374,442,797,201,577,504,670,109,397,506,505,246,36,241,306,1991
129,William Buford,2009,2012,Ohio State,Big Ten,145,4727,744,1690,529,1132,215,558,287,355,151,515,666,361,131,42,254,279,1990
130,C.J. Massinburg,2016,2019,Buffalo,MAC,130,4008,626,1386,353,678,273,708,465,614,231,539,770,318,137,44,203,244,1990
131,Jermaine Marrow,2017,2019,Hampton,Total,100,3411,662,1689,491,1160,171,529,492,620,82,328,410,449,120,8,331,276,1987
132,Yogi Ferrell,2013,2016,Indiana,Big Ten,137,4496,637,1475,365,794,272,681,440,530,76,362,438,633,114,9,312,231,1986
133,Alex Hamilton,2013,2016,Louisiana Tech,Total,140,3895,636,1387,526,996,110,391,604,834,103,413,516,501,215,49,316,207,1986
134,Warren Niles,2010,2013,Oral Roberts,Total,136,4451,673,1593,381,813,292,780,344,440,96,411,507,257,133,22,286,279,1982
135,Norris Cole,2008,2011,Cleveland State,Horizon,140,4114,677,1555,538,1122,139,433,485,587,90,353,443,455,207,11,283,312,1978
136,Chaz Williams,2010,2014,Total,Total,136,4665,634,1559,438,1038,196,521,514,667,126,404,530,840,253,20,437,390,1978
137,Bryce Cotton,2011,2014,Providence,Big East,130,4314,611,1452,345,716,266,736,487,581,70,298,368,384,118,11,193,157,1975
138,Greg Gantt,2010,2013,Florida Atlantic,Sun Belt,121,3799,707,1625,420,851,287,774,271,360,113,305,418,125,90,9,169,179,1972
139,Elijah Brown,2014,2018,Total,Total,129,3685,585,1469,306,676,279,793,520,609,64,459,523,322,115,10,308,238,1969
140,Jamarco Warren,2008,2011,Charleston Southern,Big South,121,3915,660,1635,323,718,337,917,311,391,63,270,333,336,153,6,321,256,1968
141,Ken Horton,2008,2012,Central Connecticut State,NEC,116,3865,718,1421,560,971,158,450,372,457,291,551,842,182,139,195,209,256,1966
142,Sheldon McClellan,2012,2016,Total,Total,141,4237,634,1392,456,869,178,523,517,632,126,408,534,180,133,22,180,183,1963
143,Tanner Leissner,2015,2018,New Hampshire,AEC,122,4096,667,1476,560,1137,107,339,521,675,289,573,862,196,61,44,230,282,1962
144,Stephan Hicks,2012,2015,Cal State Northridge,Big West,122,3938,651,1338,593,1153,58,185,599,737,282,515,797,137,155,35,227,284,1959
145,Shabazz Napier,2011,2014,Connecticut,Total,143,4614,595,1447,335,754,260,693,509,626,101,475,576,646,251,30,350,301,1959
146,Markus Howard,2017,2019,Marquette,Big East,99,2890,627,1384,314,661,313,723,388,430,36,275,311,297,95,5,282,236,1955
147,Tayler Persons,2015,2019,Total,Total,129,3857,715,1574,578,1173,137,401,383,508,72,434,506,559,138,15,383,310,1950
148,Kellen Dunham,2013,2016,Butler,Total,134,4280,598,1457,299,681,299,776,451,537,67,324,391,173,83,16,203,192,1946
149,Matt Mobley,2014,2018,Total,Total,127,4382,602,1478,307,659,295,819,447,537,59,447,506,272,139,21,285,286,1946
150,Anthony Drmic,2012,2016,Boise State,MWC,131,4117,634,1463,359,677,275,786,399,529,129,477,606,244,122,16,223,361,1942
151,Sindarius Thornwell,2014,2017,South Carolina,SEC,132,4194,596,1521,417,993,179,528,570,739,214,471,685,390,199,78,331,320,1941
152,Matt Howard,2008,2011,Butler,Horizon,141,3828,606,1178,548,1025,58,153,669,855,331,553,884,148,112,131,221,451,1939
153,Tim Williams,2013,2017,Total,Total,118,3990,759,1309,757,1301,2,8,419,599,229,623,852,115,121,133,194,254,1939
154,Stephen Croone,2013,2016,Furman,Southern,121,3744,573,1294,434,831,139,463,651,872,55,415,470,385,177,31,365,267,1936
155,Damian Lillard,2009,2012,Weber State,Big Sky,104,3363,584,1310,338,680,246,630,520,600,43,401,444,362,129,19,246,221,1934
156,Rayvonte Rice,2011,2015,Total,Total,123,3902,655,1515,499,1014,156,501,468,642,155,549,704,200,206,70,230,337,1934
157,Matthew Dellavedova,2010,2013,Saint Mary's (CA),WCC,136,4944,590,1423,302,662,288,761,465,541,113,356,469,768,150,7,342,264,1933
158,Keith Gabriel,2009,2012,Virginia Military Institute,Big South,124,3082,654,1569,343,636,311,933,306,449,105,277,382,168,212,99,239,301,1925
159,Bryce Alford,2014,2017,UCLA,Pac-12,141,4509,584,1443,255,614,329,829,425,515,30,360,390,537,106,10,235,191,1922
160,Evan Bradds,2014,2017,Belmont,OVC,129,3606,740,1109,728,1072,12,37,429,612,236,684,920,214,59,27,283,342,1921
161,Josh Hart,2014,2017,Villanova,Big East,146,4093,677,1326,470,794,207,532,360,500,252,560,812,266,161,43,194,327,1921
162,Ian Clark,2010,2013,Belmont,Total,133,3818,681,1406,341,606,340,800,218,269,64,316,380,289,162,27,277,283,1920
163,Drew Crawford,2010,2014,Northwestern,Big Ten,143,4627,687,1575,455,917,232,658,314,432,201,512,713,286,118,98,235,356,1920
164,Carsen Edwards,2017,2019,Purdue,Big Ten,108,3180,634,1539,353,776,281,763,371,454,41,322,363,270,126,21,241,206,1920
165,JaJuan Johnson,2008,2011,Purdue,Big Ten,140,3856,706,1410,691,1350,15,60,492,662,280,573,853,95,93,263,188,246,1919
166,D'Vauntes Smith-Rivera,2013,2016,Georgetown,Big East,130,4257,600,1419,350,728,250,691,469,565,117,396,513,386,165,22,215,238,1919
167,Anthony Beane,2013,2016,Southern Illinois,MVC,129,4272,679,1563,486,1026,193,537,366,474,81,313,394,189,145,18,255,302,1917
168,Augustine Rubit,2011,2014,South Alabama,Sun Belt,118,3756,673,1359,652,1284,21,75,550,763,491,692,1183,125,71,139,269,283,1917
169,Jordon Varnado,2016,2019,Troy,Sun Belt,114,3434,717,1421,598,1075,119,346,364,508,240,578,818,172,68,147,215,304,1917
170,Jarrell Brantley,2016,2019,College of Charleston,CAA,123,3896,694,1424,582,1107,112,317,414,539,225,743,968,203,150,85,314,362,1914
171,Cameron Morse,2015,2018,Youngstown State,Horizon,110,3418,666,1593,434,925,232,668,349,450,41,235,276,334,126,12,194,155,1913
172,Jaylen Adams,2015,2018,St. Bonaventure,A-10,110,3998,532,1246,262,561,270,685,578,690,59,313,372,590,170,22,314,291,1912
173,Derrick Marks,2012,2015,Boise State,MWC,127,3538,669,1417,553,1124,116,293,458,580,69,383,452,370,190,50,332,355,1912
174,Javonte Green,2012,2015,Radford,Big South,133,3378,701,1350,677,1249,24,101,485,739,360,704,1064,141,243,89,245,358,1911
175,Nolan Smith,2008,2011,Duke,ACC,143,3842,667,1490,501,1039,166,451,411,514,114,284,398,406,142,19,292,267,1911
176,Kendall Anthony,2012,2015,Richmond,A-10,134,3918,628,1504,358,815,270,689,383,475,54,148,202,236,100,3,193,290,1909
177,T.J. Cline,2013,2017,Total,Total,135,3575,730,1397,548,878,182,519,267,408,141,579,720,398,97,22,250,350,1909
178,Kyle Wiltjer,2012,2016,Total,Total,147,3504,690,1417,442,834,248,583,281,341,173,497,670,190,48,85,186,223,1909
179,Russ Smith,2011,2014,Louisville,Total,133,3228,620,1501,440,980,180,521,488,642,98,261,359,378,257,8,316,321,1908
180,Stephen Curry,2008,2009,Davidson,Southern,70,2338,629,1343,337,638,292,705,355,402,49,267,316,293,159,22,219,166,1905
181,Keith Benson,2008,2011,Oakland,Summit,135,3616,684,1226,673,1197,11,29,524,772,331,772,1103,94,68,369,183,380,1903
182,Donte Clark,2015,2018,Total,Total,133,3935,582,1445,409,892,173,553,565,740,98,415,513,325,118,42,298,376,1902
183,Devan Downey,2008,2010,South Carolina,SEC,94,3271,686,1634,512,1131,174,503,355,456,56,236,292,420,277,11,304,202,1901
184,Patrick Miller,2011,2014,Tennessee State,OVC,126,4451,609,1433,482,1041,127,392,555,754,149,342,491,520,196,22,375,331,1900
185,E.C. Matthews,2014,2018,Rhode Island,A-10,128,3931,632,1503,410,835,222,668,413,564,109,444,553,213,94,65,303,249,1899
186,Brandon Young,2011,2014,DePaul,Big East,126,4007,660,1530,530,1085,130,445,449,624,75,322,397,521,188,20,352,209,1899
187,Jeffery Taylor,2009,2012,Vanderbilt,SEC,134,3923,665,1378,550,1057,115,321,452,652,280,472,752,252,146,60,309,313,1897
188,Garret Covington,2014,2017,Western Illinois,Summit,112,3764,602,1460,306,692,296,768,396,479,52,417,469,261,103,16,270,181,1896
189,Karl Cochran,2012,2015,Wofford,Southern,133,4068,701,1814,389,900,312,914,180,262,86,573,659,320,226,101,267,292,1894
190,Antwan Carter,2009,2012,Longwood,Ind,123,3351,781,1452,740,1304,41,148,283,419,329,679,1008,128,103,88,249,407,1886
191,Yante Maten,2015,2018,Georgia,SEC,128,3576,655,1355,597,1211,58,144,518,686,333,556,889,129,55,199,245,310,1886
192,Caleb Martin,2015,2019,Total,Total,139,3959,605,1461,294,595,311,866,364,502,121,505,626,261,135,78,198,293,1885
193,Frank Mason,2014,2017,Kansas,Big 12,145,4345,609,1340,424,900,185,440,482,633,79,421,500,576,165,10,270,287,1885
194,Braylon Rayson,2014,2017,Central Michigan,MAC,127,3681,625,1551,354,783,271,768,364,448,89,338,427,232,131,3,237,249,1885
195,Elijah Wilson,2014,2017,Coastal Carolina,Total,140,4232,659,1681,366,829,293,852,274,385,138,377,515,132,117,24,213,281,1885
196,Ty Greene,2012,2015,South Carolina Upstate,A-Sun,128,4213,590,1447,305,692,285,755,419,548,81,298,379,329,201,19,190,226,1884
197,Desmar Jackson,2010,2014,Total,Total,125,3545,665,1442,571,1109,94,333,460,625,166,402,568,251,243,56,369,357,1884
198,Treveon Graham,2012,2015,Virginia Commonwealth,Total,140,3558,618,1431,418,866,200,565,446,645,293,512,805,199,111,29,191,299,1882
199,James Woodard,2013,2016,Tulsa,Total,131,4272,595,1410,334,677,261,733,430,579,139,580,719,236,124,32,221,236,1881
200,C.J. Wilcox,2011,2014,Washington,Total,131,3735,640,1478,339,705,301,773,299,356,110,331,441,214,112,98,178,250,1880
201,Khallid Hart,2014,2017,Marist,MAAC,110,3851,584,1321,369,732,215,589,496,607,47,256,303,240,138,12,225,256,1879
202,Gerald Robinson,2008,2012,Total,Total,127,3981,676,1517,529,1057,147,460,377,495,109,308,417,404,197,12,342,275,1876
203,Derek Needham,2010,2013,Fairfield,MAAC,131,4435,628,1642,347,793,281,849,338,466,68,337,405,537,193,13,436,351,1875
204,Ray Lee,2013,2017,Eastern Michigan,MAC,135,3270,595,1426,382,826,213,600,470,591,65,151,216,242,167,14,336,255,1873
205,Jamal Olasewere,2010,2013,Long Island University,NEC,130,3384,630,1235,587,1085,43,150,570,859,274,689,963,164,170,104,405,462,1873
206,Trevor Releford,2011,2014,Alabama,SEC,134,4367,638,1319,478,873,160,446,437,537,83,336,419,395,263,11,303,325,1873
207,Junior Robinson,2015,2018,Mount St. Mary's,NEC,131,4049,603,1461,373,842,230,619,436,509,49,203,252,457,134,8,325,302,1872
208,Marcus Paige,2013,2016,North Carolina,ACC,141,4570,605,1487,302,677,303,810,357,421,55,344,399,601,203,35,274,242,1870
209,Shamorie Ponds,2017,2019,St. John's (NY),Big East,96,3378,632,1447,445,877,187,570,419,499,106,327,433,413,225,20,209,177,1870
210,Kyle Weems,2009,2012,Missouri State,MVC,134,3981,681,1550,441,909,240,641,266,337,188,656,844,198,146,114,181,382,1868
211,Matt Mooney,2015,2019,Total,Total,133,3757,667,1499,443,888,224,611,309,401,56,404,460,347,233,17,292,231,1867
212,Saah Nimley,2012,2015,Charleston Southern,Big South,115,3717,544,1484,256,646,288,838,490,633,91,335,426,511,113,7,302,247,1866
213,Otis Livingston II,2016,2019,George Mason,A-10,132,4558,621,1517,418,934,203,583,420,489,32,339,371,493,126,2,316,207,1865
214,C.J. Burks,2016,2019,Marshall,CUSA,129,3846,694,1474,481,880,213,594,263,326,68,344,412,328,150,18,305,260,1864
215,Rotnei Clarke,2009,2013,Total,Total,125,4086,598,1398,209,463,389,935,279,320,42,275,317,208,111,6,193,150,1864
216,Jahad Thomas,2015,2018,Massachusetts-Lowell,AEC,109,3599,735,1327,711,1263,24,64,370,577,222,640,862,384,164,25,391,312,1864
217,Aaric Murray,2010,2014,Total,Total,127,3433,679,1422,583,1145,96,277,405,555,291,591,882,146,107,275,271,380,1859
218,Aaron White,2012,2015,Iowa,Big Ten,140,3939,590,1142,529,925,61,217,618,800,289,613,902,190,149,85,211,219,1859
219,Elias Harris,2010,2013,Gonzaga,WCC,135,3785,666,1289,588,1070,78,219,447,618,270,709,979,177,123,72,242,290,1857
220,Nigel Hayes,2014,2017,Wisconsin,Big Ten,150,4439,605,1358,504,1054,101,304,546,820,270,532,802,319,133,64,238,313,1857
221,MoMo Jones,2010,2013,Total,Total,135,3929,651,1488,507,1028,144,460,405,483,72,250,322,351,125,5,298,252,1851
222,Khadeen Carrington,2015,2018,Seton Hall,Big East,132,4044,612,1478,423,942,189,536,433,564,81,323,404,388,138,30,272,270,1846
223,Malcolm Hill,2014,2017,Illinois,Big Ten,137,3864,583,1347,424,894,159,453,521,655,160,487,647,281,122,39,220,264,1846
224,Carl Jones,2010,2013,Saint Joseph's,A-10,126,3928,570,1409,357,804,213,605,492,662,42,302,344,341,123,9,266,177,1845
225,Divine Myles,2015,2018,Stetson,A-Sun,127,4163,681,1413,570,1092,111,321,372,533,92,461,553,501,160,18,223,254,1845
226,George Beamon,2010,2014,Manhattan,MAAC,120,3414,608,1367,485,1025,123,342,504,645,197,437,634,136,162,42,226,247,1843
227,Frank Gaines,2010,2013,Purdue-Fort Wayne,Summit,123,3287,601,1363,462,934,139,429,500,672,140,421,561,114,130,63,219,302,1841
228,Casper Ware,2009,2012,Long Beach State,Big West,131,4319,586,1458,373,848,213,610,456,582,60,274,334,545,205,15,368,290,1841
229,Le'Bryan Nash,2012,2015,Oklahoma State,Big 12,126,3893,635,1381,605,1237,30,144,539,715,154,485,639,217,79,73,322,374,1839
230,Julius Brown,2012,2015,Toledo,MAC,131,4328,635,1512,436,934,199,578,369,459,43,278,321,694,140,23,369,180,1838
231,Greivis Vasquez,2008,2010,Maryland,ACC,102,3588,637,1512,438,911,199,601,364,436,106,429,535,615,152,34,358,223,1837
232,Joel Berry,2015,2018,North Carolina,ACC,144,3973,615,1464,347,730,268,734,337,404,64,340,404,450,165,27,221,275,1835
233,Dedric Lawson,2016,2019,Total,Total,101,3341,647,1422,554,1142,93,280,448,592,307,688,995,250,125,161,263,260,1835
234,Bernard Thompson,2012,2015,Florida Gulf Coast,A-Sun,134,4031,636,1466,417,865,219,601,344,487,170,453,623,246,262,19,278,313,1835
235,Michael Young,2014,2017,Pittsburgh,ACC,136,3924,642,1313,581,1133,61,180,490,644,296,551,847,243,66,87,221,265,1835
236,Tu Holloway,2009,2012,Xavier,A-10,134,4298,499,1210,339,736,160,474,675,792,43,388,431,550,164,11,345,265,1833
237,Omar Prewitt,2014,2017,William & Mary,CAA,126,3822,626,1340,437,803,189,537,390,555,104,536,640,320,118,78,239,272,1831
238,Joe Chealey,2014,2018,College of Charleston,CAA,129,4018,533,1320,354,804,179,516,582,723,68,386,454,397,111,18,244,322,1827
239,Kevin Pangos,2012,2015,Gonzaga,WCC,142,4689,566,1306,244,530,322,776,370,439,46,358,404,536,177,7,222,269,1824
240,James Thompson IV,2016,2019,Eastern Michigan,MAC,132,4278,701,1109,694,1091,7,18,414,649,575,876,1451,78,97,171,224,412,1823
241,Kevin Jones,2009,2012,West Virginia,Big East,139,4347,728,1475,618,1126,110,349,256,378,450,598,1048,141,84,109,136,225,1822
242,Brian Parker,2016,2019,Marist,MAAC,120,3683,629,1304,565,1111,64,193,500,741,120,486,606,386,75,7,410,263,1822
243,Josh Adams,2013,2016,Wyoming,MWC,132,4318,579,1333,390,761,189,572,472,621,62,373,435,405,144,42,326,314,1819
244,R.J. Hunter,2013,2015,Georgia State,Total,99,3438,559,1321,306,606,253,715,448,525,68,406,474,240,191,92,168,214,1819
245,Devin Sibley,2015,2018,Furman,Southern,134,3729,621,1318,411,759,210,559,365,529,67,428,495,239,94,33,329,287,1817
246,Devin Watson,2015,2019,Total,Total,128,3959,572,1413,353,804,219,609,453,612,52,266,318,490,119,0,297,202,1816
247,Ricky Harris,2008,2010,Massachusetts,A-10,97,3113,598,1410,339,682,259,728,360,476,55,228,283,199,136,13,264,203,1815
248,Jalen Hayes,2014,2018,Oakland,Horizon,134,3901,697,1322,680,1265,17,57,403,541,280,691,971,175,133,79,217,387,1814
249,Kendall Williams,2011,2014,New Mexico,MWC,137,4450,526,1216,321,677,205,539,556,725,87,372,459,617,186,16,286,228,1813
250,Andrew Andrews,2013,2016,Washington,Pac-12,128,3929,520,1340,326,788,194,552,578,709,135,408,543,387,149,10,264,336,1812
251,James Anderson,2008,2010,Oklahoma State,Big 12,101,3316,583,1268,358,668,225,600,420,527,196,317,513,163,112,60,212,214,1811
252,Nic Moore,2012,2016,Total,Total,135,4363,571,1338,290,660,281,678,388,464,34,278,312,643,169,6,319,309,1811
253,Jelani Hewitt,2011,2015,Georgia Southern,Total,127,4042,573,1488,303,720,270,768,394,490,113,386,499,340,252,21,343,281,1810
254,Malcolm Brogdon,2012,2016,Virginia,ACC,136,4157,601,1399,416,892,185,507,422,482,82,481,563,335,117,31,207,250,1809
255,Corey Walden,2011,2015,Total,Total,125,3978,585,1164,419,687,166,477,471,562,97,371,468,366,292,15,274,383,1807
256,Victor Sanders,2015,2018,Idaho,Big Sky,120,3156,546,1237,274,578,272,659,440,559,60,301,361,287,130,45,283,289,1804
257,Jaylin Walker,2016,2019,Kent State,MAC,114,3489,590,1529,295,676,295,853,329,415,154,311,465,167,107,7,244,168,1804
258,Venky Jois,2013,2016,Eastern Washington,Big Sky,122,3927,718,1232,714,1210,4,22,363,660,275,740,1015,276,121,240,302,299,1803
259,Jordan Murphy,2016,2019,Minnesota,Big Ten,133,3895,655,1322,623,1184,32,138,460,698,415,890,1305,189,115,129,273,384,1802
260,Ahmaad Rorie,2015,2019,Total,Total,136,4115,643,1457,442,894,201,563,314,381,90,377,467,430,108,18,202,238,1801
261,Marcus Evans,2016,2019,Total,Total,100,3069,558,1261,379,712,179,549,505,642,57,289,346,327,175,16,318,263,1800
262,Perry Ellis,2013,2016,Kansas,Big 12,144,3604,653,1286,597,1156,56,130,436,576,258,576,834,148,90,72,174,268,1798
263,Obi Emegano,2012,2016,Total,Total,100,3406,580,1269,492,1044,88,225,550,684,80,375,455,171,126,17,213,217,1798
264,Tra Holder,2015,2018,Arizona State,Pac-12,129,4181,544,1370,368,874,176,496,533,696,99,337,436,448,120,4,308,255,1797
265,Dominique Jones,2008,2010,South Florida,Big East,95,3470,592,1339,432,844,160,495,453,615,142,375,517,328,144,39,249,245,1797
266,Isiah Umipig,2011,2015,Total,Total,125,3789,582,1411,234,524,348,887,285,345,57,256,313,311,119,2,272,278,1797
267,Grant Riller,2017,2019,College of Charleston,CAA,101,3226,653,1240,513,844,140,396,350,448,45,231,276,244,116,23,190,185,1796
268,Jake Cohen,2010,2013,Davidson,Southern,131,3157,611,1260,489,912,122,348,451,560,232,515,747,147,76,197,258,406,1795
269,Kendrick Nunn,2014,2018,Total,Total,126,3796,631,1473,337,711,294,762,239,291,57,398,455,262,146,27,213,225,1795
270,Charles Williams,2017,2019,Howard,MEAC,100,3219,641,1488,441,953,200,535,313,392,79,211,290,62,69,31,164,200,1795
271,Rian Pearson,2010,2014,Total,Total,130,3668,680,1444,637,1316,43,128,391,565,264,490,754,197,181,27,251,253,1794
272,Tyler Seibring,2016,2019,Elon,CAA,128,4077,659,1378,381,698,278,680,198,267,187,592,779,242,54,81,137,239,1794
273,TaShawn Thomas,2012,2015,Total,Total,131,4001,737,1318,735,1298,2,20,317,510,365,696,1061,226,122,262,258,272,1793
274,David Kool,2008,2010,Western Michigan,MAC,96,3245,547,1299,355,739,192,560,506,572,62,303,365,224,129,2,235,193,1792
275,Cleveland Melvin,2011,2014,DePaul,Big East,110,3349,719,1509,655,1317,64,192,290,444,266,441,707,87,101,131,217,207,1792
276,Jaelan Sanford,2016,2019,Toledo,MAC,133,4377,618,1404,380,757,238,647,315,391,80,314,394,373,77,48,218,235,1789
277,Ryan Anderson,2012,2016,Total,Total,128,3906,630,1295,598,1175,32,120,495,706,309,741,1050,151,83,73,235,235,1787
278,Quinton Hooker,2014,2017,North Dakota,Big Sky,128,3917,592,1278,422,842,170,436,433,523,102,394,496,417,195,27,216,276,1787
279,Ryan Boatright,2012,2015,Connecticut,Total,128,4322,566,1362,367,838,199,524,455,573,65,381,446,491,180,22,302,206,1786
280,Stacy Davis,2013,2016,Pepperdine,WCC,125,3941,607,1318,538,1122,69,196,503,654,283,711,994,211,83,87,301,282,1786
281,Reid Travis,2015,2019,Total,Total,130,3825,656,1216,631,1128,25,88,449,701,372,615,987,107,84,44,223,315,1786
282,Kevin Hervey,2015,2018,Texas-Arlington,Sun Belt,115,3186,631,1435,427,805,204,630,317,413,221,700,921,216,114,55,236,215,1783
283,Kemba Walker,2009,2011,Connecticut,Big East,111,3647,578,1350,452,963,126,387,501,640,116,377,493,460,185,28,258,171,1783
284,T.J. Price,2012,2015,Western Kentucky,Total,125,3881,581,1425,295,656,286,769,334,440,113,466,579,318,123,25,300,332,1782
285,Barry Brown,2016,2019,Kansas State,Big 12,139,4472,633,1518,460,976,173,542,342,488,76,383,459,350,254,17,271,287,1781
286,Dyami Starks,2011,2015,Total,Total,112,3545,600,1464,300,657,300,807,279,319,62,242,304,162,81,13,204,206,1779
287,Xavier Cooks,2015,2018,Winthrop,Big South,127,3558,659,1300,558,1010,101,290,359,520,223,760,983,306,109,221,333,323,1778
288,Matt Dickey,2009,2012,North Carolina-Asheville,Big South,130,3959,546,1252,347,679,199,573,487,578,96,354,450,429,188,10,332,334,1778
289,Ryan Taylor,2014,2017,Marshall,CUSA,128,3519,616,1263,528,960,88,303,458,683,254,731,985,292,111,122,302,446,1778
290,De'Mon Brooks,2011,2014,Davidson,Southern,125,2971,647,1209,594,1055,53,154,430,590,275,490,765,113,98,71,232,397,1777
291,Shannon Evans,2014,2018,Total,Total,127,4201,553,1408,288,670,265,738,406,494,54,336,390,504,182,37,259,246,1777
292,Erving Walker,2009,2012,Florida,SEC,144,4358,527,1345,242,590,285,755,438,550,59,322,381,547,159,1,302,241,1777
293,Marcus Denmon,2009,2012,Missouri,Big 12,141,3598,597,1311,314,606,283,705,298,373,131,348,479,237,178,14,140,185,1775
294,Kwame Vaughn,2009,2013,Total,Total,123,3767,556,1246,401,808,155,438,508,640,65,447,512,342,120,16,315,314,1775
295,Dior Lowhorn,2008,2010,San Francisco,WCC,90,2940,672,1371,603,1170,69,201,360,491,221,407,628,62,49,59,197,173,1773
296,Kassius Robertson,2014,2018,Total,Total,134,4074,563,1278,245,507,318,771,329,418,101,271,372,255,113,10,232,224,1773
297,Jimmy Hall,2013,2017,Total,Total,105,3215,708,1381,697,1336,11,45,345,480,359,575,934,217,74,105,283,303,1772
298,Robbie Hummel,2008,2012,Purdue,Big Ten,127,3830,583,1315,367,760,216,555,390,464,237,625,862,268,131,112,138,306,1772
299,John Roberson,2008,2011,Texas Tech,Big 12,129,4436,548,1363,274,664,274,699,402,504,42,291,333,636,135,9,400,328,1772
300,Nick Perkins,2016,2019,Buffalo,MAC,139,3429,638,1405,492,953,146,452,349,521,249,599,848,84,47,92,257,347,1771
301,Raheem Appleby,2012,2015,Louisiana Tech,Total,127,3476,672,1583,486,1023,186,560,240,320,89,223,312,188,138,14,170,135,1770
302,Khalil Ahmad,2016,2019,Cal State Fullerton,Big West,117,3465,604,1425,427,872,177,553,383,481,79,393,472,172,142,22,249,268,1768
303,Jordan Price,2013,2017,Total,Total,121,3609,578,1449,321,730,257,719,355,467,66,412,478,267,93,31,299,259,1768
304,Austin Kenon,2008,2011,Virginia Military Institute,Big South,105,3153,551,1318,202,408,349,910,316,388,99,223,322,294,136,4,205,234,1767
305,Adrian Oliver,2008,2011,Total,Total,85,2835,591,1360,449,990,142,370,443,530,100,279,379,209,70,37,266,226,1767
306,Stephen Thompson Jr.,2016,2019,Oregon State,Pac-12,121,3941,636,1498,406,821,230,677,265,389,109,294,403,309,177,31,229,242,1767
307,Reggie Holmes,2008,2010,Morgan State,MEAC,102,3104,516,1355,255,639,261,716,473,600,171,278,449,67,136,22,156,262,1766
308,Brice Johnson,2013,2016,North Carolina,ACC,148,3102,734,1272,734,1272,0,0,298,417,314,721,1035,133,111,163,187,369,1766
309,Kay Felder,2014,2016,Oakland,Horizon,101,3626,554,1300,411,885,143,415,514,625,67,369,436,788,164,19,350,287,1765
310,Andre Hollins,2012,2015,Minnesota,Big Ten,140,3907,539,1341,265,640,274,701,413,499,84,377,461,359,135,23,284,323,1765
311,Jairus Lyles,2014,2018,Total,Total,108,3078,607,1367,445,907,162,460,388,525,93,422,515,264,180,7,240,183,1764
312,Austin Freeman,2008,2011,Georgetown,Big East,129,4000,640,1285,453,794,187,491,294,356,118,344,462,274,108,19,206,233,1761
313,Nick Garth,2016,2019,Lamar,Southland,127,3444,565,1352,245,509,320,843,310,380,54,229,283,256,114,5,164,241,1760
314,Brenton Scott,2015,2018,Indiana State,MVC,125,3865,592,1487,322,766,270,721,306,423,62,508,570,240,173,19,261,251,1760
315,Jevon Carter,2015,2018,West Virginia,Big 12,144,4299,587,1441,346,763,241,678,343,430,131,407,538,559,330,34,264,358,1758
316,Jonathan Williams,2014,2017,Toledo,MAC,131,3664,607,1388,385,746,222,642,321,418,74,281,355,286,83,12,281,247,1757
317,Maodo Lo,2013,2016,Columbia,Ivy,121,3678,623,1329,346,637,277,692,233,304,64,367,431,264,181,51,235,267,1756
318,Klay Thompson,2009,2011,Washington State,Pac-10,98,3367,599,1414,357,794,242,620,316,382,89,386,475,259,130,74,289,241,1756
319,Lawrence Alexander,2012,2015,North Dakota State,Summit,131,4629,587,1362,380,830,207,532,374,491,66,476,542,408,130,26,320,229,1755
320,D'Marcus Simonds,2017,2019,Georgia State,Sun Belt,98,3224,641,1402,526,1011,115,391,358,519,103,383,486,334,139,65,329,238,1755
321,Nana Foulland,2015,2018,Bucknell,Patriot,134,3586,696,1202,696,1200,0,2,362,666,296,611,907,134,75,212,247,357,1754
322,Jared Terrell,2015,2018,Rhode Island,A-10,134,4232,586,1442,394,916,192,526,390,511,95,313,408,281,170,26,233,353,1754
323,Devonte' Graham,2015,2018,Kansas,Big 12,142,4498,546,1295,250,572,296,723,362,460,62,377,439,632,197,14,270,237,1750
324,Ameen Tanksley,2012,2016,Total,Total,134,4193,574,1380,356,781,218,599,384,534,260,497,757,174,151,39,220,373,1750
325,Stefan Moody,2013,2016,Total,Total,94,2955,527,1301,294,660,233,641,462,545,81,256,337,278,124,15,277,222,1749
326,Tai Wesley,2008,2011,Utah State,WAC,139,3768,657,1102,650,1090,7,12,428,608,340,533,873,356,112,144,281,432,1749
327,Robert Covington,2010,2013,Tennessee State,OVC,118,3536,623,1309,441,878,182,431,320,399,306,570,876,145,181,150,275,354,1748
328,Ashton Gibbs,2009,2012,Pittsburgh,Big East,137,3837,562,1360,265,636,297,724,327,375,50,227,277,255,63,6,175,146,1748
329,Stephen Maxwell,2012,2015,Cal State Northridge,Big West,122,3704,635,1199,635,1199,0,0,478,657,425,551,976,67,98,23,219,314,1748
330,James Florence,2008,2010,Mercer,A-Sun,91,3014,581,1481,394,845,187,636,398,565,58,268,326,345,175,20,345,265,1747
331,Seth Tuttle,2012,2015,Northern Iowa,MVC,136,3672,600,1041,561,932,39,109,508,675,276,641,917,282,126,95,270,294,1747
332,Phil Forte,2013,2017,Oklahoma State,Big 12,135,3994,512,1237,183,405,329,832,393,445,52,214,266,178,164,5,132,178,1746
333,Roberto Nelson,2011,2014,Oregon State,Total,124,3217,540,1270,361,791,179,479,486,614,107,241,348,307,107,21,280,277,1745
334,David Efianayi,2016,2019,Gardner-Webb,Big South,119,3374,578,1219,426,826,152,393,436,583,59,301,360,274,123,47,268,193,1744
335,Chris Fouch,2010,2014,Drexel,CAA,126,3449,568,1464,293,684,275,780,333,426,75,276,351,178,84,23,151,223,1744
336,Thomas Walkup,2013,2016,Stephen F. Austin,Southland,135,3532,633,1114,593,983,40,131,438,577,301,453,754,395,176,34,215,383,1744
337,Corey Hawkins,2011,2015,Total,Total,110,3095,561,1200,385,766,176,434,445,555,74,397,471,297,136,25,226,196,1743
338,Brad Waldow,2012,2015,Saint Mary's (CA),WCC,134,3486,683,1162,683,1161,0,1,377,632,368,532,900,141,58,133,187,316,1743
339,Bryn Forbes,2013,2016,Total,Total,138,4010,565,1258,241,513,324,745,288,351,67,272,339,182,87,8,164,219,1742
340,Erick Green,2010,2013,Virginia Tech,ACC,129,3648,592,1356,452,942,140,414,418,520,59,273,332,326,156,26,178,208,1742
341,J.J. Avila,2011,2015,Total,Total,115,3619,639,1345,532,992,107,353,356,477,267,516,783,329,189,55,299,307,1741
342,Anthony Raffa,2009,2013,Total,Total,122,3406,608,1330,448,871,160,459,365,486,127,302,429,234,161,8,262,238,1741
343,Askia Booker,2012,2015,Colorado,Pac-12,134,3810,595,1551,425,1013,170,538,380,480,72,374,446,335,155,5,287,243,1740
344,Egor Koulechov,2014,2018,Total,Total,128,3719,579,1330,337,715,242,615,340,409,193,637,830,173,88,27,181,248,1740
345,Mark Lyons,2010,2013,Total,Total,133,3975,577,1375,383,822,194,553,392,513,44,313,357,358,145,28,315,335,1740
346,Jerian Grant,2012,2015,Notre Dame,Total,119,4337,556,1276,377,757,179,519,448,567,47,296,343,690,175,37,266,219,1739
347,Zach Thomas,2015,2018,Bucknell,Patriot,121,3116,534,1145,365,722,169,423,501,648,137,659,796,255,102,60,287,255,1738
348,Chris Fowler,2013,2016,Central Michigan,MAC,120,3927,593,1209,518,983,75,226,475,680,67,310,377,686,185,13,327,329,1736
349,Scottie Reynolds,2008,2010,Villanova,Big East,106,3362,513,1214,290,614,223,600,486,599,54,251,305,349,161,9,294,231,1735
350,Myles Taylor,2012,2016,Tennessee-Martin,OVC,125,3186,588,1128,564,1047,24,81,534,705,289,476,765,96,100,84,222,429,1734
351,Jaron Blossomgame,2014,2017,Clemson,ACC,128,3925,627,1286,531,982,96,304,383,529,242,589,831,141,83,95,190,211,1733
352,Da'Sean Butler,2008,2010,West Virginia,Big East,110,3653,606,1373,440,905,166,468,355,477,223,450,673,243,108,32,206,271,1733
353,Damyean Dotson,2013,2017,Total,Total,134,3906,645,1390,402,751,243,639,199,250,166,509,675,149,101,21,154,214,1732
354,Deshon Taylor,2015,2019,Total,Total,126,3773,495,1134,278,586,217,548,525,633,64,286,350,335,159,15,252,272,1732
355,Alan Williams,2012,2015,UC-Santa Barbara,Big West,112,3026,637,1295,637,1292,0,3,458,649,403,722,1125,117,108,216,196,310,1732
356,James Johnson,2009,2012,Quinnipiac,NEC,127,4285,581,1511,363,922,218,589,351,443,106,341,447,479,185,12,283,297,1731
357,Nate Mason,2015,2018,Minnesota,Big Ten,125,3981,582,1493,370,909,212,584,355,466,65,343,408,512,163,10,194,226,1731
358,Christian Watford,2010,2013,Indiana,Big Ten,132,3759,531,1293,367,905,164,388,504,616,191,586,777,129,88,64,246,288,1730
359,Jud Dillard,2010,2013,Tennessee Tech,OVC,123,3442,605,1219,556,1057,49,162,470,618,239,577,816,156,119,21,258,230,1729
360,Marcus Georges-Hunt,2013,2016,Georgia Tech,ACC,130,4017,569,1314,447,943,122,371,468,625,200,380,580,287,121,28,220,307,1728
361,Olivier Hanlan,2013,2015,Boston College,ACC,97,3493,565,1247,389,760,176,487,421,541,62,320,382,303,104,5,236,216,1727
362,Lester Hudson,2008,2009,Tennessee-Martin,OVC,65,2372,604,1324,374,705,230,619,289,337,142,371,513,283,169,40,232,173,1727
363,Tyreek Duren,2011,2014,La Salle,A-10,132,4600,568,1267,408,853,160,414,430,543,67,342,409,500,227,37,295,248,1726
364,Chris Flores,2010,2013,NJIT,GWC,122,3726,587,1463,350,799,237,664,315,442,111,360,471,330,212,25,265,287,1726
365,Matt Scott,2015,2018,Niagara,MAAC,122,3600,553,1336,390,843,163,493,457,623,216,521,737,273,137,41,290,272,1726
366,Ken Williams,2014,2017,South Alabama,Sun Belt,127,3847,553,1508,300,730,253,778,366,464,65,359,424,343,90,28,269,217,1725
367,Tyler Cavanaugh,2013,2017,Total,Total,137,3502,545,1221,390,804,155,417,479,584,226,561,787,155,53,40,257,357,1724
368,KeVaughn Allen,2016,2019,Florida,SEC,142,4178,556,1397,306,654,250,743,361,411,50,315,365,266,170,38,195,210,1723
369,Zack Rosen,2009,2012,Pennsylvania,Ivy,117,4198,540,1247,315,671,225,576,418,496,63,327,390,587,154,7,327,306,1723
370,Travis Munnings,2016,2019,Louisiana-Monroe,Sun Belt,134,4373,625,1348,417,788,208,560,264,384,273,683,956,280,124,32,281,352,1722
371,Omar Carter,2008,2012,Total,Total,121,3583,617,1440,443,946,174,494,313,438,216,561,777,187,124,21,235,239,1721
372,Walt Lemon ,2011,2014,Bradley,MVC,130,3935,628,1422,524,1098,104,324,361,502,50,367,417,367,222,44,404,340,1721
373,Isaiah Thomas,2009,2011,Washington,Pac-10,105,3197,554,1301,390,796,164,505,449,630,70,296,366,415,122,7,279,208,1721
374,Jalen Cannon,2012,2015,St. Francis (NY),NEC,127,3789,629,1198,583,1045,46,153,416,613,441,719,1160,115,91,71,162,244,1720
375,Juwan Howard,2011,2015,Total,Total,131,3733,620,1501,442,1007,178,494,302,365,166,376,542,248,101,60,219,260,1720
376,Zach Johnson,2016,2019,Total,Total,135,4033,607,1413,424,895,183,518,323,477,56,330,386,399,199,48,312,297,1720
377,Chris Horton,2013,2016,Austin Peay,OVC,127,3932,662,1200,662,1199,0,1,395,633,488,773,1261,144,132,319,270,288,1719
378,Paul Miller,2015,2018,North Dakota State,Summit,119,3838,569,1320,324,668,245,652,336,427,51,533,584,237,99,32,237,224,1719
379,Keith Clanton,2010,2013,Central Florida,CUSA,129,4040,622,1246,547,997,75,249,399,621,347,653,1000,236,130,227,339,328,1718
380,Demetri McCamey,2008,2011,Illinois,Big Ten,139,4374,597,1404,361,750,236,654,288,405,67,368,435,733,138,21,393,261,1718
381,T.J. Robinson,2009,2012,Long Beach State,Big West,131,3964,652,1235,643,1210,9,25,405,642,390,818,1208,95,77,11,278,290,1718
382,Billy Baron,2011,2014,Total,Total,105,3342,533,1214,319,656,214,558,436,513,61,347,408,416,120,1,246,134,1716
383,Cane Broome,2015,2019,Total,Total,131,3577,595,1356,423,828,172,528,353,469,59,321,380,337,140,9,283,214,1715
384,Michael Deloach,2008,2010,Norfolk State,MEAC,92,3014,638,1330,547,1040,91,290,348,510,118,282,400,282,197,15,313,271,1715
385,Justin Johnson,2015,2018,Western Kentucky,CUSA,135,3785,669,1241,595,1049,74,192,303,522,315,743,1058,184,67,79,175,235,1715
386,Joshua Braun,2015,2018,Grand Canyon,WAC,122,3641,504,1181,247,506,257,675,449,552,168,398,566,140,91,74,147,238,1714
387,Dewayne Russell,2013,2017,Total,Total,117,3962,565,1397,443,1067,122,330,459,623,55,299,354,525,169,13,297,253,1711
388,Josh Scott,2013,2016,Colorado,Pac-12,124,3761,600,1157,595,1141,5,16,506,657,365,609,974,128,80,161,151,232,1711
389,Robert Gray Jr.,2016,2018,Houston,AAC,91,2776,601,1326,429,851,172,475,336,429,67,231,298,277,105,14,185,164,1710
390,Dez Wells,2012,2015,Total,Total,130,3756,612,1238,527,1011,85,227,401,524,139,490,629,294,120,67,321,281,1710
391,Keion Bell,2009,2013,Total,Total,115,3193,581,1318,472,966,109,352,437,569,131,395,526,267,141,25,382,205,1708
392,Monte Morris,2014,2017,Iowa State,Big 12,140,4734,636,1336,484,937,152,399,284,364,108,408,516,768,225,41,165,212,1708
393,Kyle Collinsworth,2011,2016,Brigham Young,Total,140,4330,617,1293,587,1186,30,107,443,690,307,740,1047,703,229,61,367,302,1707
394,Jalen Adams,2016,2019,Connecticut,AAC,124,3901,655,1479,516,1063,139,416,257,312,101,358,459,511,148,40,318,245,1706
395,Mike Rosario,2009,2013,Total,Total,131,3628,602,1486,354,731,248,755,254,321,120,252,372,193,115,12,273,207,1706
396,Jeff Allen,2008,2011,Virginia Tech,ACC,134,3927,647,1327,611,1193,36,134,372,587,328,783,1111,173,233,150,354,460,1702
397,Chad Tomko,2008,2011,North Carolina-Wilmington,CAA,125,3989,590,1505,334,761,256,744,266,320,56,420,476,481,223,17,349,265,1702
398,Justin Sears,2013,2016,Yale,Ivy,120,3507,607,1184,596,1147,11,37,475,707,366,453,819,198,123,200,281,313,1700
399,Marc Trasolini,2009,2013,Santa Clara,WCC,137,3824,628,1139,568,957,60,182,383,517,299,547,846,100,87,176,215,340,1699
400,Craig Bradshaw,2013,2016,Belmont,OVC,130,3370,591,1235,342,603,249,632,267,350,78,327,405,328,155,35,279,251,1698
401,Joe Harris ,2011,2014,Virginia,ACC,135,4084,568,1276,305,630,263,646,299,414,116,393,509,254,116,48,213,307,1698
402,Jamel Artis,2014,2017,Pittsburgh,ACC,135,3726,579,1231,409,781,170,450,368,485,186,441,627,304,63,42,252,237,1696
403,Spencer Collins,2013,2016,Wofford,Southern,132,3882,573,1385,391,873,182,512,368,471,101,306,407,194,94,19,203,272,1696
404,Derrick Colter,2013,2016,Duquesne,A-10,125,3948,550,1383,311,708,239,675,356,472,72,297,369,526,107,16,326,256,1695
405,Sean Armand,2011,2014,Iona,MAAC,137,3447,566,1244,218,437,348,807,214,279,108,287,395,294,113,29,192,283,1694
406,Roy Devyn Marble,2011,2014,Iowa,Big Ten,136,3749,564,1359,430,963,134,396,432,595,118,342,460,397,176,33,232,212,1694
407,Ryan Harrow,2011,2015,Total,Total,121,3528,636,1423,530,1085,106,338,314,396,67,218,285,426,128,13,211,196,1692
408,Jalan West,2013,2018,Northwestern State,Southland,104,3191,522,1158,286,579,236,579,410,474,53,323,376,652,232,23,248,214,1690
409,J.P. Primm,2009,2012,North Carolina-Asheville,Big South,130,4047,517,1260,312,663,205,597,450,569,95,364,459,607,248,10,393,347,1689
410,Michael Thompson,2008,2011,Northwestern,Big Ten,129,4633,568,1300,292,625,276,675,277,365,50,208,258,528,159,10,240,347,1689
411,Marqus Blakely,2008,2010,Vermont,AEC,97,3246,599,1059,596,1035,3,24,487,809,317,627,944,280,209,234,302,271,1688
412,Joe Jackson,2011,2014,Memphis,Total,139,3983,540,1184,441,891,99,293,508,661,91,300,391,564,189,19,373,282,1687
413,Travis McKie,2011,2014,Wake Forest,ACC,127,4020,568,1228,447,861,121,367,430,567,241,575,816,146,127,101,234,271,1687
414,Eric Paschall,2015,2019,Total,Total,137,4057,589,1259,419,746,170,513,339,443,210,494,704,209,101,71,265,314,1687
415,Dylan Windler,2016,2019,Belmont,OVC,128,3759,593,1096,376,562,217,534,284,373,209,790,999,251,128,98,210,306,1687
416,Stefon Jackson,2008,2009,Texas-El Paso,CUSA,70,2494,543,1222,476,1013,67,209,533,677,117,271,388,128,78,7,155,177,1686
417,James Nunnally,2009,2012,UC-Santa Barbara,Big West,123,3618,558,1201,371,717,187,484,382,487,119,514,633,247,70,25,276,234,1685
418,Bradford Burgess,2009,2012,Virginia Commonwealth,CAA,146,4572,555,1243,324,660,231,583,343,450,223,511,734,210,146,60,190,318,1684
419,Tamir Jackson,2010,2013,Rice,CUSA,128,4118,573,1453,457,1030,116,423,422,616,98,328,426,387,162,2,342,315,1684
420,Danuel House,2013,2016,Total,Total,119,3587,547,1315,345,717,202,598,387,554,150,410,560,238,85,53,228,223,1683
421,Bryant McIntosh,2015,2018,Northwestern,Big Ten,129,4348,621,1519,451,1021,170,498,271,319,44,319,363,700,78,18,327,219,1683
422,Ben Smith,2008,2010,Jacksonville,A-Sun,96,3523,482,1183,288,651,194,532,525,652,77,247,324,391,192,8,231,160,1683
423,Andre Walker,2015,2018,Loyola (MD),Patriot,122,3814,546,1520,332,902,214,618,376,486,97,360,457,393,194,20,342,348,1682
424,Devin Gibson,2008,2011,Texas-San Antonio,Southland,119,3937,474,1123,384,845,90,278,643,844,153,377,530,549,323,18,355,321,1681
425,Kyle Allman,2016,2019,Cal State Fullerton,Big West,127,3690,532,1225,405,864,127,361,489,670,36,299,335,238,94,32,279,257,1680
426,Brandon Davies,2010,2013,Brigham Young,Total,135,3251,609,1166,603,1148,6,18,456,691,246,594,840,213,132,123,283,406,1680
427,Alec Brown,2011,2014,Green Bay,Horizon,126,3693,604,1299,526,1104,78,195,392,524,287,513,800,111,74,309,263,336,1678
428,Rahmon Fletcher,2008,2011,Green Bay,Horizon,128,3657,633,1338,483,939,150,399,262,352,68,229,297,438,197,9,341,316,1678
429,Daniel Mullings,2012,2015,New Mexico State,WAC,128,4008,579,1240,523,1062,56,178,463,651,207,401,608,342,249,60,322,260,1677
430,Jon Scheyer,2008,2010,Duke,ACC,111,3647,473,1158,237,545,236,613,493,570,108,304,412,379,169,25,159,172,1675
431,Jeromie Hill,2011,2015,Texas-San Antonio,Total,122,3823,637,1420,472,973,165,447,235,379,252,590,842,160,118,69,306,280,1674
432,Kareem Jamar,2011,2014,Montana,Big Sky,121,4032,565,1193,403,767,162,426,381,556,125,539,664,407,110,66,263,249,1673
433,Corey Fisher,2008,2011,Villanova,Big East,138,3662,530,1284,369,811,161,473,451,583,76,258,334,487,174,10,287,315,1672
434,Chris Gaston,2010,2013,Fordham,A-10,101,3409,652,1434,647,1402,5,32,363,585,361,677,1038,128,107,160,343,264,1672
435,Manny Harris,2008,2010,Michigan,Big Ten,98,3329,521,1283,379,836,142,447,484,585,153,406,559,366,144,36,313,182,1668
436,Josh White,2008,2011,North Texas,Sun Belt,126,4260,499,1177,314,680,185,497,485,571,62,238,300,331,68,2,282,189,1668
437,Jalen Brunson,2016,2018,Villanova,Big East,116,3349,579,1135,402,685,177,450,332,405,47,238,285,432,97,1,217,209,1667
438,Christian Keeling,2017,2019,Charleston Southern,Big South,93,3005,566,1257,415,828,151,429,383,490,91,508,599,194,108,44,211,190,1666
439,Marlain Veal,2016,2019,Southeastern Louisiana,Southland,132,3831,522,1206,351,739,171,467,451,586,106,383,489,596,222,12,464,315,1666
440,Parker Smith,2009,2013,Total,Total,128,3314,500,1222,139,319,361,903,304,359,33,262,295,130,76,12,214,208,1665
441,Jessie Govan,2016,2019,Georgetown,Big East,128,3235,612,1221,521,998,91,223,349,460,199,644,843,171,74,139,214,364,1664
442,Tyrell Nelson,2014,2017,Gardner-Webb,Big South,133,3412,653,1167,640,1128,13,39,345,550,332,542,874,139,89,85,253,387,1664
443,Myles Powell,2017,2019,Seton Hall,Big East,101,3088,541,1261,272,513,269,748,312,380,62,239,301,222,132,20,200,226,1663
444,Rakim Sanders,2008,2012,Total,Total,126,3637,632,1383,462,880,170,503,229,369,229,451,680,246,161,64,326,311,1663
445,Eric Wise,2009,2013,Total,Total,115,3538,587,1303,549,1192,38,111,450,615,259,477,736,236,100,38,224,308,1662
446,Ky Bowman,2017,2019,Boston College,ACC,98,3477,576,1331,355,761,221,570,288,378,80,547,627,382,131,34,295,250,1661
447,Bryce Brown,2016,2019,Auburn,SEC,130,3614,530,1339,152,374,378,965,223,284,64,192,256,183,115,15,166,232,1661
448,Jordan Dykstra,2011,2014,South Dakota State,Summit,130,3595,568,1171,375,737,193,434,332,428,208,627,835,190,70,54,202,314,1661
449,Marcus Gilbert,2013,2016,Fairfield,MAAC,127,3820,531,1246,289,571,242,675,357,468,125,480,605,154,91,69,271,291,1661
450,Tres Tinkle,2016,2019,Oregon State,Pac-12,95,3215,551,1179,417,766,134,413,425,544,160,510,670,276,142,52,239,235,1661
451,Chris Cokley,2015,2018,Alabama-Birmingham,CUSA,134,2934,678,1185,678,1182,0,3,304,401,318,538,856,162,92,80,178,273,1660
452,C.J. Fair,2011,2014,Syracuse,Total,143,4251,631,1367,570,1189,61,178,337,466,266,549,815,119,154,112,204,227,1660
453,Lamar Stevens,2017,2019,Penn State,Big Ten,104,3388,609,1387,548,1170,61,217,381,511,161,499,660,195,73,90,248,266,1660
454,Dylon Cormier,2011,2014,Loyola (MD),Total,115,3662,552,1280,456,940,96,340,459,662,241,226,467,210,185,26,182,242,1659
455,John Jenkins,2010,2012,Vanderbilt,SEC,98,2998,516,1102,210,403,306,699,320,374,41,224,265,111,67,27,130,122,1658
456,Jock Landale,2015,2018,Saint Mary's (CA),WCC,126,2776,652,1044,644,1015,8,29,346,469,250,592,842,153,33,94,204,289,1658
457,Myles Mack,2012,2015,Rutgers,Total,128,3931,541,1311,302,663,239,648,337,393,59,303,362,425,211,13,278,212,1658
458,Malik Story,2009,2013,Total,Total,129,3699,563,1390,293,666,270,724,262,368,44,323,367,249,103,19,280,274,1658
459,Ricky Tarrant,2012,2016,Total,Total,119,3760,468,1205,271,594,197,611,525,658,51,289,340,375,172,4,242,287,1658
460,Melo Trimble,2015,2017,Maryland,Big Ten,104,3415,489,1139,312,624,177,515,503,597,26,358,384,402,125,13,282,192,1658
461,Melvin Johnson,2013,2016,Virginia Commonwealth,A-10,140,3482,598,1459,313,685,285,774,176,224,79,211,290,218,141,7,171,202,1657
462,Gerald McLemore,2009,2012,Maine,AEC,116,3856,561,1383,238,538,323,845,212,253,46,238,284,147,118,24,189,223,1657
463,Desi Rodriguez,2015,2018,Seton Hall,Big East,129,3390,609,1286,470,900,139,386,300,448,179,451,630,182,138,45,214,293,1657
464,JaMychal Green,2009,2012,Alabama,SEC,123,3340,614,1184,611,1167,3,17,425,598,365,547,912,152,125,212,312,390,1656
465,Markel Brown,2011,2014,Oklahoma State,Big 12,134,4088,551,1255,405,834,146,421,407,555,104,475,579,308,136,113,239,285,1655
466,Brandon Paul,2010,2013,Illinois,Big Ten,138,3665,521,1356,310,706,211,650,401,554,116,408,524,310,155,67,312,295,1654
467,Martez Harrison,2014,2017,Missouri-Kansas City,WAC,99,3212,504,1222,378,820,126,402,518,722,70,237,307,393,162,4,307,271,1652
468,Damion James,2008,2010,Texas,Big 12,107,3248,606,1272,504,1000,102,272,338,520,329,736,1065,131,117,121,207,291,1652
469,Taylor Braun,2011,2014,North Dakota State,Summit,116,3495,536,1105,411,803,125,302,454,581,107,564,671,338,153,27,268,261,1651
470,Torin Dorn,2015,2019,Total,Total,133,3622,648,1288,551,993,97,295,258,389,214,519,733,158,102,30,220,207,1651
471,Brandon Goodwin,2014,2018,Total,Total,126,3633,575,1212,457,820,118,392,383,535,116,396,512,477,137,11,290,214,1651
472,Keiton Page,2009,2012,Oklahoma State,Big 12,134,4322,496,1226,197,414,299,812,360,419,20,198,218,265,144,4,194,329,1651
473,Durand Scott,2010,2013,Miami (FL),ACC,132,4238,580,1285,482,995,98,290,392,507,153,423,576,404,166,18,292,304,1650
474,Mike Caffey,2012,2015,Long Beach State,Big West,132,4001,595,1429,418,897,177,532,282,422,129,370,499,457,178,18,320,251,1649
475,Darius Johnson-Odom,2010,2012,Marquette,Big East,105,3238,558,1257,337,708,221,549,312,432,56,265,321,262,93,17,223,237,1649
476,R.J. Price,2012,2015,Radford,Big South,131,3900,544,1477,243,629,301,848,260,367,53,302,355,369,166,14,248,203,1649
477,Justin Jackson,2015,2017,North Carolina,ACC,118,3430,623,1353,453,853,170,500,232,326,181,300,481,312,76,45,164,179,1648
478,Jordan McLaughlin,2015,2018,Southern California,Pac-12,128,4294,572,1304,387,816,185,488,319,432,83,371,454,739,213,22,303,134,1648
479,Tyus Battle,2017,2019,Syracuse,ACC,103,3649,549,1315,370,781,179,534,370,461,49,236,285,214,135,23,183,210,1647
480,Kevin Dillard,2009,2013,Total,Total,124,3898,522,1245,340,763,182,482,421,516,50,253,303,614,154,26,365,304,1647
481,Marshall Henderson,2010,2014,Total,Total,96,2891,495,1341,163,376,332,965,325,382,33,211,244,151,115,7,168,172,1647
482,Michael Oguine,2016,2019,Montana,Big Sky,127,3876,534,1164,403,785,131,379,448,616,203,470,673,235,161,62,199,364,1647
483,Cameron Jones,2008,2011,Northern Arizona,Big Sky,118,3214,630,1309,520,1039,110,270,276,362,80,316,396,319,113,8,264,196,1646
484,Frantz Massenat,2011,2014,Drexel,CAA,128,4381,505,1261,353,842,152,419,484,649,57,303,360,548,100,49,264,332,1646
485,Pendarvis Williams,2011,2014,Norfolk State,MEAC,132,3913,545,1166,328,600,217,566,339,417,117,416,533,269,137,55,214,244,1646
486,Jalen Moore,2014,2017,Utah State,MWC,126,3833,574,1210,402,761,172,449,325,435,136,517,653,241,72,69,169,182,1645
487,Giddy Potts,2015,2018,Middle Tennessee,CUSA,134,3610,557,1245,271,559,286,686,245,305,84,497,581,202,148,30,172,320,1645
488,Rodney Pryor,2015,2017,Total,Total,96,3003,591,1270,377,708,214,562,249,314,126,429,555,151,108,58,188,225,1645
489,Ben Uzoh,2008,2010,Tulsa,CUSA,110,3747,561,1215,417,793,144,422,379,481,127,423,550,379,127,73,265,196,1645
490,Denzel Valentine,2013,2016,Michigan State,Big Ten,144,4182,579,1309,314,659,265,650,222,285,157,698,855,639,132,40,317,303,1645
491,Ricky Cadell,2008,2011,St. Francis (NY),NEC,116,3685,551,1347,329,716,222,631,319,440,92,285,377,253,133,0,317,263,1643
492,Melvin Ejim,2011,2014,Iowa State,Big 12,135,3752,596,1198,504,896,92,302,359,491,374,677,1051,188,146,59,246,423,1643
493,Eli Cain,2016,2019,DePaul,Big East,129,4165,564,1416,385,912,179,504,335,489,80,381,461,405,127,42,293,326,1642
494,Branden Frazier,2011,2014,Fordham,A-10,118,4138,539,1447,353,813,186,634,378,479,112,300,412,495,110,23,317,236,1642
495,Mike Moore,2008,2012,Total,Total,121,3424,535,1326,326,741,209,585,362,448,106,395,501,190,131,22,230,273,1641
496,Dee Bost,2009,2012,Mississippi State,SEC,122,4192,498,1296,261,606,237,690,407,557,72,385,457,633,193,20,379,262,1640
497,Vince Edwards,2015,2018,Purdue,Big Ten,138,3957,589,1244,416,803,173,441,287,350,265,514,779,403,69,64,237,277,1638
498,Ron Baker,2013,2016,Wichita State,MVC,124,3795,522,1205,280,550,242,655,350,437,99,421,520,345,163,76,177,215,1636
499,Corey Petros,2012,2015,Oakland,Total,135,4516,664,1152,664,1151,0,1,308,603,409,664,1073,174,67,49,195,341,1636
500,Matt Gatens,2009,2012,Iowa,Big Ten,128,4444,525,1264,286,612,239,652,346,401,98,357,455,298,141,22,216,262,1635
501,Lazar Hayward,2008,2010,Marquette,Big East,104,3095,584,1282,425,857,159,425,308,379,237,549,786,112,138,40,195,298,1635
502,Jalen Jones,2012,2016,Total,Total,128,3523,568,1247,503,1039,65,208,434,627,271,522,793,97,113,61,212,347,1635
503,Zane Najdawi,2016,2019,Citadel,Southern,126,3056,566,1165,459,874,107,291,395,515,253,475,728,114,103,197,252,371,1634
504,Fuquan Edwin,2011,2014,Seton Hall,Big East,127,3847,606,1358,434,886,172,472,249,366,148,457,605,182,295,51,235,380,1633
505,Arlon Harper,2012,2015,Charleston Southern,Big South,122,3464,557,1287,362,752,195,535,324,435,106,353,459,256,226,29,214,290,1633
506,Bonzie Colson,2015,2018,Notre Dame,ACC,125,3132,609,1154,561,1017,48,137,366,474,266,634,900,122,125,155,126,245,1632
507,Billy Garrett,2014,2017,DePaul,Big East,125,3649,463,1199,322,762,141,437,565,672,36,296,332,432,108,24,321,344,1632
508,Lucky Jones,2012,2015,Robert Morris,NEC,136,3769,494,1219,298,661,196,558,448,562,244,602,846,186,171,36,264,352,1632
509,David Walker,2013,2016,Northeastern,CAA,133,4710,517,1200,267,547,250,653,347,418,70,351,421,420,180,47,244,110,1631
510,Shavon Shields,2013,2016,Nebraska,Big Ten,121,3861,562,1236,485,976,77,260,429,565,162,505,667,223,123,32,254,304,1630
511,Trae Bell-Haynes,2015,2018,Vermont,AEC,139,3944,524,1066,444,858,80,208,501,657,79,347,426,518,148,14,373,314,1629
512,Marshon Brooks,2008,2011,Providence,Big East,113,2855,587,1265,429,790,158,475,297,402,179,307,486,175,129,81,207,222,1629
513,Shep Garner,2015,2018,Penn State,Big Ten,138,4443,532,1356,196,469,336,887,229,291,47,321,368,317,151,16,221,272,1629
514,Jarvis Summers,2012,2015,Mississippi,SEC,134,3885,520,1285,394,931,126,354,463,640,61,222,283,530,119,23,291,340,1629
515,Tristan Thompson,2008,2011,North Texas,Sun Belt,128,3266,463,1055,280,593,183,462,520,637,81,275,356,170,74,8,212,229,1629
516,Grant Williams,2017,2019,Tennessee,SEC,104,3002,549,1064,519,961,30,103,501,661,257,421,678,219,89,160,219,331,1629
517,Bill Clark,2008,2011,Duquesne,A-10,126,3549,516,1168,289,511,227,657,369,517,233,447,680,275,137,45,263,413,1628
518,J.J. Frazier,2014,2017,Georgia,SEC,130,3528,487,1212,283,636,204,576,450,535,54,388,442,422,164,15,201,287,1628
519,Deshaun Thomas,2011,2013,Ohio State,Big Ten,113,3052,607,1269,464,851,143,418,271,338,225,335,560,100,48,26,129,160,1628
520,Evan Roquemore,2011,2014,Santa Clara,WCC,135,4272,469,1258,264,681,205,577,484,600,75,368,443,578,131,41,326,299,1627
521,Jordan Downing,2011,2015,Total,Total,121,3456,595,1414,370,820,225,594,211,273,61,363,424,143,68,24,207,202,1626
522,Stephen Madison,2011,2014,Idaho,WAC,129,3418,544,1173,409,773,135,400,403,537,183,461,644,238,82,44,258,314,1626
523,Ryan Pearson,2009,2012,George Mason,CAA,129,3441,573,1165,513,990,60,175,420,608,237,569,806,157,127,58,230,314,1626
524,Ahmad Thomas,2015,2018,North Carolina-Asheville,Big South,122,3470,671,1329,601,1128,70,201,214,346,165,539,704,256,251,40,245,300,1626
525,Lucas Troutman,2011,2014,Elon,Southern,124,3168,636,1219,635,1215,1,4,353,533,224,427,651,80,106,213,218,292,1626
526,Ian Hummer,2010,2013,Princeton,Ivy,123,3523,625,1225,599,1141,26,84,349,524,211,514,725,308,140,109,282,233,1625
527,Jeremiah Martin,2016,2019,Memphis,AAC,124,3679,517,1173,370,720,147,453,444,596,96,301,397,436,222,70,249,238,1625
528,Patrick Richard,2009,2012,McNeese State,Southland,123,3550,546,1259,422,857,124,402,409,540,193,438,631,302,128,62,255,268,1625
529,Kyan Anderson,2012,2015,Texas Christian,Total,129,4126,520,1232,330,703,190,529,394,479,41,190,231,480,168,7,328,221,1624
530,Jerome Frink,2013,2017,Total,Total,125,3910,619,1296,531,1026,88,270,297,455,304,585,889,159,122,118,286,371,1623
531,Jarrod Jones,2009,2012,Ball State,MAC,123,3587,622,1314,609,1267,13,47,366,535,264,717,981,105,85,115,229,300,1623
532,Tyrone Wallace,2013,2016,University of California,Pac-12,129,4074,588,1417,470,1013,118,404,329,537,130,544,674,436,139,55,279,328,1623
533,Akeem Richmond,2010,2014,Total,Total,139,3514,514,1338,98,256,416,1082,178,216,67,235,302,146,115,5,128,153,1622
534,George Fant,2012,2015,Western Kentucky,Total,129,3671,592,1171,592,1168,0,3,437,723,367,527,894,123,112,124,273,402,1621
535,Jerrick Harding,2017,2019,Weber State,Big Sky,93,2597,555,1110,404,727,151,383,360,413,45,221,266,120,101,22,164,166,1621
536,Quinn McDowell,2009,2012,William & Mary,CAA,126,4093,528,1141,315,611,213,530,352,433,138,461,599,190,77,12,172,254,1621
537,Jerome Randle,2008,2010,University of California,Pac-10,99,3389,525,1131,299,595,226,536,345,387,40,210,250,431,76,0,311,173,1621
538,Joe Rosga,2016,2019,Denver,Summit,115,3849,534,1171,289,596,245,575,308,349,62,329,391,312,122,4,222,210,1621
539,Ryan Thompson,2008,2010,Rider,MAAC,97,3519,538,1110,410,776,128,334,417,532,181,390,571,304,147,42,237,222,1621
540,Joe Zeglinski,2008,2011,Hartford,AEC,104,3745,553,1442,229,539,324,903,191,278,125,338,463,219,105,17,190,256,1621
541,Michael Bryson,2013,2016,UC-Santa Barbara,Big West,124,3758,561,1243,320,592,241,651,257,316,133,460,593,219,96,78,253,336,1620
542,Matt Carlino,2012,2015,Total,Total,124,3604,557,1397,317,731,240,666,266,359,67,358,425,525,201,16,307,234,1620
543,Ray McCallum,2011,2013,Detroit Mercy,Horizon,102,3519,546,1173,449,838,97,335,429,593,126,360,486,451,175,32,233,210,1618
544,Sean McGonagill,2011,2014,Brown,Ivy,114,4110,538,1363,289,680,249,683,293,387,70,429,499,522,132,8,327,273,1618
545,B.J. Taylor,2015,2019,Central Florida,AAC,104,3541,491,1248,311,747,180,501,456,622,35,267,302,324,93,3,178,165,1618
546,Christen Cunningham,2015,2019,Total,Total,143,4621,546,1236,461,957,85,279,440,545,65,302,367,674,125,9,326,209,1617
547,Quincy Ford,2012,2016,Northeastern,CAA,130,4148,526,1277,322,692,204,585,361,478,184,557,741,245,180,113,269,291,1617
548,Jordan Mathews,2014,2017,Total,Total,141,3799,513,1226,227,527,286,699,305,395,91,338,429,170,82,8,145,240,1617
549,Jonathan Rodriguez,2008,2010,Campbell,A-Sun,90,2940,528,1097,472,921,56,176,505,651,256,538,794,192,130,41,264,205,1617
550,Joe Cremo,2016,2019,Total,Total,136,3649,524,1150,345,703,179,447,387,460,87,417,504,344,103,22,232,219,1614
551,C.J. Harris,2010,2013,Wake Forest,ACC,124,3970,459,1063,297,646,162,417,533,639,39,288,327,282,116,7,299,296,1613
552,Scott Machado,2009,2012,Iona,MAAC,132,4143,529,1232,406,872,123,360,432,584,105,405,510,880,191,17,440,315,1613
553,Dillon Brooks,2015,2017,Oregon,Pac-12,109,3153,587,1243,454,876,133,367,305,384,174,321,495,279,96,51,234,320,1612
554,Milik Yarbrough,2015,2019,Total,Total,124,3137,577,1279,493,1008,84,271,373,518,151,566,717,338,85,58,375,280,1611
555,Zaid Hearst,2012,2015,Quinnipiac,Total,125,3764,542,1254,405,852,137,402,389,492,238,390,628,224,73,37,193,268,1610
556,Zak Irvin,2014,2017,Michigan,Big Ten,142,4220,600,1417,359,736,241,681,169,249,85,446,531,282,103,9,199,163,1610
557,Aaron Bacote,2013,2016,Old Dominion,Total,137,3773,495,1233,322,708,173,525,446,560,75,319,394,354,112,18,283,282,1609
558,Yoeli Childs,2017,2019,Brigham Young,WCC,100,3111,626,1185,579,1036,47,149,310,473,197,684,881,184,80,142,221,243,1609
559,Noah Dickerson,2016,2019,Washington,Pac-12,134,3425,562,1040,559,1024,3,16,482,682,322,657,979,96,100,75,258,432,1609
560,Bryan Dougher,2009,2012,Stony Brook,AEC,126,4067,514,1415,177,515,337,900,244,300,75,231,306,233,125,12,204,247,1609
561,Darrion Pellum,2009,2012,Hampton,MEAC,112,3632,549,1471,352,820,197,651,314,438,98,340,438,172,146,25,285,216,1609
562,ShawnDre' Jones,2014,2017,Richmond,A-10,131,3750,539,1236,312,648,227,588,303,374,46,168,214,364,104,7,187,256,1608
563,Kyle O'Quinn,2009,2012,Norfolk State,MEAC,129,3542,610,1104,556,897,54,207,333,486,332,760,1092,122,69,283,262,378,1607
564,Milton Doyle,2014,2017,Loyola (IL),MVC,121,3677,538,1229,398,822,140,407,390,543,83,411,494,459,151,76,380,317,1606
565,Julian Norfleet,2011,2014,Mount St. Mary's,NEC,126,4175,569,1402,327,689,242,713,225,312,78,300,378,423,153,40,279,265,1605
566,Ryan Arcidiacono,2013,2016,Villanova,Big East,144,4592,487,1228,226,499,261,729,369,461,44,289,333,535,169,4,253,282,1604
567,Ike Azotam,2011,2014,Quinnipiac,Total,126,3444,628,1240,628,1239,0,1,347,561,430,613,1043,97,62,99,191,359,1603
568,Marcus Keene,2014,2017,Total,Total,86,2655,527,1199,289,574,238,625,310,385,38,259,297,293,72,3,242,172,1602
569,Josh Slater,2008,2011,Lipscomb,A-Sun,122,3313,487,1148,343,713,144,435,484,672,144,445,589,462,224,33,336,272,1602
570,Jeremy Combs,2015,2019,Total,Total,120,3396,598,1014,593,991,5,23,400,716,361,627,988,101,146,80,228,357,1601
571,Chris Wright,2008,2011,Dayton,A-10,123,3320,591,1208,566,1099,25,109,394,595,299,588,887,148,100,162,303,321,1601
572,DeWayne Jackson,2010,2013,Morgan State,MEAC,128,3620,562,1323,373,707,189,616,287,406,155,408,563,187,174,93,238,389,1600
573,Zach Lofton,2014,2018,Total,Total,99,2906,511,1238,341,710,170,528,407,524,87,307,394,188,113,16,198,212,1599
574,Melvin Johnson,2010,2014,Total,Total,124,2927,527,1199,245,534,282,665,262,319,61,348,409,104,99,12,200,192,1598
575,Shizz Alston Jr.,2016,2019,Temple,AAC,129,3799,543,1360,293,656,250,704,261,295,63,277,340,417,131,19,195,224,1597
576,Adrian Rodgers,2012,2016,Total,Total,136,3554,585,1406,418,904,167,502,260,346,101,383,484,226,110,13,257,236,1597
577,Desmond Washington,2011,2015,Total,Total,116,3883,514,1323,271,628,243,695,325,384,43,303,346,126,140,7,192,205,1596
578,Fred Hunter,2009,2013,Nicholls State,Southland,108,2994,584,1076,530,880,54,196,373,581,269,340,609,152,148,14,248,298,1595
579,Angel Delgado,2015,2018,Seton Hall,Big East,132,4039,644,1196,644,1191,0,5,305,566,518,937,1455,227,82,101,286,332,1593
580,A.J. Hammons,2013,2016,Purdue,Big Ten,132,3201,613,1138,607,1115,6,23,361,523,314,616,930,104,50,343,271,325,1593
581,Rodney Purvis,2013,2017,Total,Total,137,4097,568,1367,337,731,231,636,226,354,62,346,408,243,113,19,227,265,1593
582,Sherrod Wright,2010,2014,George Mason,Total,132,3530,529,1132,422,816,107,316,428,566,132,313,445,138,106,30,263,232,1593
583,Robo Kreps,2008,2011,Illinois-Chicago,Horizon,125,3944,532,1287,302,662,230,625,298,365,71,343,414,246,146,4,226,169,1592
584,Ryan Wittman,2008,2010,Cornell,Ivy,93,3149,552,1191,268,533,284,658,204,245,42,321,363,185,90,23,159,189,1592
585,Ryan Broekhoff,2010,2013,Valparaiso,Horizon,134,3642,512,1103,260,485,252,618,315,385,189,652,841,246,129,100,186,236,1591
586,Devontae Cacok,2016,2019,North Carolina-Wilmington,CAA,129,3064,650,1018,649,1016,1,2,290,490,450,812,1262,66,112,91,198,418,1591
587,Jerome Robinson,2016,2018,Boston College,ACC,90,3118,562,1249,403,826,159,423,308,408,46,297,343,294,117,24,259,226,1591
588,DeAndre Bembry,2014,2016,Saint Joseph's,A-10,101,3645,580,1270,460,885,120,385,310,494,137,535,672,364,143,78,248,249,1590
589,Brandon Bowdry,2009,2011,Eastern Michigan,MAC,94,2936,570,1241,514,1059,56,182,394,589,235,598,833,149,94,31,295,265,1590
590,Darryl Bryant,2009,2012,West Virginia,Big East,135,3824,455,1268,258,665,197,603,483,616,76,242,318,388,117,4,292,288,1590
591,JayVaughn Pinkston,2012,2015,Villanova,Big East,136,3571,495,1063,462,948,33,115,567,780,269,468,737,182,113,78,288,340,1590
592,Ramon Galloway,2010,2013,Total,Total,126,3567,541,1315,296,680,245,635,261,340,81,376,457,323,163,33,313,292,1588
593,Velton Jones,2010,2013,Robert Morris,NEC,135,3686,469,1261,314,777,155,484,495,688,80,245,325,551,220,5,347,382,1588
594,Jermaine Crumpton,2015,2018,Canisius,MAAC,121,3104,573,1237,414,798,159,439,282,387,175,300,475,132,80,40,175,259,1587
595,Tyler Hansbrough,2008,2009,North Carolina,ACC,73,2315,512,969,503,939,9,30,553,673,254,421,675,69,101,26,146,170,1586
596,Brian Stafford,2009,2012,Denver,Sun Belt,124,4101,501,1040,237,424,264,616,320,399,50,209,259,248,119,21,212,331,1586
597,Ella Ellis,2010,2013,Army,Patriot,120,2952,479,1129,286,619,193,510,434,532,130,336,466,159,75,45,206,245,1585
598,Rob Jones,2008,2012,Total,WCC,134,3943,627,1326,534,1016,93,310,238,370,301,698,999,222,150,77,302,382,1585
599,Deion Holmes,2016,2019,South Carolina Upstate,Total,123,3127,564,1355,367,766,197,589,259,322,130,258,388,156,61,15,268,251,1584
600,Kyle Gibson,2008,2010,Louisiana Tech,WAC,93,3290,479,1140,277,615,202,525,423,543,88,296,384,221,94,17,233,222,1583
601,Isaiah Pineiro,2016,2019,Total,Total,101,2912,557,1129,481,904,76,225,393,495,145,577,722,181,118,63,241,328,1583
602,Tim Ambrose,2008,2011,Albany (NY),AEC,124,3083,584,1303,458,965,126,338,288,382,174,401,575,308,128,14,329,328,1582
603,Jackie Carmichael,2010,2013,Illinois State,MVC,131,3273,575,1113,571,1095,4,18,426,619,264,678,942,88,82,200,241,329,1580
604,Jaren Lewis,2016,2019,Abilene Christian,Southland,126,3666,595,1180,538,1022,57,158,333,449,231,594,825,253,191,82,244,278,1580
605,Sa'eed Nelson,2017,2019,American,Patriot,89,3305,558,1203,485,935,73,268,391,593,74,330,404,383,195,25,304,228,1580
606,Tyshawn Taylor,2009,2012,Kansas,Big 12,146,4039,551,1156,431,832,120,324,358,506,47,277,324,575,172,31,379,307,1580
607,Langston Hall,2011,2014,Mercer,A-Sun,138,4541,481,1221,225,544,256,677,361,447,58,380,438,633,177,35,322,242,1579
608,Harouna Mutombo,2009,2012,Western Carolina,Southern,132,3815,601,1343,503,1005,98,338,278,508,233,451,684,271,185,55,252,298,1578
609,Caleb White,2014,2017,East Carolina,Total,129,4083,539,1244,283,568,256,676,244,317,78,317,395,216,69,25,188,290,1578
610,Johnathan Jordan,2012,2015,Texas A&M-Corpus Christi,Southland,126,4341,492,1145,459,1007,33,138,559,827,138,381,519,652,182,18,335,307,1576
611,Rodney McGruder,2010,2013,Kansas State,Big 12,135,3702,568,1257,380,763,188,494,252,332,254,400,654,186,116,36,171,205,1576
612,Khalif Wyatt,2010,2013,Temple,A-10,109,2881,482,1083,305,588,177,495,435,525,54,219,273,295,172,27,227,207,1576
613,Kwamain Mitchell,2009,2013,Saint Louis,A-10,124,3939,547,1257,347,690,200,567,281,405,60,291,351,420,172,5,280,293,1575
614,Carson Puriefoy,2013,2016,Stony Brook,AEC,132,3651,494,1242,308,739,186,503,398,517,63,290,353,345,144,27,296,257,1572
615,Quinn Cook,2012,2015,Duke,ACC,143,4033,534,1235,298,606,236,629,267,313,53,326,379,509,151,9,201,264,1571
616,Keenan Evans,2015,2018,Texas Tech,Big 12,131,3390,490,1103,357,734,133,369,458,575,65,290,355,346,128,38,223,244,1571
617,Reggie Upshaw,2014,2017,Middle Tennessee,CUSA,140,3967,598,1230,511,961,87,269,288,482,288,622,910,257,151,110,213,316,1571
618,Charles Cooke,2013,2017,Total,Total,123,3725,506,1166,347,730,159,436,399,568,140,433,573,221,135,98,208,221,1570
619,Kim English,2009,2012,Missouri,Big 12,141,3409,515,1227,276,621,239,606,301,414,94,336,430,204,151,28,236,253,1570
620,Zach Jackson,2016,2019,Omaha,Summit,126,3413,536,1101,383,734,153,367,345,434,144,393,537,147,108,24,180,256,1570
621,Admiral Schofield,2016,2019,Tennessee,SEC,132,3288,585,1277,401,801,184,476,216,283,168,536,704,177,88,47,188,349,1570
622,Justin Strings,2015,2018,Sacramento State,Big Sky,119,3260,584,1313,439,898,145,415,257,399,138,484,622,144,52,68,152,249,1570
623,B.J. Tyson,2015,2018,East Carolina,AAC,120,3589,569,1355,448,939,121,416,311,418,102,370,472,268,107,18,231,199,1570
624,Eugene German,2017,2019,Northern Illinois,MAC,94,2534,580,1212,415,762,165,450,244,346,38,287,325,170,76,13,185,155,1569
625,Bryson Scott,2014,2018,Total,Total,123,2723,531,1196,417,834,114,362,393,515,77,357,434,235,169,14,247,213,1569
626,Byron Wesley,2012,2015,Total,Total,132,4179,583,1273,525,1103,58,170,345,516,143,530,673,273,111,39,251,213,1569
627,Devon Beitzel,2008,2011,Northern Colorado,Big Sky,115,3002,499,1044,264,460,235,584,335,397,67,239,306,186,149,3,192,194,1568
628,Jordan Loveridge,2013,2016,Utah,Pac-12,129,3993,513,1264,290,678,223,586,319,399,145,555,700,231,90,38,211,246,1568
629,Sam Merrill,2017,2019,Utah State,MWC,100,3252,520,1098,290,556,230,542,298,335,31,312,343,350,101,21,160,240,1568
630,Stuckey Mosley,2015,2019,Total,Total,130,3618,542,1336,317,713,225,623,259,336,64,385,449,286,134,19,204,273,1568
631,Jake Odum,2011,2014,Indiana State,MVC,134,4199,452,1008,378,778,74,230,590,781,94,523,617,603,204,34,326,310,1568
632,Tyler Stone,2010,2014,Total,Total,104,3029,632,1208,590,1071,42,137,262,369,186,591,777,125,77,124,152,230,1568
633,Brian Sullivan,2012,2016,Total,Total,125,4053,517,1304,166,414,351,890,180,227,40,302,342,335,95,7,176,264,1565
634,Alvin Abreu,2008,2012,New Hampshire,AEC,117,3844,527,1421,312,768,215,653,295,395,106,296,402,222,111,22,273,199,1564
635,Schadrac Casimir,2015,2019,Total,Total,138,3866,472,1066,193,439,279,627,341,388,68,236,304,270,119,4,177,228,1564
636,Tyler Harvey,2013,2015,Eastern Washington,Big Sky,84,2635,494,1066,234,464,260,602,316,373,49,244,293,197,86,16,151,162,1564
637,Patrick Patterson,2008,2010,Kentucky,SEC,97,3295,617,1054,593,981,24,73,306,417,279,512,791,146,69,152,159,206,1564
638,Brandon Triche,2010,2013,Syracuse,Big East,147,3938,536,1242,363,722,173,520,319,425,151,233,384,438,146,14,303,250,1564
639,Darion Anderson,2008,2011,Total,Total,119,3650,538,1294,416,889,122,405,365,516,187,524,711,327,140,14,358,260,1563
640,Joe Sherburne,2016,2019,Maryland-Baltimore County,AEC,136,4244,577,1252,311,583,266,669,143,174,147,464,611,255,118,27,164,293,1563
641,Anthony Brown,2011,2015,Stanford,Total,144,4200,518,1211,300,670,218,541,308,410,139,552,691,231,99,23,228,257,1562
642,Josh Perkins,2015,2019,Gonzaga,WCC,153,4689,531,1211,280,560,251,651,249,332,66,363,429,709,178,25,310,363,1562
643,Adam Smith,2012,2016,Total,Total,114,3384,549,1358,277,662,272,696,192,242,41,258,299,178,44,6,137,178,1562
644,Edwin Ubiles,2008,2010,Siena,MAAC,99,3230,627,1259,543,1037,84,222,224,337,133,298,431,199,126,74,204,132,1562
645,Olin Carter III,2016,2019,San Diego,WCC,125,4061,537,1338,233,495,304,843,180,234,30,321,351,212,95,31,168,316,1558
646,Juwan Staten,2011,2015,Total,Total,129,4046,542,1269,511,1161,31,108,443,628,72,358,430,623,140,6,269,201,1558
647,Beau Beech,2013,2016,North Florida,A-Sun,133,3817,505,1193,203,424,302,769,245,322,138,534,672,184,147,53,227,375,1557
648,Wesley Jenkins,2008,2011,Saint Peter's,MAAC,113,3702,525,1439,252,721,273,718,234,317,70,424,494,146,172,38,249,233,1557
649,Erick Neal,2015,2018,Texas-Arlington,Sun Belt,132,3880,521,1281,259,541,262,740,253,350,83,368,451,756,217,10,396,297,1557
650,Angelo Warner,2012,2015,Morehead State,OVC,130,3606,488,1105,324,637,164,468,417,520,173,402,575,299,207,18,272,311,1557
651,Antonius Cleveland,2014,2017,Southeast Missouri State,OVC,121,3488,585,1184,523,969,62,215,324,529,170,402,572,242,159,76,225,315,1556
652,"Ed Polite, Jr.",2016,2019,Radford,Big South,131,4031,562,1118,509,934,53,184,379,562,345,774,1119,189,199,159,241,309,1556
653,Frankie Sullivan,2009,2013,Auburn,SEC,134,3755,497,1268,269,555,228,713,334,431,79,355,434,287,190,26,243,339,1556
654,Isaac Haas,2015,2018,Purdue,Big Ten,139,2496,561,953,561,953,0,0,433,628,216,427,643,71,22,124,229,289,1555
655,Holton Hunsaker,2011,2014,Utah Valley,Total,127,4161,427,1220,189,515,238,705,463,531,21,266,287,438,158,1,320,319,1555
656,Nick Faust,2012,2016,Total,Total,137,3827,518,1279,324,698,194,581,323,471,136,464,600,304,156,50,299,297,1553
657,Omar Samhan,2008,2010,Saint Mary's (CA),WCC,101,2887,619,1135,619,1128,0,7,315,450,355,574,929,128,45,211,179,282,1553
658,Damier Pitts,2009,2012,Marshall,CUSA,123,3771,483,1197,282,592,201,605,384,475,61,223,284,517,101,5,328,283,1551
659,Chaisson Allen,2008,2011,Northeastern,CAA,125,4418,513,1239,333,734,180,505,344,476,160,482,642,430,232,13,273,232,1550
660,Ron Curry,2013,2016,James Madison,CAA,128,4205,493,1222,302,658,191,564,373,518,76,357,433,417,131,34,209,262,1550
661,Doug Davis,2009,2012,Princeton,Ivy,122,3940,545,1291,269,604,276,687,184,228,40,213,253,171,131,16,200,197,1550
662,Patricio Garino,2013,2016,George Washington,A-10,129,3877,567,1116,465,836,102,280,314,468,206,355,561,221,220,94,289,334,1550
663,Justin Greene,2009,2012,Kent State,MAC,134,3414,574,1142,574,1141,0,1,402,547,276,538,814,155,114,121,296,291,1550
664,Mark Nwakamma,2012,2015,Hartford,AEC,121,3235,598,1174,559,1054,39,120,315,477,188,442,630,203,121,75,342,399,1550
665,Michael Snaer,2010,2013,Florida State,ACC,133,3851,525,1236,329,725,196,511,304,387,93,360,453,265,119,42,326,281,1550
666,Brandon Clark,2012,2015,Santa Clara,WCC,133,3437,493,1225,328,739,165,486,398,474,75,253,328,410,114,8,240,299,1549
667,Josh Greene,2011,2014,Cal State Northridge,Big West,125,3594,455,1167,227,577,228,590,411,472,61,256,317,360,128,11,240,253,1549
668,DaVonte Lacy,2012,2015,Washington State,Pac-12,116,3516,467,1141,218,448,249,693,365,476,79,258,337,217,100,14,202,239,1548
669,Alec Wintering,2014,2017,Portland,WCC,110,3492,471,1104,364,837,107,267,499,631,63,279,342,568,177,2,324,289,1548
670,E.J. Singler,2010,2013,Oregon,Total,142,4165,507,1134,339,683,168,451,364,429,192,535,727,286,110,63,253,350,1546
671,Marquis Wright,2014,2017,Siena,MAAC,121,4251,544,1295,445,1002,99,293,359,496,163,336,499,614,199,35,354,301,1546
672,Tucker Haymond,2014,2017,Western Michigan,MAC,123,3557,518,1150,391,762,127,388,382,528,188,398,586,233,82,9,252,252,1545
673,Isaiah Sykes,2011,2014,Central Florida,Total,126,3574,588,1194,554,1091,34,103,335,599,303,461,764,336,183,34,344,294,1545
674,T.T. Carey,2010,2014,Total,Total,112,3273,571,1322,334,678,237,644,165,228,99,452,551,194,154,53,185,243,1544
675,Eli Carter,2012,2016,Total,Total,122,3417,525,1384,323,727,202,657,292,375,42,305,347,300,128,12,307,252,1544
676,Steffphon Pettigrew,2008,2011,Western Kentucky,Sun Belt,136,3621,579,1233,467,897,112,336,274,440,280,390,670,116,85,52,202,296,1544
677,Osiris Eldridge,2008,2010,Illinois State,MVC,102,3371,534,1294,305,666,229,628,246,331,131,411,542,234,149,36,230,207,1543
678,Tim Frazier,2010,2014,Penn State,Big Ten,135,4132,508,1214,434,975,74,239,453,585,115,407,522,641,196,20,355,342,1543
679,Mike Black,2010,2013,Albany (NY),AEC,128,3831,508,1190,328,730,180,460,346,470,70,239,309,383,114,3,340,241,1542
680,Bennie Boatwright,2016,2019,Southern California,Pac-12,106,3005,511,1182,268,543,243,639,277,365,161,448,609,190,51,70,153,262,1542
681,Jawan Carter,2009,2011,Delaware,CAA,94,3414,435,1116,215,481,220,635,452,558,66,228,294,308,101,1,237,230,1542
682,Justin Hurtt,2008,2011,Tulsa,CUSA,120,3252,512,1212,285,614,227,598,291,361,63,285,348,172,53,19,211,182,1542
683,Craig Brackins,2008,2010,Iowa State,Big 12,96,3052,572,1285,503,1049,69,236,326,449,163,573,736,153,52,99,196,188,1539
684,Jason Calliste,2011,2014,Total,Total,134,3991,425,1024,183,410,242,614,447,560,68,288,356,261,147,13,228,272,1539
685,Justin Cobbs,2010,2014,Total,Total,136,3839,524,1157,437,901,87,256,404,491,49,297,346,575,112,14,278,198,1539
686,Carl Montgomery,2008,2011,Chicago State,Total,124,3166,601,1135,597,1113,4,22,333,581,379,542,921,84,86,148,250,393,1539
687,Toure' Murry,2009,2012,Wichita State,MVC,139,3999,519,1280,384,846,135,434,366,480,153,473,626,429,180,41,340,240,1539
688,Jimmie Taylor,2014,2017,Rider,MAAC,130,4076,517,1223,302,675,215,548,290,412,150,413,563,201,115,21,198,336,1539
689,Marques Townes,2015,2019,Total,Total,129,3748,581,1185,466,853,115,332,262,368,100,431,531,334,153,22,237,193,1539
690,Darian Anderson,2015,2018,Fairleigh Dickinson,NEC,106,3340,541,1362,371,870,170,492,286,368,85,301,386,354,201,25,269,280,1538
691,Larry Anderson,2009,2012,Long Beach State,Big West,122,3852,522,1050,434,794,88,256,406,602,190,400,590,361,205,50,294,247,1538
692,Ahmad Caver,2016,2019,Old Dominion,CUSA,136,4183,516,1368,301,721,215,647,291,446,62,378,440,607,187,33,239,236,1538
693,Mike Scott,2008,2012,Virginia,ACC,130,3457,585,1122,569,1078,16,44,352,454,334,610,944,124,85,51,211,263,1538
694,Allen Crabbe,2011,2013,University of California,Total,98,3402,533,1195,324,648,209,547,262,320,85,474,559,219,84,57,182,165,1537
695,Jarred DuBois,2009,2013,Total,Total,128,4002,487,1285,297,779,190,506,373,441,72,293,365,332,142,4,299,329,1537
696,Ryan Taylor,2015,2019,Total,Total,118,3614,553,1335,344,756,209,579,222,262,61,260,321,149,74,41,155,270,1537
697,Maurice Watson Jr.,2013,2017,Total,Total,119,3643,590,1220,503,965,87,255,270,387,69,323,392,800,187,1,378,294,1537
698,David Brown,2010,2015,Western Michigan,MAC,135,3279,455,1136,238,465,217,671,409,562,59,302,361,176,140,18,220,312,1536
699,Jon Diebler,2008,2011,Ohio State,Big Ten,144,4688,473,1109,99,209,374,900,216,263,46,358,404,269,138,24,169,190,1536
700,Scott Eatherton,2011,2015,Total,Total,124,3149,581,1002,548,905,33,97,341,494,249,565,814,125,65,151,242,338,1536
701,Mike Singletary,2008,2011,Texas Tech,Big 12,128,3359,493,1068,452,921,41,147,509,698,172,526,698,240,93,61,295,304,1536
702,Nigel Williams-Goss,2014,2017,Total,Total,100,3415,574,1236,477,943,97,293,291,361,69,440,509,496,133,13,258,191,1536
703,Ben Aird,2011,2014,Utah Valley,Total,125,3766,577,1142,555,1077,22,65,359,502,284,735,1019,162,112,183,175,368,1535
704,Rodney Green,2008,2010,La Salle,A-10,93,3131,559,1251,479,988,80,263,337,466,104,364,468,334,151,19,331,229,1535
705,Seth Hinrichs,2012,2015,Lafayette,Patriot,119,3268,520,1075,311,590,209,485,286,352,160,409,569,205,92,37,238,184,1535
706,Sherron Collins,2008,2010,Kansas,Big 12,105,3224,527,1206,342,707,185,499,295,362,40,210,250,440,117,5,268,181,1534
707,James Palmer,2015,2019,Total,Total,141,3188,485,1219,339,756,146,463,418,563,105,282,387,256,103,44,192,186,1534
708,Roosevelt Jones,2012,2016,Butler,Total,139,4422,589,1297,588,1293,1,4,354,595,308,506,814,464,147,67,322,361,1533
709,LeAntwan Luckett,2013,2016,Total,Total,124,3384,520,1351,431,1009,89,342,404,603,138,207,345,214,126,31,264,321,1533
710,Kevin Olekaibe,2011,2014,Total,Total,126,3716,508,1361,234,559,274,802,243,310,66,237,303,187,136,15,178,190,1533
711,Jordan Taylor,2009,2012,Wisconsin,Big Ten,136,3950,490,1215,310,731,180,484,373,477,102,310,412,464,102,9,154,300,1533
712,Tim Hardaway,2011,2013,Michigan,Big Ten,107,3560,527,1239,325,650,202,589,276,381,62,378,440,225,76,33,182,212,1532
713,Glynn Watson Jr.,2016,2019,Nebraska,Big Ten,134,4027,557,1417,373,890,184,527,234,295,64,350,414,382,177,18,182,331,1532
714,Luke Nelson,2014,2017,UC-Irvine,Big West,119,3480,514,1242,256,533,258,709,245,322,39,300,339,414,145,21,264,235,1531
715,Robby Ptacek,2009,2012,Central Connecticut State,NEC,112,3699,511,1256,394,899,117,357,392,442,80,306,386,220,97,7,293,252,1531
716,Brock Motum,2010,2013,Washington State,Total,120,3002,565,1089,477,840,88,249,312,433,173,366,539,127,53,43,228,214,1530
717,Chris Harris,2008,2010,Navy,Patriot,90,3062,458,1213,194,507,264,706,349,410,48,181,229,223,160,4,228,249,1529
718,Brett Bisping,2013,2017,Siena,MAAC,137,3750,532,1116,436,842,96,274,368,477,299,725,1024,151,104,72,235,394,1528
719,Patrick Christopher,2008,2010,University of California,Pac-10,101,3471,568,1268,417,827,151,441,240,290,128,308,436,204,100,11,170,217,1527
720,Michael Lyons,2010,2013,Air Force,MWC,115,3482,549,1201,407,753,142,448,287,383,125,288,413,214,109,27,228,234,1527
721,Shelvin Mack,2009,2011,Butler,Horizon,108,3374,515,1228,299,623,216,605,281,372,88,366,454,357,118,9,239,206,1527
722,Jamel Waters,2013,2016,Alabama State,SWAC,124,3894,509,1248,362,829,147,419,362,482,95,332,427,579,224,11,296,277,1527
723,Cameron Ayers,2011,2014,Bucknell,Patriot,133,3985,530,1205,329,717,201,488,265,319,92,337,429,220,98,9,144,181,1526
724,Devin Cannady,2016,2019,Princeton,Ivy,104,3235,484,1094,215,431,269,663,289,322,53,373,426,169,112,18,139,199,1526
725,Gabe Knutson,2010,2013,Lehigh,Patriot,128,3536,536,1049,516,991,20,58,434,578,247,437,684,114,68,60,166,279,1526
726,Chase Tapley,2010,2013,San Diego State,MWC,134,3813,573,1247,350,682,223,565,157,206,74,335,409,303,187,54,182,208,1526
727,Julian Washburn,2012,2015,Texas-El Paso,CUSA,130,4448,592,1360,473,1011,119,349,223,319,101,396,497,274,118,55,213,239,1526
728,Michael Williams,2010,2014,Total,Total,122,3558,528,1270,301,654,227,616,243,340,43,326,369,219,76,10,204,245,1526
729,Jeremy Ingram,2011,2014,North Carolina Central,Total,112,3035,459,1062,289,598,170,464,437,568,85,257,342,123,122,53,201,262,1525
730,Markis McDuffie,2016,2019,Wichita State,Total,129,3199,497,1161,337,690,160,471,371,469,185,383,568,148,116,27,174,238,1525
731,Korey Billbury,2013,2016,Total,Total,132,3855,543,1276,441,992,102,284,336,480,231,511,742,294,157,19,269,343,1524
732,Mike Liabo,2011,2014,Tennessee-Martin,OVC,117,3092,529,1421,283,698,246,723,220,285,73,305,378,247,65,16,243,163,1524
733,Arsalan Kazemi,2010,2013,Total,Total,130,3776,500,895,500,893,0,2,523,771,401,912,1313,197,225,107,232,319,1523
734,Mike Morsell,2015,2018,Towson,CAA,130,3407,519,1218,369,759,150,459,335,457,146,296,442,180,109,69,235,355,1523
735,Mo Evans,2014,2017,Purdue-Fort Wayne,Summit,118,3365,520,1141,254,492,266,649,216,263,46,328,374,466,146,18,256,276,1522
736,Kayel Locke,2013,2016,North Carolina-Greensboro,Southern,130,3557,569,1261,526,1099,43,162,341,512,260,392,652,134,58,21,226,350,1522
737,Wendell McKines,2008,2012,New Mexico State,WAC,126,3576,582,1194,499,966,83,228,274,432,400,735,1135,207,98,66,220,278,1521
738,Jordan McRae,2011,2014,Tennessee,SEC,114,3088,496,1190,317,668,179,522,350,455,75,296,371,209,73,97,225,218,1521
739,Nijal Pearson,2017,2019,Texas State,Sun Belt,102,3356,531,1275,356,785,175,490,284,401,183,389,572,214,138,32,218,217,1521
740,Justin Rutty,2008,2011,Quinnipiac,NEC,116,3392,647,1151,647,1151,0,0,227,466,465,567,1032,109,74,80,215,323,1521
741,Peter Hooley,2012,2016,Albany (NY),AEC,127,3905,464,1157,283,602,181,555,410,511,60,366,426,337,99,9,257,156,1519
742,Tre Demps,2012,2016,Northwestern,Big Ten,132,3867,554,1404,343,785,211,619,199,297,65,288,353,292,48,5,149,149,1518
743,Erik McCree,2013,2017,Total,Total,123,3082,532,1158,394,754,138,404,316,428,162,603,765,107,67,48,228,217,1518
744,Four McGlynn,2012,2016,Total,Total,136,3753,425,1107,155,388,270,719,398,442,35,231,266,166,71,12,183,249,1518
745,Draymond Green,2009,2012,Michigan State,Big Ten,145,3619,543,1163,452,911,91,252,340,495,283,813,1096,425,180,116,277,396,1517
746,Jamaal King,2016,2019,Saint Francis (PA),NEC,115,3152,526,1211,362,720,164,491,301,389,41,243,284,386,138,7,295,254,1517
747,Evan Turner,2008,2010,Ohio State,Big Ten,101,3314,539,1073,485,924,54,149,385,508,151,531,682,414,159,74,352,273,1517
748,Aubrey Coleman,2009,2010,Houston,CUSA,67,2342,523,1229,462,1020,61,209,409,547,170,351,521,167,168,6,160,154,1516
749,D.J. Covington,2011,2014,Virginia Military Institute,Big South,115,2927,599,1029,598,1020,1,9,317,466,262,485,747,66,96,272,185,337,1516
750,Moses Greenwood,2016,2019,Southeastern Louisiana,Southland,131,3143,608,1067,588,1013,20,54,279,415,282,483,765,65,93,104,230,399,1515
751,Cameron Johnson,2015,2019,Total,ACC,135,3425,516,1131,257,492,259,639,223,273,148,399,547,243,103,34,138,237,1514
752,Kyle Vinales,2012,2014,Central Connecticut State,NEC,79,2802,518,1300,311,756,207,544,271,334,21,130,151,296,105,6,249,161,1514
753,Quenton DeCosey,2013,2016,Temple,Total,129,3574,499,1260,333,783,166,477,349,494,110,409,519,251,108,32,206,204,1513
754,Latif Rivers,2011,2014,Wagner,NEC,110,3314,470,1190,274,643,196,547,377,441,49,261,310,244,84,37,259,282,1513
755,Terence Davis,2016,2019,Mississippi,SEC,121,2941,549,1234,373,715,176,519,238,332,141,456,597,249,140,70,242,318,1512
756,Jae'Sean Tate,2015,2018,Ohio State,Big Ten,129,3611,614,1113,578,983,36,130,248,447,227,544,771,216,136,64,234,382,1512
757,Jerrell Wright,2012,2015,La Salle,A-10,132,3196,591,1053,591,1053,0,0,330,540,354,487,841,123,86,107,242,352,1512
758,Darrun Hilliard,2012,2015,Villanova,Big East,132,3537,491,1125,282,556,209,569,320,428,71,329,400,248,176,47,206,274,1511
759,R.L. Horton,2008,2011,Southern Mississippi,CUSA,131,4257,529,1316,408,944,121,372,332,469,35,348,383,268,89,7,186,293,1511
760,Damian Saunders,2008,2011,Duquesne,A-10,127,4073,599,1184,495,842,104,342,209,421,359,660,1019,281,277,300,251,311,1511
761,Wesley Saunders,2012,2015,Harvard,Ivy,120,3580,496,1032,445,905,51,127,468,620,128,363,491,383,175,51,273,239,1511
762,Dean Wade,2016,2019,Kansas State,Big 12,126,3695,548,1100,420,768,128,332,286,402,218,464,682,260,118,79,148,288,1510
763,Keith Appling,2011,2014,Michigan State,Big Ten,142,4229,491,1140,353,727,138,413,389,520,63,368,431,465,151,65,296,345,1509
764,RJ Cole,2018,2019,Howard,MEAC,67,2461,459,1137,266,616,193,521,398,501,51,219,270,418,121,1,237,163,1509
765,Dusty Hannahs,2013,2017,Total,Total,131,3156,487,1139,245,527,242,612,293,330,58,160,218,123,67,6,156,240,1509
766,Nick Lindner,2014,2017,Lafayette,Patriot,121,3878,471,1113,305,659,166,454,401,504,50,204,254,520,91,5,272,253,1509
767,J.J. Mann,2011,2014,Belmont,Total,139,3570,524,1212,290,568,234,644,227,265,119,415,534,272,208,5,184,182,1509
768,Chris Silva,2016,2019,South Carolina,SEC,134,2904,452,910,424,851,28,59,577,791,333,543,876,89,85,186,263,470,1509
769,Justin Edwards,2012,2016,Total,Total,123,3573,544,1272,441,920,103,352,317,459,224,389,613,342,191,57,312,308,1508
770,Peter Jok,2014,2017,Iowa,Big Ten,125,2801,491,1191,275,620,216,571,310,352,88,313,401,193,102,11,183,227,1508
771,Anthony Barber,2014,2016,North Carolina State,ACC,104,3256,500,1169,418,933,82,236,425,536,65,274,339,403,70,3,220,198,1507
772,Phil Booth,2015,2019,Villanova,Big East,148,3636,492,1136,268,533,224,603,299,381,53,335,388,374,98,19,219,256,1507
773,David Crisp,2016,2019,Washington,Pac-12,135,4116,518,1341,262,575,256,766,215,325,79,267,346,356,125,12,271,274,1507
774,Shonn Miller,2012,2016,Total,Total,121,3341,541,1124,475,887,66,237,359,455,140,654,794,92,160,181,161,346,1507
775,Connor Hill,2012,2015,Idaho,Total,124,3305,503,1152,163,352,340,800,160,201,27,222,249,111,52,1,110,210,1506
776,Darrius Morrow,2009,2012,East Carolina,CUSA,123,3717,514,946,514,943,0,3,478,723,306,472,778,120,103,112,254,352,1506
777,Josh Williams,2014,2017,Lipscomb,A-Sun,107,2919,513,1089,301,539,212,550,268,348,137,316,453,177,117,30,215,277,1506
778,Keith Braxton,2017,2019,Saint Francis (PA),NEC,98,3356,526,1085,420,798,106,287,346,445,175,735,910,333,152,42,246,181,1504
779,D.J. Kennedy,2008,2011,St. John's (NY),Big East,129,3927,475,1089,353,748,122,341,432,579,218,563,781,311,183,61,266,257,1504
780,Egidijus Mockevicius,2013,2016,Evansville,MVC,136,3497,551,893,551,893,0,0,402,548,300,958,1258,43,87,297,178,425,1504
781,Tyler Zeller,2009,2012,North Carolina,ACC,117,2696,548,1010,548,1008,0,2,407,525,316,472,788,69,78,130,165,271,1503
782,Marcus Marshall,2013,2017,Total,Total,93,3029,445,1046,224,460,221,586,391,474,28,233,261,242,58,6,141,182,1502
783,Kennedy Meeks,2014,2017,North Carolina,ACC,144,3068,616,1105,616,1104,0,1,270,426,407,645,1052,140,99,154,187,324,1502
784,Chris Udofia,2011,2014,Denver,Total,124,3661,551,1074,486,849,65,225,334,515,179,424,603,349,141,256,228,392,1501
785,Jordan Williams,2012,2015,North Texas,Total,114,3389,504,1249,361,772,143,477,350,469,184,365,549,126,117,57,253,250,1501
786,Vincent Council,2010,2013,Providence,Big East,118,4024,514,1365,405,1016,109,349,362,523,137,308,445,725,164,41,353,292,1499
787,Dwayne Evans,2011,2014,Saint Louis,A-10,134,3616,543,1081,523,1015,20,66,393,547,294,648,942,126,129,85,232,327,1499
788,Kevin Thompson,2009,2012,Morgan State,MEAC,132,3738,584,1177,583,1175,1,2,330,564,478,732,1210,177,74,167,306,372,1499
789,Nick Murphy,2008,2011,Jacksonville State,OVC,113,3406,531,1045,509,971,22,74,414,624,238,441,679,228,190,33,254,290,1498
790,K.T. Harrell,2011,2015,Total,Total,107,3032,476,1099,284,611,192,488,353,440,72,226,298,152,71,15,212,215,1497
791,Deron Powers,2013,2017,Total,Total,128,4199,469,1196,335,770,134,426,425,517,86,277,363,561,133,5,331,298,1497
792,Tyrone Lewis,2008,2010,Niagara,MAAC,91,3153,468,1273,219,538,249,735,311,413,144,265,409,172,200,64,175,239,1496
793,Ben Drayton,2009,2012,Georgia Southern,Southern,122,3650,533,1155,408,812,125,343,304,432,99,210,309,379,175,3,300,253,1495
794,Przemek Karnowski,2013,2017,Gonzaga,WCC,152,3212,615,1033,614,1030,1,3,264,511,238,581,819,165,57,152,245,316,1495
795,Nathan Boothe,2013,2016,Toledo,MAC,127,3523,599,1235,550,1098,49,137,247,297,218,557,775,249,90,155,185,411,1494
796,Josh Robinson,2015,2017,Austin Peay,OVC,95,2935,467,1148,280,624,187,524,373,456,39,210,249,214,85,5,206,128,1494
797,Ryan Welage,2016,2019,Total,Total,126,3334,539,1232,318,672,221,560,195,249,97,427,524,137,60,19,152,197,1494
798,Rob Poole,2012,2015,Siena,MAAC,125,4051,469,1208,254,598,215,610,340,441,124,428,552,218,122,18,207,255,1493
799,Matt Klinewski,2015,2018,Lafayette,Patriot,124,2731,562,1119,511,996,51,123,317,412,157,408,565,127,47,64,209,287,1492
800,Austin McBroom,2012,2016,Total,Total,130,3508,461,1149,204,506,257,643,313,376,61,200,261,314,110,3,238,195,1492
801,Lamond Murray,2014,2017,Pepperdine,WCC,118,2876,575,1217,488,984,87,233,255,337,126,369,495,107,88,40,175,218,1492
802,Craig Sword,2013,2016,Mississippi State,SEC,123,3354,517,1152,442,867,75,285,383,603,106,306,412,305,185,69,391,357,1492
803,Terry Allen,2013,2016,Richmond,A-10,134,3409,547,1080,483,866,64,214,333,471,215,567,782,168,138,74,209,295,1491
804,Manu Lecomte,2014,2018,Total,Total,137,3893,468,1120,227,525,241,595,314,370,48,207,255,392,89,3,237,242,1491
805,J.P. Macura,2015,2018,Xavier,Big East,141,3518,495,1105,313,588,182,517,319,400,158,292,450,300,166,25,213,297,1491
806,Dan Trist,2012,2015,Lafayette,Patriot,123,2825,608,1128,607,1123,1,5,274,382,201,360,561,141,40,56,271,285,1491
807,Mike Holloway,2016,2019,Fairleigh Dickinson,NEC,128,3487,570,1080,554,1029,16,51,334,509,313,475,788,146,96,111,248,434,1490
808,Devon Collier,2011,2014,Oregon State,Total,128,3158,539,935,539,935,0,0,411,668,287,392,679,181,109,134,205,228,1489
809,Ernie Duncan,2015,2019,Vermont,AEC,136,3840,479,1085,171,350,308,735,223,268,37,279,316,308,87,15,183,212,1489
810,Eron Harris,2013,2017,Total,Total,126,3068,487,1128,268,583,219,545,296,366,82,275,357,200,68,18,214,243,1489
811,Jared Sam,2015,2018,Southern,SWAC,134,3802,502,973,501,969,1,4,484,668,318,619,937,120,117,97,208,333,1489
812,Martez Walker,2014,2018,Total,Total,119,3132,458,1033,276,498,182,535,391,484,147,265,412,129,79,37,156,182,1489
813,Seth Allen,2013,2017,Total,ACC,123,3297,484,1125,300,596,184,529,335,443,30,270,300,338,112,21,292,253,1487
814,Anthony Miles,2009,2012,Lamar,Southland,126,3517,457,1068,360,786,97,282,476,603,135,395,530,416,146,11,280,280,1487
815,Devin Thomas,2013,2016,Wake Forest,ACC,125,3533,544,1047,544,1046,0,1,398,702,314,747,1061,212,92,144,336,348,1486
816,Geno Crandall,2016,2019,Total,Total,122,3526,503,1059,375,702,128,357,351,480,81,364,445,438,221,24,340,367,1485
817,Yancy Gates,2009,2012,Cincinnati,Big East,132,3573,618,1246,611,1220,7,26,242,411,350,566,916,108,85,134,167,313,1485
818,Gerald Lee,2008,2010,Old Dominion,CAA,104,3142,562,1077,550,1047,12,30,349,465,235,327,562,143,59,81,198,241,1485
819,Jaylen Shaw,2014,2018,Total,Total,132,3424,528,1176,375,768,153,408,276,357,32,291,323,479,138,11,298,246,1485
820,Joel Bolomboy,2013,2016,Weber State,Big Sky,130,3743,492,931,456,834,36,97,464,651,412,900,1312,93,72,178,260,304,1484
821,Will Cherry,2010,2013,Montana,Big Sky,116,3565,489,1138,388,784,101,354,405,564,66,350,416,397,265,33,273,243,1484
822,Chase Simon,2008,2012,Total,Total,127,3556,525,1315,381,866,144,449,290,418,149,349,498,226,128,18,316,309,1484
823,Tre' Coggins,2013,2017,Total,Total,117,3101,492,1205,245,523,247,682,252,307,37,297,334,194,99,17,232,218,1483
824,Kelvin Martin,2009,2012,Charleston Southern,Big South,115,3505,574,1062,569,1023,5,39,330,527,355,613,968,181,221,127,253,297,1483
825,Eric Ferguson,2011,2015,Georgia Southern,Total,119,3225,556,1117,504,939,52,178,318,499,234,493,727,115,157,101,277,382,1482
826,Andrew Warren,2008,2011,Bradley,MVC,96,3207,470,1133,266,619,204,514,338,400,103,329,432,154,128,19,171,241,1482
827,Vaughn Duggins,2008,2011,Wright State,Horizon,97,3350,506,1133,358,722,148,411,321,410,81,245,326,248,126,9,178,152,1481
828,Shaquille Harrison,2013,2016,Tulsa,Total,133,4017,513,1156,480,1003,33,153,422,654,123,482,605,461,244,49,306,310,1481
829,Matt Stainbrook,2011,2015,Total,Total,137,3489,601,1055,596,1034,5,21,274,410,329,617,946,250,80,111,237,333,1481
830,Trey Zeigler,2011,2015,Total,Total,127,3463,572,1312,535,1182,37,130,300,548,206,375,581,251,112,70,282,306,1481
831,Justin Robinson,2008,2011,Rider,MAAC,130,3814,496,1191,289,711,207,480,281,328,65,317,382,394,152,16,263,305,1480
832,Ike Smith,2016,2019,Georgia Southern,Sun Belt,101,2770,527,1211,363,715,164,496,262,408,100,392,492,122,94,56,203,216,1480
833,Jahmar Young,2008,2010,New Mexico State,WAC,87,2710,496,1091,340,670,156,421,331,399,55,230,285,233,97,16,193,204,1479
834,Chandler Hutchison,2015,2018,Boise State,MWC,123,2948,523,1098,444,874,79,224,353,514,138,534,672,255,120,29,236,268,1478
835,Nathan Knight,2017,2019,William & Mary,CAA,93,2373,538,932,515,843,23,89,379,527,183,444,627,212,43,172,199,283,1478
836,Johnathan Williams,2014,2018,Total,Total,143,3893,554,1085,504,935,50,150,320,559,334,685,1019,141,78,152,254,363,1478
837,Brett Comer,2012,2015,Florida Gulf Coast,A-Sun,137,4047,536,1247,435,923,101,324,304,459,104,350,454,845,181,19,460,291,1477
838,Max Landis,2012,2016,Total,Total,128,3730,466,1133,197,412,269,721,276,340,21,200,221,287,92,1,184,176,1477
839,D.J. Richardson,2010,2013,Illinois,Big Ten,138,4351,498,1284,220,502,278,782,203,258,82,311,393,251,122,24,193,249,1477
840,Murphy Holloway,2009,2013,Mississippi,SEC,132,3674,615,1130,614,1119,1,11,245,478,404,689,1093,134,194,76,198,327,1476
841,David Holston,2008,2009,Chicago State,Ind,60,2050,471,1102,194,385,277,717,257,308,57,148,205,346,155,2,240,129,1476
842,Kris Joseph,2009,2012,Syracuse,Big East,140,3725,491,1094,379,756,112,338,382,544,181,446,627,208,179,67,217,224,1476
843,Riley LaChance,2015,2018,Vanderbilt,SEC,135,4091,498,1151,238,521,260,630,220,264,40,368,408,423,81,3,198,244,1476
844,Novar Gadson,2009,2012,Rider,MAAC,127,3294,540,1183,426,824,114,359,281,395,184,542,726,224,103,95,317,337,1475
845,Josh Hagins,2013,2016,Little Rock,Sun Belt,128,3495,525,1224,350,727,175,497,250,306,90,401,491,468,179,39,241,307,1475
846,Ahmed Hill,2015,2019,Virginia Tech,ACC,134,4024,514,1155,284,566,230,589,215,290,86,376,462,167,63,14,162,263,1473
847,Ralston Turner,2011,2015,Total,Total,132,3841,488,1265,218,516,270,749,227,303,62,315,377,164,78,22,190,320,1473
848,Ceola Clark,2009,2013,Western Illinois,Summit,124,4186,471,1032,224,457,247,575,283,368,103,359,462,464,242,15,217,219,1472
849,Shane Richards,2013,2016,Manhattan,MAAC,129,3569,443,1103,131,302,312,801,274,330,49,305,354,149,91,13,158,271,1472
850,Louis Dabney,2013,2016,Tulane,Total,131,3372,468,1225,320,764,148,461,387,511,90,277,367,201,120,11,213,277,1471
851,DeShawn Sims,2008,2010,Michigan,Big Ten,99,3001,593,1268,503,970,90,298,195,283,250,403,653,85,106,72,154,223,1471
852,Derrick Walton,2014,2017,Michigan,Big Ten,127,4053,432,1068,199,487,233,581,374,447,56,507,563,499,146,6,224,225,1471
853,Bryant Crawford,2016,2018,Wake Forest,ACC,94,2988,471,1133,304,657,167,476,361,450,38,270,308,467,149,21,283,258,1470
854,Kevin Larsen,2013,2016,George Washington,A-10,136,4209,559,1093,535,1034,24,59,328,497,364,586,950,282,87,101,226,249,1470
855,Elijah Minnie,2015,2019,Total,Total,119,3415,531,1185,323,574,208,611,200,249,157,494,651,105,162,181,231,266,1470
856,Mikh McKinney,2013,2015,Sacramento State,Big Sky,91,3105,508,1082,376,743,132,339,320,395,67,234,301,369,149,14,197,189,1468
857,Brett Olson,2012,2015,Denver,Total,124,4296,489,1018,224,411,265,607,225,254,34,303,337,336,122,24,212,298,1468
858,Chris Perez,2010,2014,Total,Total,125,3514,547,1171,456,907,91,264,283,426,166,238,404,188,117,3,240,280,1468
859,Julian Boyd,2009,2013,Long Island University,NEC,104,2674,530,992,497,896,33,96,374,546,286,557,843,96,77,70,173,294,1467
860,Wes Channels,2008,2010,Austin Peay,OVC,100,3123,475,1151,273,639,202,512,315,434,82,272,354,268,139,15,249,272,1467
861,Shawn Glover,2010,2014,Total,Total,126,3356,586,1255,515,1034,71,221,224,290,142,387,529,154,94,125,192,201,1467
862,Chris Johnson,2009,2012,Dayton,A-10,138,3439,468,1095,232,459,236,636,295,357,312,534,846,145,105,50,158,246,1467
863,Ishmael Lane,2016,2019,Northwestern State,Southland,117,3062,553,1048,517,934,36,114,325,520,255,588,843,108,87,168,242,295,1467
864,A.J. Ogilvy,2008,2010,Vanderbilt,SEC,96,2459,495,901,488,872,7,29,470,640,187,453,640,106,82,145,227,279,1467
865,Scott Wood,2010,2013,North Carolina State,ACC,138,4372,450,1065,116,256,334,809,233,263,56,312,368,190,97,79,141,316,1467
866,Matt Janning,2008,2010,Northeastern,CAA,96,3465,509,1208,341,719,168,489,280,366,80,310,390,262,139,18,232,182,1466
867,Nick Leon,2008,2011,Saint Peter's,MAAC,122,3850,467,1253,279,722,188,531,344,401,44,263,307,332,132,8,369,236,1466
868,Chris Braswell,2010,2013,Charlotte,A-10,122,3173,501,1061,467,936,34,125,429,573,299,569,868,142,101,101,307,351,1465
869,Pat Connaughton,2012,2015,Notre Dame,Total,139,4484,515,1145,247,450,268,695,167,215,137,686,823,257,93,71,135,232,1465
870,David Laury,2013,2015,Iona,MAAC,92,2930,534,1050,507,978,27,72,370,581,237,624,861,222,77,122,213,270,1465
871,Kelvin Lewis,2008,2010,Houston,CUSA,100,3299,483,1163,232,505,251,658,248,304,114,259,373,119,147,21,94,199,1465
872,Jahmal McMurray,2016,2019,Total,AAC,90,3003,528,1252,282,613,246,639,163,201,35,198,233,205,52,9,188,170,1465
873,Dwight Powell,2011,2014,Stanford,Total,136,3569,515,1110,482,996,33,114,402,557,225,628,853,240,125,118,283,390,1465
874,Dorian Green,2010,2013,Colorado State,MWC,130,4247,441,1081,244,549,197,532,385,478,38,335,373,373,105,17,251,287,1464
875,LeRoy Nobles,2008,2011,IUPUI,Summit,126,3479,462,998,276,530,186,468,354,446,113,315,428,147,88,15,189,210,1464
876,Brandon Wood,2008,2012,Total,Total,108,3129,538,1161,371,703,167,458,221,304,97,299,396,248,114,19,195,181,1464
877,Alex Franklin,2008,2010,Siena,MAAC,98,3098,520,926,520,926,0,0,423,651,263,502,765,109,137,77,217,262,1463
878,Mustapha Heron,2017,2019,Total,Total,95,2799,477,1084,342,731,135,353,374,481,124,386,510,114,97,14,212,266,1463
879,Levi Bradley,2016,2019,Northern Illinois,MAC,132,3206,535,1178,443,891,92,287,300,371,162,446,608,107,76,32,146,332,1462
880,Gary Clark,2015,2018,Cincinnati,AAC,139,4003,542,1033,488,892,54,141,324,464,422,710,1132,279,163,180,158,272,1462
881,Angel Rodriguez,2012,2016,Total,Total,132,3585,449,1193,258,610,191,583,373,488,73,239,312,558,208,16,326,338,1462
882,Chris Gradnigo,2008,2012,Total,Total,113,2891,542,1222,399,825,143,397,234,306,121,320,441,79,58,50,211,305,1461
883,Xavier Johnson,2013,2017,Colorado,Pac-12,127,3387,510,1068,380,728,130,340,311,497,214,491,705,91,68,45,215,308,1461
884,Justin Drummond,2011,2015,Total,Total,120,2977,489,1087,393,811,96,276,386,516,175,343,518,181,99,53,217,317,1460
885,Jonathan Gibson,2008,2010,New Mexico State,WAC,100,2987,505,1141,256,526,249,615,201,262,44,189,233,215,124,5,193,225,1460
886,Delroy James,2008,2011,Rhode Island,A-10,123,3102,534,1196,446,878,88,318,304,435,262,443,705,224,146,105,271,295,1460
887,Ravern Johnson,2008,2011,Mississippi State,SEC,128,3274,522,1166,262,512,260,654,156,208,88,272,360,94,43,53,147,133,1460
888,Yuta Watanabe,2015,2018,George Washington,A-10,134,4027,509,1197,353,734,156,463,286,363,147,462,609,197,93,147,170,240,1460
889,RJ White,2013,2017,North Carolina-Greensboro,Southern,140,3122,591,1053,548,926,43,127,235,383,253,625,878,130,113,142,222,466,1460
890,Michael Dixon,2010,2014,Total,Total,135,2987,480,1045,314,603,166,442,333,391,55,202,257,365,173,9,201,289,1459
891,Bronson Koenig,2014,2017,Wisconsin,Big Ten,148,4075,498,1210,228,515,270,695,193,237,56,234,290,296,57,29,154,251,1459
892,Jason Dunne,2016,2019,Hartford,AEC,130,3892,491,1230,215,447,276,783,200,255,72,326,398,296,141,31,255,303,1458
893,Dairese Gary,2008,2011,New Mexico,MWC,135,3707,412,904,315,636,97,268,537,715,70,281,351,564,162,3,303,321,1458
894,Anthony Gill,2012,2016,Total,Total,139,3412,528,949,515,918,13,31,389,572,291,450,741,108,81,67,172,315,1458
895,Frank Kaminsky,2012,2015,Wisconsin,Big Ten,144,2943,529,1013,426,734,103,279,297,389,182,484,666,188,77,153,121,235,1458
896,Josh McFolley,2016,2019,Detroit Mercy,Horizon,124,3403,471,1154,238,510,233,644,283,370,45,206,251,289,201,11,225,315,1458
897,Jermaine Taylor,2008,2009,Central Florida,CUSA,62,2026,522,1107,351,647,171,460,243,302,112,196,308,110,74,33,165,121,1458
898,Justin Bibbs,2015,2018,Virginia Tech,ACC,128,4049,523,1160,269,561,254,599,157,221,40,332,372,189,54,9,168,235,1457
899,Justin Harper,2008,2011,Richmond,A-10,137,3133,537,1111,358,643,179,468,204,287,193,458,651,102,76,113,172,305,1457
900,Ryan Rossiter,2008,2011,Siena,MAAC,133,3663,525,1009,520,977,5,32,402,526,387,764,1151,140,131,167,180,304,1457
901,Tyler Bernardini,2008,2012,Pennsylvania,Ivy,114,3275,480,1142,281,600,199,542,297,384,109,311,420,168,133,33,202,298,1456
902,D.J. Irving,2011,2014,Boston University,Total,128,4126,458,1146,288,674,170,472,370,475,77,319,396,469,145,7,287,277,1456
903,Rob Marberry,2015,2019,Total,Total,111,2605,608,983,608,980,0,3,239,337,181,321,502,198,59,74,134,245,1455
904,Chase Fischer,2012,2016,Total,Total,133,3420,465,1156,176,398,289,758,235,292,40,238,278,210,101,8,157,175,1454
905,Vasa Pusica,2015,2019,Total,Total,121,3332,473,1004,300,567,173,437,335,418,51,355,406,395,112,17,283,245,1454
906,Kamar Baldwin,2017,2019,Butler,Big East,102,3236,559,1226,433,849,126,377,209,260,48,411,459,263,162,44,216,251,1453
907,Austin Price,2014,2017,Lehigh,Patriot,126,3745,499,1173,259,561,240,612,215,288,85,286,371,214,178,52,187,301,1453
908,Ryan Willen,2009,2012,Lafayette,Patriot,125,3143,442,1014,291,602,151,412,418,535,212,363,575,182,93,32,224,323,1453
909,Deon Jones,2012,2016,Total,Total,128,3636,487,1112,414,877,73,235,405,533,208,512,720,160,114,67,278,302,1452
910,Chandler Parsons,2008,2011,Florida,SEC,142,3964,527,1105,374,651,153,454,245,401,270,589,859,339,129,42,234,282,1452
911,Grant Benzinger,2015,2018,Wright State,Horizon,132,3884,477,1147,186,416,291,731,206,246,122,405,527,132,74,19,125,333,1451
912,Mathieu Kamba,2015,2018,Central Arkansas,Southland,124,3553,532,1007,492,888,40,119,347,580,265,444,709,218,99,86,283,320,1451
913,Grant Maxey,2008,2011,Jackson State,SWAC,99,2635,517,1116,439,879,78,237,339,442,211,398,609,167,138,72,245,277,1451
914,Deonta Vaughn,2008,2010,Cincinnati,Big East,99,3281,456,1132,206,435,250,697,289,358,48,295,343,405,117,4,284,258,1451
915,Jaylen Franklin,2016,2019,Abilene Christian,Southland,122,3898,564,1091,538,994,26,97,296,529,85,379,464,504,220,26,306,312,1450
916,David Gonzalvez,2008,2010,Richmond,A-10,102,3525,496,1092,287,565,209,527,249,344,85,327,412,218,147,33,190,246,1450
917,TJ Haws,2017,2019,Brigham Young,WCC,101,3289,460,1062,277,550,183,512,347,415,31,274,305,418,115,23,227,215,1450
918,Nick Kellogg,2011,2014,Ohio,MAC,143,3998,479,1084,189,356,290,728,201,238,46,283,329,265,141,9,163,286,1449
919,Corey Lowe,2008,2010,Boston University,AEC,87,3008,497,1233,245,537,252,696,203,322,69,288,357,342,101,22,314,214,1449
920,Casey Walker,2011,2014,Delaware State,MEAC,122,3980,496,1324,230,489,266,835,191,263,97,337,434,101,91,56,140,265,1449
921,Trey Lewis,2012,2016,Total,Total,117,3448,482,1153,257,566,225,587,259,342,82,318,400,292,110,17,227,222,1448
922,Jerome Jordan,2008,2010,Tulsa,CUSA,110,3035,518,915,518,915,0,0,411,584,281,653,934,109,45,316,252,318,1447
923,Josh Young,2008,2010,Drake,MVC,95,3162,434,1023,236,493,198,530,381,484,77,249,326,184,109,4,176,182,1447
924,JeQuan Lewis,2014,2017,Virginia Commonwealth,A-10,141,3447,457,1074,268,569,189,505,341,416,39,256,295,505,205,4,320,359,1444
925,Quincy Pondexter,2008,2010,Washington,Pac-10,104,2951,528,1048,492,931,36,117,352,457,275,354,629,181,86,39,193,263,1444
926,Katin Reinhardt,2013,2017,Total,Total,129,3571,503,1272,260,616,243,656,195,230,69,250,319,249,114,20,213,155,1444
927,Tre'Shawn Thurman,2015,2019,Total,Total,127,3476,539,1073,483,866,56,207,310,459,218,603,821,170,108,118,189,361,1444
928,Bruce Beckford,2013,2016,North Carolina A&T,MEAC,122,3473,509,1115,445,884,64,231,361,477,212,570,782,107,86,65,286,339,1443
929,Aaron Holiday,2016,2018,UCLA,Pac-12,101,3209,476,1058,296,631,180,427,311,391,48,272,320,477,126,22,304,271,1443
930,Damiyne Durham,2016,2019,Cal State Bakersfield,WAC,123,2886,523,1407,207,446,316,961,80,121,83,299,382,119,128,31,147,130,1442
931,Vic Law,2015,2019,Northwestern,Big Ten,125,3790,481,1198,288,674,193,524,287,371,138,572,710,254,119,77,215,332,1442
932,Armon Johnson,2008,2010,Nevada,WAC,101,3299,546,1168,476,926,70,242,279,372,78,292,370,445,83,25,276,171,1441
933,Gabe Vincent,2015,2018,UC-Santa Barbara,Big West,113,3359,496,1213,253,567,243,646,206,268,56,245,301,285,116,18,154,305,1441
934,Jaytornah Wisseh,2008,2010,Long Island University,NEC,89,3166,452,1134,358,843,94,291,443,546,64,312,376,450,141,9,315,186,1441
935,Marshall Bjorklund,2011,2014,North Dakota State,Summit,127,3221,592,907,592,907,0,0,256,405,282,400,682,122,81,58,173,341,1440
936,Rodney Glasgow,2011,2014,Virginia Military Institute,Big South,120,3536,489,1102,286,555,203,547,259,314,73,255,328,530,139,1,199,210,1440
937,Shaq Goodwin,2013,2016,Memphis,Total,134,3504,518,1003,509,967,9,36,395,602,320,532,852,206,135,197,266,392,1440
938,Jordan Woodard,2014,2017,Oklahoma,Big 12,125,3733,419,1091,257,670,162,421,440,542,75,322,397,471,186,17,261,256,1440
939,Tim Coleman,2014,2017,NJIT,Total,123,3191,487,1066,369,747,118,319,347,482,153,609,762,244,154,135,254,393,1439
940,Siler Schneider,2016,2019,UC-Davis,Big West,130,3560,531,1283,383,839,148,444,229,324,58,342,400,268,110,15,329,347,1439
941,Fred VanVleet,2013,2016,Wichita State,MVC,141,3775,463,1086,322,721,141,365,372,462,91,376,467,637,225,13,207,215,1439
942,Jack Isenbarger,2011,2014,Elon,Southern,122,3361,446,1147,182,426,264,721,282,335,67,315,382,290,82,5,206,197,1438
943,Juvonte Reddic,2011,2014,Virginia Commonwealth,Total,143,3362,574,1091,570,1073,4,18,286,452,386,508,894,76,160,123,210,321,1438
944,Trevor Cooney,2013,2016,Syracuse,Total,141,4034,466,1285,185,450,281,835,224,281,63,224,287,211,209,12,145,166,1437
945,Papa Dia,2008,2011,Southern Methodist,CUSA,124,3218,549,1059,536,1028,13,31,326,458,304,607,911,133,91,142,321,320,1437
946,Christian Sengfelder,2015,2018,Total,Total,125,3914,522,1150,305,545,217,605,176,244,226,524,750,95,88,43,160,312,1437
947,Demonte Harper,2008,2011,Morehead State,OVC,135,3941,515,1270,361,840,154,430,252,358,112,375,487,400,166,46,448,351,1436
948,Jake Layman,2013,2016,Maryland,Total,141,3938,482,1083,284,536,198,547,274,361,159,515,674,156,123,113,204,272,1436
949,Evan Payne,2014,2017,Total,Total,91,2595,477,1108,346,737,131,371,351,424,74,209,283,129,88,16,210,163,1436
950,Reed Tellinghuisen,2015,2018,South Dakota State,Summit,139,4070,484,1131,228,447,256,684,212,297,137,476,613,189,76,81,181,330,1436
951,Robert Brown,2012,2016,Total,Total,133,3746,511,1318,323,746,188,572,225,317,65,300,365,341,111,39,256,244,1435
952,Tim Derksen,2013,2016,San Francisco,WCC,126,3355,497,1005,351,647,146,358,294,442,145,431,576,197,95,22,179,262,1434
953,Rickey McGill,2016,2019,Iona,MAAC,132,3809,503,1082,371,710,132,372,296,395,89,375,464,551,214,30,276,277,1434
954,Jordan Clarkson,2011,2014,Total,Total,93,2952,473,1075,378,780,95,295,392,487,74,236,310,249,87,26,254,211,1433
955,Kyle Johnson,2008,2011,Long Island University,NEC,124,3393,479,1243,239,577,240,666,235,305,196,463,659,102,97,21,188,207,1433
956,Byron Ashe,2014,2018,Total,Total,125,3561,506,1302,300,672,206,630,214,295,105,347,452,189,136,37,212,267,1432
957,Steven Gray,2008,2011,Gonzaga,WCC,125,3689,493,1109,283,541,210,568,236,309,105,337,442,339,155,32,209,258,1432
958,Kyle Barone,2010,2013,Idaho,WAC,126,3424,525,898,525,895,0,3,381,536,260,609,869,147,53,122,237,273,1431
959,Darnell Edge,2016,2019,Fairleigh Dickinson,NEC,128,3594,485,1037,284,551,201,486,260,285,64,278,342,224,123,3,167,213,1431
960,Micah Mason,2013,2016,Total,Total,119,3366,487,1001,176,330,311,671,146,174,33,298,331,376,102,4,162,190,1431
961,Aaron Anderson,2011,2014,North Dakota,Total,133,3772,415,943,266,581,149,362,451,555,65,284,349,359,141,7,207,182,1430
962,Solomon Hill,2010,2013,Arizona,Total,139,4030,487,1012,372,705,115,307,341,458,250,523,773,304,127,49,290,339,1430
963,Alex Rosenberg,2012,2016,Columbia,Ivy,122,3352,409,992,275,621,134,371,478,628,144,351,495,204,93,23,207,297,1430
964,Malcolm Drumwright,2015,2018,Jacksonville State,OVC,125,3821,495,1227,308,692,187,535,252,312,44,235,279,404,88,22,220,295,1429
965,Dorian Finney-Smith,2012,2016,Total,Total,134,3834,480,1168,295,657,185,511,284,432,347,606,953,256,105,92,240,321,1429
966,Joel Hernandez,2014,2018,Long Island University,NEC,113,3025,523,1178,427,888,96,290,287,470,172,386,558,157,74,39,216,248,1429
967,Devin Brown,2009,2012,Holy Cross,Patriot,120,2991,439,1047,248,540,191,507,358,450,40,208,248,149,66,5,230,206,1427
968,Nate Navigato,2016,2019,Toledo,MAC,133,3884,461,1053,152,320,309,733,196,241,92,376,468,235,73,57,115,205,1427
969,Isaac Hamilton,2015,2017,UCLA,Pac-12,104,3431,538,1202,345,689,193,513,157,203,99,286,385,321,90,14,230,215,1426
970,Elfrid Payton,2012,2014,Louisiana,Sun Belt,100,3155,501,1032,471,920,30,112,394,645,148,360,508,486,197,51,336,226,1426
971,Desmond Yates,2008,2010,Middle Tennessee,Sun Belt,90,2727,573,1028,502,858,71,170,209,261,134,255,389,50,51,37,132,299,1426
972,Dyshawn Pierre,2013,2016,Dayton,A-10,126,3772,501,1041,387,744,114,297,307,435,270,568,838,276,68,39,220,223,1423
973,Marland Smith,2010,2013,Southeast Missouri State,OVC,126,3671,476,1201,225,504,251,697,220,292,98,348,446,248,112,19,198,259,1423
974,Lavoy Allen,2008,2011,Temple,A-10,135,4352,592,1109,573,1043,19,66,218,325,409,738,1147,281,72,213,189,337,1421
975,Eric Atkins,2011,2014,Notre Dame,Total,133,4628,480,1149,302,680,178,469,283,412,92,251,343,589,151,12,249,256,1421
976,J.P. Kuhlman,2010,2013,Davidson,Southern,128,4060,464,1111,292,643,172,468,320,424,105,326,431,412,120,2,245,236,1420
977,Daman Starring,2009,2013,Total,Total,133,3902,478,1186,280,671,198,515,266,357,115,369,494,298,144,22,284,279,1420
978,Brandon Clarke,2016,2019,Total,Total,98,2725,585,916,579,892,6,24,243,393,268,484,752,184,100,229,144,211,1419
979,Reggie Dillard,2014,2018,Presbyterian,Big South,123,3969,500,1211,312,675,188,536,231,341,67,363,430,344,96,28,324,275,1419
980,Gabe Rogers,2010,2013,Northern Arizona,Big Sky,109,3265,500,1289,254,653,246,636,173,220,43,164,207,245,89,4,236,174,1419
981,Randal Holt,2010,2013,Kent State,MAC,135,3618,476,1210,229,524,247,686,218,266,58,251,309,280,142,14,219,196,1417
982,Kyle Leufroy,2016,2019,Lehigh,Patriot,124,3532,471,1079,282,607,189,472,286,332,45,495,540,299,136,19,276,234,1417
983,Anthony Myles,2011,2014,Rider,MAAC,128,3519,449,1105,259,574,190,531,329,447,97,370,467,196,85,78,251,287,1417
984,Kent Bazemore,2009,2012,Old Dominion,CAA,140,3681,516,1155,416,856,100,299,284,489,191,451,642,379,250,67,320,306,1416
985,Jeffrey Carroll,2015,2018,Oklahoma State,Big 12,118,2960,484,1074,301,562,183,512,265,341,143,437,580,125,78,27,157,178,1416
986,Jared Harper,2017,2019,Auburn,SEC,105,3096,394,1027,183,439,211,588,417,526,35,207,242,507,122,5,213,189,1416
987,Cameron Long,2008,2011,George Mason,CAA,132,3826,481,1085,326,685,155,400,299,407,137,381,518,356,147,18,258,160,1416
988,Dylan Osetkowski,2015,2019,Total,Total,134,3987,511,1178,420,872,91,306,303,449,324,600,924,160,140,49,236,275,1416
989,Luwane Pipkins,2017,2019,Massachusetts,A-10,90,2802,463,1214,237,569,226,645,264,345,44,269,313,336,143,3,235,195,1416
990,Justin Tillman,2015,2018,Virginia Commonwealth,A-10,137,2876,586,1022,559,937,27,85,216,354,326,596,922,37,44,102,127,264,1415
991,Anton Grady,2012,2016,Total,Total,134,3144,559,1124,551,1086,8,38,288,458,255,604,859,169,127,148,235,422,1414
992,Josh Hawkinson,2014,2017,Washington State,Pac-12,119,3259,520,995,470,852,50,143,324,399,179,836,1015,158,52,94,150,224,1414
993,T.J. McConnell,2011,2015,Total,Total,139,4425,550,1123,412,760,138,363,176,235,94,444,538,751,324,24,281,258,1414
994,Danny Stewart,2011,2014,Rider,MAAC,130,3722,456,907,430,837,26,70,476,665,277,595,872,98,92,101,252,405,1414
995,Julius Wells,2009,2012,James Madison,CAA,114,3688,481,1246,234,543,247,703,205,289,110,458,568,210,92,14,259,265,1414
996,Sterling Gibbs,2012,2016,Total,Total,127,3358,411,997,213,496,198,501,393,522,40,201,241,349,108,2,209,196,1413
997,Robert Johnson,2015,2018,Indiana,Big Ten,129,3723,513,1172,274,558,239,614,148,213,44,443,487,342,102,15,276,255,1413
998,Gabe Levin,2014,2018,Total,Total,109,3165,484,1062,433,896,51,166,394,520,243,484,727,142,98,95,239,303,1413
999,Mychel Thompson,2008,2011,Pepperdine,WCC,128,3722,487,1366,295,777,192,589,247,325,160,387,547,201,145,79,213,264,1413
1000,Eric Fanning,2013,2017,Total,Total,112,2641,425,923,326,651,99,272,463,603,116,399,515,164,66,31,262,258,1412
1001,Josh Akognon,2008,2009,Cal State Fullerton,Big West,64,2153,460,1090,208,429,252,661,239,267,36,172,208,99,76,5,139,134,1411
1002,Ian Baker,2014,2017,New Mexico State,WAC,120,3454,443,1059,243,517,200,542,325,407,53,348,401,375,138,9,238,177,1411
1003,Will Felder,2010,2014,Total,Total,122,3431,517,1056,446,819,71,237,306,391,222,512,734,118,86,125,256,279,1411
1004,Charles Mann,2013,2016,Georgia,SEC,132,3645,365,925,302,733,63,192,618,895,80,459,539,400,110,11,399,330,1411
1005,Hillary Haley,2008,2012,Total,Total,122,3136,479,1294,335,779,144,515,308,436,163,329,492,106,86,23,214,258,1410
1006,Lamar Patterson,2010,2014,Pittsburgh,Total,149,3628,477,1097,306,634,171,463,285,394,173,415,588,427,146,44,244,276,1410
1007,J.C. Hampton,2013,2017,Total,Total,127,3652,455,1170,226,527,229,643,270,343,53,317,370,331,113,11,229,280,1409
1008,Jeffery Moss,2013,2016,Murray State,OVC,129,4057,469,1047,251,509,218,538,253,309,96,336,432,249,91,22,152,265,1409
1009,Duane Notice,2014,2017,South Carolina,SEC,138,3989,454,1181,235,582,219,599,282,393,112,250,362,353,118,16,236,241,1409
1010,Steve Santa Ana,2016,2019,Elon,CAA,122,3320,476,1130,239,456,237,674,220,316,95,454,549,254,94,20,208,248,1409
1011,Trevis Simpson,2011,2013,North Carolina-Greensboro,Southern,86,2315,488,1213,334,747,154,466,279,368,109,238,347,83,56,14,171,244,1409
1012,Mike Smith,2008,2011,East Tennessee State,A-Sun,105,3214,481,1062,370,751,111,311,336,436,160,498,658,186,108,48,216,322,1409
1013,Trelun Banks,2014,2017,Southern,SWAC,133,4173,466,1325,311,840,155,485,320,484,61,295,356,423,139,8,347,296,1407
1014,Omega Harris,2015,2018,Texas-El Paso,CUSA,119,3768,486,1098,312,650,174,448,261,340,38,316,354,246,126,14,243,252,1407
1015,Malik Moore,2016,2019,South Carolina Upstate,Total,125,3110,488,1069,347,618,141,451,290,434,173,512,685,228,131,56,208,294,1407
1016,Lovell Cabbil,2016,2019,Liberty,Total,132,4025,456,1077,263,546,193,531,301,356,48,437,485,360,180,37,262,300,1406
1017,Raiquan Clark,2016,2019,Long Island University,NEC,100,2741,490,940,463,828,27,112,399,549,215,379,594,127,97,55,319,271,1406
1018,Dylan Garrity,2012,2015,Sacramento State,Big Sky,119,3991,434,965,212,433,222,532,316,378,24,233,257,527,99,2,261,229,1406
1019,Will Rayman,2017,2019,Colgate,Patriot,100,3152,471,1074,274,598,197,476,267,368,177,418,595,121,88,68,181,275,1406
1020,Diego Kapelan,2008,2011,McNeese State,Southland,120,3025,456,1231,161,425,295,806,198,233,75,194,269,104,67,5,146,156,1405
1021,Jesse Reed,2013,2016,American,Patriot,123,3927,479,1037,304,589,175,448,272,367,70,423,493,171,109,55,207,272,1405
1022,Tevonn Walker,2015,2018,Valparaiso,Total,124,3374,470,1141,347,733,123,408,342,458,142,387,529,195,150,9,182,295,1405
1023,Rodney Bullock,2016,2018,Providence,Big East,102,3351,486,1110,359,723,127,387,305,414,172,476,648,120,89,107,210,265,1404
1024,Zavier Turner,2014,2018,Total,Total,120,3595,396,1017,204,523,192,494,420,503,46,199,245,435,103,2,381,300,1404
1025,Trey Kell,2015,2018,San Diego State,MWC,134,3640,461,1212,311,727,150,485,331,468,82,436,518,320,126,30,206,176,1403
1026,Winston Shepard,2013,2016,San Diego State,MWC,139,3583,467,1165,426,996,41,169,428,653,217,491,708,315,103,47,308,198,1403
1027,Chris Hass,2013,2016,Bucknell,Patriot,104,2753,460,1076,270,565,190,511,292,351,72,288,360,104,69,40,146,172,1402
1028,Elijah Stewart,2015,2018,Southern California,Pac-12,138,3741,485,1131,240,503,245,628,187,249,120,331,451,148,105,125,132,333,1402
1029,Okaro White,2011,2014,Florida State,ACC,139,3417,466,944,397,733,69,211,401,502,254,450,704,95,103,107,217,398,1402
1030,Miles Jackson-Cartwright,2011,2014,Pennsylvania,Ivy,118,3896,441,1051,286,602,155,449,364,448,37,290,327,353,130,15,325,285,1401
1031,Morgan Sabia,2008,2011,Hartford,AEC,125,3796,499,1226,257,550,242,676,161,227,147,490,637,113,84,86,225,334,1401
1032,Jared Stohl,2008,2011,Portland,WCC,126,3418,451,996,115,242,336,754,163,187,49,181,230,208,86,1,146,106,1401
1033,Frank Turner,2008,2010,Canisius,MAAC,94,3447,503,1162,444,957,59,205,336,498,95,338,433,449,144,11,350,220,1401
1034,Ben Botts,2008,2011,Purdue-Fort Wayne,Summit,122,3688,468,1067,231,535,237,532,227,266,40,236,276,197,97,16,156,170,1400
1035,Kendall Smith,2014,2018,Total,Total,119,3128,486,1177,362,834,124,343,304,443,62,270,332,354,110,12,250,193,1400
1036,Steve Vasturia,2014,2017,Notre Dame,ACC,137,4402,483,1102,293,581,190,521,244,286,81,336,417,331,128,18,190,274,1400
1037,Justin Black,2011,2014,Morgan State,MEAC,110,3173,486,1177,356,738,130,439,297,479,154,223,377,274,136,6,280,276,1399
1038,Cortez Edwards,2016,2019,Southern Mississippi,CUSA,127,3765,550,1194,475,939,75,255,224,305,154,481,635,367,200,59,204,167,1399
1039,Cameron Jackson,2015,2019,Wofford,Southern,138,2587,569,976,560,949,9,27,252,399,250,467,717,203,168,125,207,388,1399
1040,Ashton Moore,2012,2015,Citadel,Southern,123,3497,462,1197,255,655,207,542,268,337,51,247,298,321,101,10,269,167,1399
1041,Ronald Roberts ,2011,2014,Saint Joseph's,A-10,131,3541,543,953,543,953,0,0,312,527,356,505,861,100,55,116,190,286,1398
1042,Jaleen Smith,2014,2017,New Hampshire,AEC,122,3785,457,1089,316,678,141,411,342,415,129,485,614,364,115,48,266,288,1397
1043,Antonio Green,2016,2019,Total,Total,89,2941,476,1230,201,473,275,757,169,212,43,297,340,183,67,9,236,156,1396
1044,Zachary Hamilton,2015,2018,Prairie View,SWAC,130,3149,474,1195,283,673,191,522,257,324,137,326,463,114,111,39,159,292,1396
1045,Trey Thompkins,2009,2011,Georgia,SEC,89,2628,535,1141,456,920,79,221,247,339,179,514,693,124,90,117,235,196,1396
1046,Mark Alstork,2014,2018,Total,Total,129,3298,422,1087,260,625,162,462,389,507,121,396,517,277,94,65,292,351,1395
1047,Kerwin Roach Jr.,2016,2019,Texas,Big 12,127,3498,473,1099,337,700,136,399,313,483,85,382,467,363,161,32,280,336,1395
1048,Cassius Winston,2017,2019,Michigan State,Big Ten,108,2977,459,976,275,551,184,425,293,349,26,271,297,713,88,11,274,212,1395
1049,William Lee,2015,2018,Alabama-Birmingham,CUSA,132,3383,520,1051,386,684,134,367,220,301,201,644,845,173,95,291,210,243,1394
1050,Luke Maye,2016,2019,North Carolina,ACC,141,2977,543,1180,439,892,104,288,204,302,288,654,942,220,77,68,181,274,1394
1051,Jacobi Boykins,2015,2018,Louisiana Tech,CUSA,132,3247,450,1033,181,346,269,687,224,279,72,374,446,156,145,50,123,267,1393
1052,Jeremy Goode,2008,2010,Mount St. Mary's,NEC,96,3215,446,1052,351,770,95,282,406,606,83,208,291,439,201,6,286,154,1393
1053,Ramone Moore,2009,2012,Temple,A-10,114,3123,496,1123,385,806,111,317,290,384,102,317,419,277,92,14,221,209,1393
1054,Austin Tillotson,2012,2016,Total,Total,124,3871,502,1023,357,655,145,368,244,338,58,235,293,484,164,4,251,259,1393
1055,Devonta White,2011,2014,Georgia State,Total,119,3721,465,1120,338,732,127,388,336,431,58,226,284,415,164,4,255,234,1393
1056,Jeremy Hemsley,2016,2019,San Diego State,MWC,134,3632,483,1135,330,692,153,443,273,406,58,264,322,286,106,42,260,267,1392
1057,Steven Pledger,2010,2013,Oklahoma,Big 12,124,3424,469,1129,220,454,249,675,205,248,100,232,332,167,100,26,177,263,1392
1058,Willie Rodriguez,2015,2018,Binghamton,AEC,116,3422,511,1113,434,839,77,274,292,424,190,464,654,142,93,72,262,273,1391
1059,Tevin Svihovec,2011,2015,Northern Colorado,Big Sky,121,3539,474,1080,390,850,84,230,359,473,58,310,368,331,109,11,260,231,1391
1060,Damen Bell-Holter,2010,2013,Oral Roberts,Total,132,3446,496,1018,470,928,26,90,371,510,312,566,878,143,51,139,228,319,1389
1061,Justin Bibbins,2015,2018,Total,Total,134,3590,418,980,218,490,200,490,353,412,50,279,329,506,130,5,249,299,1389
1062,Julian Mavunga,2009,2012,Miami (OH),MAC,124,3602,433,955,354,713,79,242,444,632,205,594,799,255,76,72,352,277,1389
1063,B.J. Stith,2015,2019,Total,Total,110,2996,485,1183,334,763,151,420,268,324,92,494,586,126,75,20,154,171,1389
1064,Kerron Johnson,2010,2013,Belmont,Total,132,3205,405,848,338,639,67,209,511,682,55,269,324,515,206,6,326,327,1388
1065,Lester Wilson,2013,2016,East Tennessee State,Total,132,3234,487,1194,215,441,272,753,142,197,129,375,504,60,70,17,117,283,1388
1066,Sean Baptiste,2008,2010,Fairleigh Dickinson,NEC,82,2934,472,1074,331,675,141,399,302,417,159,325,484,97,97,18,162,210,1387
1067,Alex Harris,2011,2015,Total,Total,117,3519,457,1120,302,620,155,500,318,465,80,316,396,307,170,15,211,252,1387
1068,C.J. Garner,2009,2013,Total,Total,127,3504,476,1032,437,931,39,101,395,542,95,239,334,343,140,32,265,210,1386
1069,Rashad Hassan,2009,2013,Savannah State,Total,121,2915,561,1008,550,972,11,36,253,404,191,424,615,94,61,85,241,297,1386
1070,Larry Nance,2012,2015,Wyoming,MWC,123,3631,510,978,474,861,36,117,330,428,185,622,807,172,141,135,193,284,1386
1071,Mike Ringgold,2008,2011,Rider,MAAC,133,4030,610,1181,610,1180,0,1,166,466,389,400,789,250,130,93,327,393,1386
1072,Kavin Gilder-Tilbury,2014,2017,Texas State,Sun Belt,128,3345,477,1057,308,606,169,451,262,381,141,376,517,182,127,68,232,326,1385
1073,Mandell Thomas,2013,2016,Fordham,A-10,117,3607,483,1227,319,767,164,460,255,363,121,315,436,274,198,53,212,245,1385
1074,Will Davis,2012,2015,UC-Irvine,Big West,133,3406,593,1083,593,1081,0,2,198,306,306,546,852,90,61,205,206,232,1384
1075,Bryson Johnson,2010,2013,Bucknell,Patriot,133,3690,401,1022,78,210,323,812,259,319,25,260,285,200,47,8,137,194,1384
1076,Mason Plumlee,2010,2013,Duke,ACC,141,3652,525,915,523,905,2,10,332,569,333,755,1088,212,115,199,282,347,1384
1077,John Caleb Sanders,2011,2014,Liberty,Big South,132,3306,457,1098,277,592,180,506,290,388,90,265,355,335,77,4,245,283,1384
1078,Kris Jenkins,2014,2017,Villanova,Big East,146,3319,432,1039,168,331,264,708,255,305,66,372,438,215,101,43,137,278,1383
1079,Taylor Johns,2013,2016,UC-Riverside,Big West,108,3229,509,1043,488,957,21,86,344,538,254,520,774,163,97,182,299,300,1383
1080,Anthony Lamb,2017,2019,Vermont,AEC,85,2220,501,992,411,748,90,244,291,377,149,383,532,112,66,119,169,203,1383
1081,Eli Pemberton,2017,2019,Hofstra,CAA,95,3250,416,929,261,531,155,398,396,515,130,281,411,207,73,12,160,239,1383
1082,Justin Robinson,2016,2019,Virginia Tech,ACC,125,3579,422,949,271,557,151,392,388,502,65,267,332,562,125,14,287,260,1383
1083,Joe Trapani,2009,2011,Boston College,ACC,98,2895,484,1123,331,695,153,428,262,346,182,470,652,150,71,82,172,214,1383
1084,Donavan Monroe,2008,2011,College of Charleston,Southern,139,3653,486,1076,353,701,133,375,277,372,121,241,362,262,114,16,221,262,1382
1085,Drew Viney,2008,2012,Total,Total,95,2850,475,1040,328,687,147,353,285,360,126,423,549,148,90,87,201,230,1382
1086,Sam Maniscalco,2008,2012,Total,Total,139,4116,431,1035,219,412,212,623,307,375,40,248,288,419,127,3,232,257,1381
1087,A.J. Slaughter,2008,2010,Western Kentucky,Sun Belt,102,3024,453,1077,268,581,185,496,290,365,58,225,283,300,137,8,210,177,1381
1088,Matt Bouldin,2008,2010,Gonzaga,WCC,99,3279,460,985,302,573,158,412,302,380,62,348,410,340,142,14,212,170,1380
1089,Lavon Long,2014,2017,Siena,MAAC,129,3729,479,1016,452,935,27,81,394,533,231,461,692,281,110,90,313,466,1379
1090,Mark Payne,2008,2011,UC-Davis,Big West,111,3718,453,823,402,672,51,151,422,527,146,411,557,448,178,40,262,168,1379
1091,Allerik Freeman,2015,2018,Total,Total,133,3480,435,1064,251,576,184,488,324,406,78,314,392,213,90,1,213,175,1378
1092,Mike DiNunno,2009,2013,Total,Total,126,3710,456,1209,231,537,225,672,240,308,50,195,245,406,186,0,301,275,1377
1093,T.J. Williams,2014,2017,Northeastern,CAA,123,3671,445,991,364,734,81,257,406,585,70,322,392,403,95,18,260,222,1377
1094,J'Covan Brown,2010,2012,Texas,Big 12,103,2699,434,1090,271,624,163,466,345,398,51,214,265,284,99,15,222,186,1376
1095,Jalen Hudson,2015,2019,Total,Total,137,2950,469,1120,304,636,165,484,273,405,84,293,377,126,88,41,175,264,1376
1096,Jon Leuer,2008,2011,Wisconsin,Big Ten,123,2810,518,1074,418,802,100,272,240,332,156,395,551,135,51,85,142,199,1376
1097,Norman Powell,2012,2015,UCLA,Pac-12,141,3555,503,1090,392,736,111,354,259,347,58,366,424,214,158,57,180,288,1376
1098,Anthony Cowan,2017,2019,Maryland,Big Ten,99,3319,409,998,259,562,150,436,407,502,49,346,395,437,119,22,259,210,1375
1099,Mike Hughes,2015,2018,Georgia Southern,Sun Belt,124,3773,426,1094,213,469,213,625,310,418,108,451,559,223,172,35,212,292,1375
1100,Bo Spencer,2008,2012,Total,Total,123,3567,448,1189,244,579,204,610,275,326,56,228,284,308,112,13,278,199,1375
1101,Harald Frey,2017,2019,Montana State,Big Sky,96,3149,434,987,225,451,209,536,297,364,51,271,322,372,90,1,178,207,1374
1102,Isaiah Johnson,2014,2017,Akron,MAC,136,3004,508,888,507,881,1,7,357,608,291,457,748,203,55,141,202,294,1374
1103,Juwan Morgan,2016,2019,Indiana,Big Ten,128,2952,517,920,460,728,57,192,283,422,260,496,756,151,105,138,170,302,1374
1104,Xavier Thames,2010,2014,Total,Total,128,3581,427,1080,304,727,123,353,397,488,63,267,330,354,144,22,211,241,1374
1105,Earl Brown,2012,2015,Saint Francis (PA),NEC,115,3409,527,1000,507,932,20,68,299,478,238,554,792,171,95,105,292,231,1373
1106,Elijah Bryant,2015,2018,Total,Total,91,2622,432,989,278,568,154,421,355,444,76,367,443,221,107,40,231,221,1373
1107,Khyle Marshall,2011,2014,Butler,Total,140,3001,572,1055,570,1036,2,19,227,437,269,340,609,52,62,60,123,283,1373
1108,Jeff Roberson,2015,2018,Vanderbilt,SEC,132,3705,427,925,281,555,146,370,373,465,221,534,755,185,85,40,195,369,1373
1109,Marcus Colbert,2013,2016,Montana State,Big Sky,122,3400,468,1108,292,648,176,460,260,343,73,244,317,453,111,6,269,301,1372
1110,Ben Simons,2010,2013,Drake,MVC,125,3533,484,1084,250,498,234,586,170,196,43,304,347,158,79,25,162,187,1372
1111,Franko House,2014,2017,Ball State,MAC,129,3368,493,962,460,841,33,121,352,497,276,465,741,261,77,60,245,435,1371
1112,Marin Maric,2014,2018,Total,Total,124,2943,500,925,478,855,22,70,349,487,307,534,841,104,75,78,238,293,1371
1113,Marcus Morris,2009,2011,Kansas,Big 12,109,2611,508,916,464,793,44,123,311,471,261,415,676,137,102,48,172,279,1371
1114,Keith Shamburger,2011,2015,Total,Total,126,4183,399,1125,208,516,191,609,382,475,74,336,410,525,140,12,227,265,1371
1115,Jordan Theodore,2009,2012,Seton Hall,Big East,129,3720,460,1138,343,792,117,346,334,423,92,237,329,541,180,13,281,281,1371
1116,Brandon Boggs,2011,2014,Western Carolina,Southern,135,3593,528,1304,409,925,119,379,195,300,160,343,503,150,138,74,224,307,1370
1117,Luke Hancock,2010,2014,Total,Total,141,3439,430,950,265,497,165,453,345,439,120,328,448,373,135,34,239,325,1370
1118,Stephen Holt ,2011,2014,Saint Mary's (CA),WCC,127,3962,409,924,258,528,151,396,401,496,164,367,531,305,173,5,184,252,1370
1119,Cameron Reynolds,2014,2018,Tulane,Total,135,3546,489,1262,296,685,193,577,199,278,127,478,605,157,82,45,163,294,1370
1120,Corey Sanders,2016,2018,Rutgers,Big Ten,94,3035,524,1307,440,1000,84,307,238,352,48,294,342,328,136,29,249,164,1370
1121,Jaylon Brown,2014,2017,Evansville,MVC,135,3512,464,970,399,794,65,176,376,484,45,317,362,339,117,15,229,297,1369
1122,Delbert Love,2012,2015,Kennesaw State,A-Sun,124,4080,463,1208,246,575,217,633,226,316,123,308,431,337,176,6,285,250,1369
1123,Chris Wright,2008,2011,Georgetown,Big East,110,3448,474,1033,347,660,127,373,294,393,41,276,317,442,140,16,260,224,1369
1124,J.R. Holder,2014,2017,Jacksonville,A-Sun,126,3188,464,995,368,700,96,295,344,501,145,279,424,161,99,38,230,238,1368
1125,Johnathon Jones,2008,2010,Oakland,Summit,102,3765,461,1077,351,761,110,316,336,407,52,216,268,700,161,16,337,216,1368
1126,Preston Medlin,2010,2014,Utah State,Total,107,3172,445,966,232,455,213,511,265,329,16,306,322,320,55,11,173,130,1368
1127,Kahron Ross,2015,2018,Lehigh,Patriot,123,4043,473,1046,355,738,118,308,304,402,79,281,360,660,161,20,265,250,1368
1128,Alex Robinson,2015,2019,Total,Total,139,4165,510,1194,397,849,113,345,234,376,60,372,432,756,162,42,390,272,1367
1129,Steven Spieth,2014,2017,Brown,Ivy,118,3835,406,901,298,588,108,313,447,527,159,528,687,337,136,46,280,324,1367
1130,Brent Arrington,2012,2016,Total,Total,136,3657,447,1157,314,725,133,432,339,461,146,301,447,303,248,75,265,441,1366
1131,Dave Dudzinski,2011,2014,Holy Cross,Patriot,120,3048,498,1029,439,847,59,182,311,397,238,460,698,66,62,94,162,274,1366
1132,Sean Hoehn,2016,2019,Sacred Heart,NEC,124,3603,449,1064,264,546,185,518,283,347,62,297,359,364,158,9,296,300,1366
1133,Bobby Howard,2008,2011,Montana State,Big Sky,119,3252,488,1176,328,660,160,516,230,387,184,428,612,142,56,18,212,272,1366
1134,AJ Brodeur,2017,2019,Pennsylvania,Ivy,92,2896,566,1067,522,931,44,136,189,318,172,516,688,249,86,148,232,238,1365
1135,Darrell Brown,2017,2019,Bradley,MVC,100,3209,428,1140,254,700,174,440,335,432,21,197,218,340,79,4,274,210,1365
1136,Demontez Stitt,2008,2011,Clemson,ACC,126,3513,455,1061,344,726,111,335,344,468,90,256,346,419,164,46,318,312,1365
1137,Andre Stringer,2011,2014,Louisiana State,SEC,125,3709,421,1122,179,442,242,680,281,357,60,217,277,314,130,10,229,247,1365
1138,Vladimir Brodziansky,2016,2018,Texas Christian,Big 12,105,2551,502,900,456,765,46,135,314,408,211,328,539,80,31,171,124,224,1364
1139,Gregory Echenique,2009,2013,Total,Total,140,3417,496,829,496,828,0,1,372,548,359,632,991,85,72,268,220,334,1364
1140,Diante Garrett,2008,2011,Iowa State,Big 12,128,3952,505,1240,407,910,98,330,256,351,44,318,362,611,153,20,362,204,1364
1141,Jason Clark,2009,2012,Georgetown,Big East,130,3760,475,990,292,486,183,504,230,300,132,343,475,206,170,28,257,280,1363
1142,Jarron Cumberland,2017,2019,Cincinnati,AAC,106,2845,444,1050,266,560,178,490,297,413,121,261,382,282,111,36,195,219,1363
1143,Tyler Davis,2016,2018,Texas A&M,SEC,102,2650,522,850,515,824,7,26,312,483,324,429,753,114,47,117,211,267,1363
1144,Sam Dekker,2013,2015,Wisconsin,Big Ten,113,3153,499,1012,357,604,142,408,223,321,185,384,569,148,73,54,114,137,1363
1145,Ousmane Drame,2012,2015,Quinnipiac,Total,123,3037,497,1022,496,1019,1,3,368,535,411,697,1108,86,57,217,242,379,1363
1146,Evan Gordon,2010,2014,Total,Total,130,3778,456,1116,265,560,191,556,260,345,85,312,397,249,158,25,254,244,1363
1147,Kevin Bailey,2012,2015,Portland,WCC,108,2750,457,1068,353,779,104,289,344,451,76,196,272,156,74,64,256,315,1362
1148,Anthony Campbell,2009,2013,Austin Peay,OVC,114,3150,455,992,274,485,181,507,271,341,106,360,466,158,94,15,222,160,1362
1149,Jermaine Marshall,2011,2014,Total,Total,122,3176,455,1111,265,577,190,534,262,356,52,332,384,171,116,53,200,289,1362
1150,Joey Rodriguez,2008,2011,Virginia Commonwealth,CAA,142,4401,438,1132,227,536,211,596,275,343,98,312,410,580,237,3,326,275,1362
1151,Gavin Ware,2013,2016,Mississippi State,SEC,125,3328,532,943,532,942,0,1,298,435,291,597,888,52,82,100,185,300,1362
1152,John Gillon,2013,2017,Total,Total,129,3411,365,925,180,436,185,489,446,531,40,241,281,489,106,9,252,238,1361
1153,Reginald Johnson,2015,2019,Alcorn State,SWAC,124,2636,539,1163,439,848,100,315,183,272,240,298,538,85,46,23,125,184,1361
1154,Peter Sullivan,2008,2011,Brown,Ivy,111,3373,412,963,270,550,142,413,395,504,100,383,483,162,66,11,203,210,1361
1155,Paul Watson,2014,2017,Fresno State,MWC,135,4014,465,1121,284,621,181,500,250,354,125,471,596,116,106,92,202,373,1361
1156,Quincy Acy,2009,2012,Baylor,Big 12,139,3488,503,835,500,828,3,7,351,496,300,528,828,86,102,177,214,355,1360
1157,Ben Averkamp,2010,2013,Loyola (IL),Horizon,114,3273,510,1101,451,919,59,182,281,364,199,436,635,183,79,148,175,305,1360
1158,Patrick Cole,2013,2017,Total,Total,95,2710,423,1143,295,742,128,401,386,525,80,363,443,343,91,13,299,243,1360
1159,Malcolm Smith,2012,2015,Lipscomb,A-Sun,111,2594,415,882,400,824,15,58,515,761,221,315,536,114,67,20,216,309,1360
1160,Mike Groselle,2010,2013,Citadel,Southern,105,2846,548,930,548,929,0,1,263,371,292,447,739,120,105,49,179,249,1359
1161,C.J. Leslie,2011,2013,North Carolina State,ACC,99,2859,507,1020,494,972,13,48,332,564,222,501,723,113,89,136,236,233,1359
1162,Josh Nzeakor,2016,2019,Lamar,Southland,129,3158,525,936,525,934,0,2,309,529,329,493,822,82,78,67,214,324,1359
1163,Tanner Plomb,2013,2016,Army,Patriot,109,2449,468,1098,284,583,184,515,239,316,74,412,486,130,70,30,151,150,1359
1164,Ben Hansbrough,2008,2011,Total,Total,99,3448,421,925,205,390,216,535,300,384,74,308,382,375,109,11,192,238,1358
1165,DeSean Murray,2015,2019,Total,Total,93,2538,491,965,469,891,22,74,354,475,253,403,656,157,128,48,222,248,1358
1166,Sam Young,2008,2009,Pittsburgh,Big East,73,2333,515,1025,417,765,98,260,230,322,152,305,457,85,76,72,175,133,1358
1167,C.J. Bryce,2016,2019,Total,Total,104,2943,510,1039,417,772,93,267,244,357,158,335,493,192,104,24,176,230,1357
1168,Savalance Townsend,2009,2012,Arkansas-Pine Bluff,SWAC,122,3888,429,1077,308,734,121,343,378,530,110,344,454,259,206,52,319,244,1357
1169,Murphy Burnatowski,2010,2014,Total,Total,118,3106,484,1157,296,628,188,529,200,268,137,344,481,140,133,66,177,258,1356
1170,Christavious Gill,2014,2017,New Orleans,Southland,115,3317,434,1129,236,527,198,602,290,376,73,179,252,252,169,7,180,193,1356
1171,Melquan Bolding,2009,2013,Total,Total,109,3257,464,1181,334,738,130,443,297,413,117,315,432,180,119,19,256,171,1355
1172,Daniel Dixon,2014,2017,William & Mary,CAA,114,2918,452,1029,211,411,241,618,210,257,46,329,375,179,70,45,153,252,1355
1173,Chris Hansen,2013,2015,Idaho State,Big Sky,89,2962,411,1027,182,432,229,595,304,376,45,275,320,157,109,14,141,173,1355
1174,A.J. Jacobson,2015,2018,North Dakota State,Summit,122,3802,429,976,218,452,211,524,286,354,55,481,536,214,59,55,150,294,1355
1175,David Nichols,2016,2019,Total,Total,117,2951,504,1203,359,787,145,416,202,261,39,284,323,288,104,13,230,266,1355
1176,Marcus Graves,2015,2019,Sacramento State,Big Sky,106,3301,478,1130,387,823,91,307,307,417,56,330,386,472,141,13,247,257,1354
1177,Stephen Lumpkins,2009,2013,American,Patriot,124,3202,501,968,501,964,0,4,352,564,256,628,884,107,59,138,166,297,1354
1178,LaQuentin Miles,2010,2014,Total,Total,97,2412,512,1127,493,1059,19,68,311,562,205,266,471,226,134,27,270,171,1354
1179,Jordan Tolbert,2012,2016,Total,Total,124,3096,506,934,494,896,12,38,330,499,291,497,788,80,88,90,229,342,1354
1180,Nick Ward,2017,2019,Michigan State,Big Ten,103,2050,504,833,501,830,3,3,343,544,249,428,677,55,34,143,182,262,1354
1181,Chris Davenport,2014,2017,North Florida,A-Sun,128,3311,482,917,391,657,91,260,298,410,167,658,825,335,88,153,371,339,1353
1182,Trey Davis,2013,2016,Massachusetts,A-10,129,3141,420,1076,232,546,188,530,325,394,59,296,355,348,113,7,222,215,1353
1183,Robert Nyakundi,2009,2012,Southern Methodist,CUSA,123,3206,452,998,185,383,267,615,182,216,127,362,489,124,97,23,189,319,1353
1184,Quinton Rose,2017,2019,Temple,AAC,98,3000,509,1203,398,841,111,362,224,331,66,331,397,218,169,27,224,190,1353
1185,Christian Thomas,2012,2015,Loyola (IL),Total,129,3593,508,917,473,830,35,87,302,460,241,443,684,120,67,16,186,316,1353
1186,Phil Valenti,2014,2017,Canisius,MAAC,125,3288,502,1047,406,774,96,273,253,334,219,423,642,236,109,35,201,316,1353
1187,Warren Gillis,2012,2015,Coastal Carolina,Big South,125,3416,484,1081,405,830,79,251,305,363,79,310,389,286,164,11,271,267,1352
1188,Desharick Guidry,2012,2015,McNeese State,Southland,116,3504,510,1103,436,887,74,216,258,375,359,573,932,123,129,53,195,343,1352
1189,Tramaine Isabell,2015,2019,Total,Total,118,2964,462,1099,329,683,133,416,295,397,84,354,438,297,113,4,257,179,1352
1190,Trevor Booker,2008,2010,Clemson,ACC,98,2872,528,964,505,893,23,71,272,435,288,540,828,186,112,171,189,207,1351
1191,Chris Thomas,2014,2016,Total,Total,100,3011,502,1062,443,838,59,224,288,515,174,295,469,257,111,46,288,268,1351
1192,Amanze Egekeze,2015,2018,Belmont,OVC,127,3322,448,909,226,355,222,554,232,286,142,439,581,103,70,62,136,313,1350
1193,Tyler Johnson,2011,2014,Fresno State,Total,128,3538,491,1077,372,757,119,320,249,348,183,436,619,303,140,36,176,337,1350
1194,Jeremy Lin,2008,2010,Harvard,Ivy,87,2848,462,946,363,654,99,292,327,451,76,348,424,357,197,67,280,261,1350
1195,Cameron Young,2017,2019,Quinnipiac,MAAC,70,2245,409,908,241,456,168,452,364,479,93,293,386,149,78,20,182,154,1350
1196,Aaron Calixte,2015,2019,Total,Total,131,3653,480,1104,327,665,153,439,236,273,67,241,308,365,78,8,360,260,1349
1197,Kalin Fisher,2016,2019,Hampton,Total,128,3282,475,1186,351,770,124,416,275,362,78,357,435,244,112,17,191,229,1349
1198,Robert Franks,2016,2019,Washington State,Pac-12,111,2619,463,992,297,553,166,439,257,310,122,400,522,161,38,70,211,245,1349
1199,Kason Harrell,2016,2019,Purdue-Fort Wayne,Summit,115,3038,491,1038,257,458,234,580,133,173,71,257,328,163,106,67,158,216,1349
1200,Jeremy Montgomery,2009,2012,Cleveland State,Horizon,139,3527,446,1099,234,499,212,600,245,311,66,197,263,276,125,5,281,309,1349
1201,Brandon Fortenberry,2009,2013,Southeastern Louisiana,Southland,120,3639,444,1057,276,587,168,470,292,407,64,315,379,421,110,28,254,255,1348
1202,Malcolm Grant,2008,2012,Total,Total,129,3236,408,1058,151,409,257,649,275,336,26,189,215,332,76,3,238,176,1348
1203,Fred Sims Jr.,2016,2018,Chicago State,WAC,92,2634,482,1397,310,852,172,545,212,255,72,264,336,106,77,16,146,136,1348
1204,Verdell Jones,2009,2012,Indiana,Big Ten,117,3297,454,1067,386,839,68,228,371,510,81,304,385,389,97,43,342,232,1347
1205,Glenn Sanabria,2015,2019,St. Francis (NY),NEC,126,3666,453,1188,215,543,238,645,203,312,105,215,320,326,139,32,172,270,1347
1206,Marcus Thornton,2008,2009,Louisiana State,SEC,66,2159,468,1028,300,588,168,440,243,315,134,232,366,117,99,23,132,134,1347
1207,Scott Bamforth,2011,2013,Weber State,Big Sky,99,3026,415,895,157,317,258,578,258,298,32,286,318,248,83,4,159,180,1346
1208,Zach LeDay,2013,2017,Total,Total,130,3029,442,916,400,782,42,134,420,552,253,424,677,109,67,115,152,311,1346
1209,Donald Sloan,2008,2010,Texas A&M,Big 12,104,3254,452,1077,350,774,102,303,340,461,60,327,387,310,63,5,218,152,1346
1210,Jordan Sugars,2009,2012,Navy,Patriot,116,3245,456,1122,257,559,199,563,235,335,189,435,624,115,118,15,203,210,1346
1211,Emmy Andujar,2012,2015,Manhattan,MAAC,130,3505,492,1004,455,888,37,116,324,465,240,529,769,367,167,32,369,328,1345
1212,Lamonte Bearden,2015,2019,Total,Total,124,3592,434,1008,370,793,64,215,413,540,85,241,326,504,188,29,271,286,1345
1213,D.J. Fenner,2014,2017,Nevada,MWC,135,3544,453,1177,323,783,130,394,309,381,98,342,440,183,116,46,200,319,1345
1214,Tony Taylor,2009,2012,George Washington,A-10,121,3821,434,1081,322,753,112,328,365,522,69,260,329,486,130,9,267,267,1345
1215,Travis Taylor,2009,2013,Total,Total,122,3191,521,983,521,978,0,5,303,492,253,521,774,138,77,84,260,258,1345
1216,Shawn Anderson,2015,2018,Navy,Patriot,125,3296,473,1044,414,823,59,221,339,496,156,364,520,314,107,8,254,211,1344
1217,Yonel Brown,2013,2016,Kennesaw State,A-Sun,124,3749,433,1107,258,605,175,502,303,366,45,187,232,277,114,1,256,206,1344
1218,Emmett Naar,2015,2018,Saint Mary's (CA),WCC,135,4533,460,998,308,638,152,360,271,320,48,309,357,815,111,15,326,157,1343
1219,Davon Reed,2014,2017,Miami (FL),ACC,131,3679,438,1018,236,506,202,512,265,340,86,391,477,216,113,48,187,247,1343
1220,Trae Golden,2011,2014,Total,Total,127,3384,402,1013,272,614,130,399,408,511,55,251,306,441,72,5,255,219,1342
1221,Pookie Powell,2015,2019,Total,Total,107,3103,456,1125,297,642,159,483,271,331,34,329,363,348,112,14,232,179,1342
1222,Antoine Young,2009,2012,Creighton,MVC,142,3815,454,1120,382,875,72,245,362,509,40,217,257,505,101,4,229,175,1342
1223,Kyle Fogg,2009,2012,Arizona,Total,139,3829,404,983,211,505,193,478,340,441,74,309,383,302,124,34,226,286,1341
1224,MiKyle McIntosh,2015,2018,Total,Total,132,3261,451,1078,341,755,110,323,329,478,212,470,682,187,78,64,275,426,1341
1225,Kyle Randall,2010,2013,Total,Total,124,3666,445,1187,309,785,136,402,315,387,81,233,314,316,94,3,281,194,1341
1226,Trevor Gruis,2011,2014,South Dakota,Total,121,3491,512,920,512,920,0,0,316,486,249,518,767,191,76,112,259,380,1340
1227,Marvin Prochet,2016,2019,Niagara,MAAC,127,3882,463,1136,287,663,176,473,238,337,225,606,831,179,89,119,149,276,1340
1228,Matt Rafferty,2016,2019,Furman,Southern,117,3144,505,877,465,749,40,128,290,384,275,576,851,311,186,98,166,261,1340
1229,Jakeenan Gant,2015,2019,Total,Total,116,2608,529,993,450,751,79,242,202,271,226,388,614,81,63,199,140,248,1339
1230,Kyle Hittle,2014,2016,Incarnate Word,Southland,84,2904,453,903,262,442,191,461,242,334,91,411,502,173,82,30,134,186,1339
1231,Earnest Ross,2010,2014,Total,SEC,132,3391,417,1064,248,539,169,525,336,442,196,488,684,178,157,34,228,255,1339
1232,Evan Hymes,2012,2015,Siena,MAAC,130,3554,422,1138,242,611,180,527,314,403,60,142,202,361,106,4,341,283,1338
1233,Marc Loving,2014,2017,Ohio State,Big Ten,134,3414,414,988,238,511,176,477,334,442,135,376,511,141,62,48,228,243,1338
1234,Herb Pope,2008,2012,Total,Total,111,3198,528,1165,494,1051,34,114,248,450,356,675,1031,184,101,164,265,355,1338
1235,Jeff Short,2012,2016,Total,Total,102,2670,426,988,257,519,169,469,317,392,46,274,320,173,72,24,214,191,1338
1236,Eric Stutz,2012,2015,Eastern Kentucky,OVC,133,3392,502,825,471,749,31,76,303,388,233,415,648,204,95,84,217,317,1338
1237,Jonathan Tavernari,2008,2010,Brigham Young,MWC,104,2857,493,1189,257,569,236,620,116,143,83,497,580,165,147,34,147,211,1338
1238,Travis Wallace,2010,2014,Total,Total,127,2670,552,1048,551,1044,1,4,233,384,244,410,654,100,54,82,173,192,1338
1239,A'uston Calhoun,2010,2013,Bowling Green State,MAC,99,2855,529,1166,490,1033,39,133,240,324,205,398,603,64,54,55,191,223,1337
1240,Jake O'Brien,2009,2013,Total,Total,114,3296,466,1102,270,589,196,513,209,278,180,377,557,63,60,112,155,317,1337
1241,Levi Randolph,2012,2015,Alabama,SEC,135,4139,455,1043,336,683,119,360,307,411,167,411,578,243,150,21,177,269,1336
1242,John Carroll,2015,2019,Hartford,AEC,121,3053,464,1087,398,873,66,214,341,493,197,446,643,200,54,62,225,336,1335
1243,Romone Saunders ,2015,2019,Wagner,NEC,110,3109,434,1099,245,553,189,546,278,354,180,421,601,257,126,21,210,271,1335
1244,Khalil Small,2015,2018,Green Bay,Horizon,121,3018,459,1046,343,718,116,328,301,384,194,345,539,215,114,21,202,306,1335
1245,Marcus Tyus,2013,2017,Omaha,Summit,118,2648,451,967,287,569,164,398,268,357,86,239,325,168,124,12,203,269,1334
1246,Isaac Copeland,2015,2019,Total,Total,126,3472,488,1064,367,693,121,371,236,315,170,466,636,155,87,90,161,223,1333
1247,Nick Johnson,2012,2014,Arizona,Pac-12,108,3339,441,1048,297,647,144,401,307,418,64,331,395,304,137,64,197,220,1333
1248,Eric Maynor,2008,2009,Virginia Commonwealth,CAA,66,2321,444,963,328,653,116,310,329,415,40,216,256,385,98,13,197,143,1333
1249,Keith Rendelman,2011,2013,North Carolina-Wilmington,CAA,92,3032,519,949,510,924,9,25,286,474,348,519,867,85,122,110,179,286,1333
1250,Josh Ritchart,2011,2015,UC-Davis,Big West,130,3014,473,1003,239,435,234,568,153,224,103,420,523,116,66,68,168,282,1333
1251,Alex Tyus,2008,2011,Florida,SEC,142,3271,560,1048,554,1032,6,16,207,317,248,523,771,80,54,115,164,221,1333
1252,Dionte Christmas,2008,2009,Temple,A-10,68,2457,428,1005,217,419,211,586,265,347,79,320,399,184,97,12,194,175,1332
1253,Denzel Ingram,2013,2017,Total,Total,128,3784,453,1170,204,493,249,677,177,238,54,210,264,399,140,7,198,257,1332
1254,Matt Tiby,2014,2016,Milwaukee,Horizon,98,2811,390,900,293,618,97,282,455,574,164,570,734,191,41,32,245,256,1332
1255,Anthony Gurley,2009,2011,Massachusetts,A-10,92,2571,455,1129,300,675,155,454,266,360,72,286,358,99,59,7,206,146,1331
1256,Matt Van Scyoc,2013,2017,Total,Total,126,3450,423,1020,181,359,242,661,243,329,82,375,457,101,48,61,195,349,1331
1257,Ty Abbott,2008,2011,Arizona State,Pac-10,130,4019,454,1138,181,381,273,757,149,213,80,425,505,234,133,56,199,314,1330
1258,Kimbal MacKenzie,2016,2019,Bucknell,Patriot,122,3306,419,996,208,442,211,554,281,328,56,193,249,291,93,8,187,245,1330
1259,Damian Eargle,2009,2013,Total,Total,122,3357,532,1148,531,1141,1,7,264,481,263,521,784,71,95,366,188,335,1329
1260,Codi Miller-McIntyre,2013,2016,Wake Forest,ACC,117,3607,496,1150,428,905,68,245,269,426,103,332,435,441,93,15,255,237,1329
1261,Armon Fletcher,2015,2019,Southern Illinois,MVC,119,3139,464,989,318,575,146,414,254,350,166,355,521,134,131,47,146,272,1328
1262,Joe Harden,2009,2011,UC-Davis,Big West,90,2848,437,1001,395,844,42,157,412,537,156,445,601,153,113,32,232,268,1328
1263,Joel Smith,2010,2013,Northeastern,CAA,120,3278,440,996,197,387,243,609,205,241,81,298,379,248,79,23,218,212,1328
1264,Myles Stephens,2016,2019,Princeton,Ivy,115,3152,504,1040,402,745,102,295,218,318,124,435,559,119,66,78,196,197,1328
1265,J.T. Durley,2008,2011,Wichita State,MVC,137,3073,493,1019,427,788,66,231,275,372,187,430,617,127,53,91,231,342,1327
1266,Mackey McKnight,2011,2014,Lehigh,Patriot,127,3914,419,1040,296,661,123,379,366,472,69,335,404,578,145,18,284,285,1327
1267,Javion Ogunyemi,2014,2017,Siena,MAAC,129,3313,499,951,487,908,12,43,317,508,305,300,605,107,49,206,185,378,1327
1268,Shemik Thompson,2008,2011,Central Connecticut State,NEC,116,3838,480,1204,397,916,83,288,284,378,124,335,459,483,202,11,347,234,1327
1269,Kendall Timmons,2009,2013,Tulane,CUSA,120,3433,452,1019,408,886,44,133,379,570,193,446,639,249,160,79,247,263,1327
1270,Isaiah Cousins,2013,2016,Oklahoma,Big 12,137,3794,474,1162,298,730,176,432,202,284,113,416,529,365,157,36,254,276,1326
1271,E.J. Crawford,2017,2019,Iona,MAAC,101,2934,461,967,302,554,159,413,245,305,73,314,387,136,55,23,124,207,1326
1272,Trevon Harmon,2009,2012,Cleveland State,Horizon,124,3484,442,1112,236,494,206,618,236,290,98,232,330,184,163,4,162,256,1326
1273,Darion Rackley,2012,2015,Jacksonville State,OVC,109,2943,361,945,237,517,124,428,480,646,92,199,291,201,140,34,231,235,1326
1274,Rashawn Rembert,2012,2015,East Tennessee State,Total,115,3210,425,1019,165,361,260,658,216,268,58,209,267,147,102,22,155,129,1326
1275,Jauwan Scaife,2010,2013,Ball State,MAC,120,3369,403,1076,200,497,203,579,317,405,53,223,276,187,105,12,198,200,1326
1276,Dakarai Henderson,2014,2017,Sam Houston State,Southland,132,2978,449,1206,211,503,238,703,189,281,74,205,279,126,64,7,147,152,1325
1277,Shaquille Hines,2013,2016,Texas-Rio Grande Valley,Total,124,3514,542,1112,495,951,47,161,194,310,209,411,620,184,91,74,223,328,1325
1278,Kenny Gaines,2013,2016,Georgia,SEC,127,3138,444,1091,231,522,213,569,223,302,84,234,318,125,92,83,154,305,1324
1279,Alex Young,2013,2016,UC-Irvine,Big West,139,4060,466,1143,336,747,130,396,262,355,92,412,504,576,154,33,233,291,1324
1280,Terance Mann,2016,2019,Florida State,ACC,140,3620,505,915,451,750,54,165,258,385,266,444,710,269,112,34,191,284,1322
1281,Kendrick Ray,2013,2017,Total,Total,93,2461,493,1085,363,728,130,357,206,278,78,245,323,220,74,19,184,207,1322
1282,Austin Hollins,2011,2014,Minnesota,Big Ten,141,3875,452,1050,271,520,181,530,236,303,169,281,450,293,213,57,198,247,1321
1283,Casey Jones,2013,2017,Chattanooga,Southern,119,3187,508,995,486,917,22,78,283,400,271,391,662,215,115,93,278,294,1321
1284,Marcus Posley,2013,2016,Total,Total,92,2942,435,1121,245,544,190,577,261,334,45,211,256,265,99,4,196,207,1321
1285,Willie Powers,2008,2012,Georgia Southern,Southern,105,3256,466,1042,353,704,113,338,276,369,86,273,359,460,122,13,290,221,1321
1286,Taurean Prince,2013,2016,Baylor,Big 12,129,2604,468,1017,338,671,130,346,255,355,202,345,547,145,121,63,221,271,1321
1287,Zach Urbanus,2008,2011,Citadel,Southern,127,4529,440,1119,145,414,295,705,146,189,60,338,398,353,102,4,229,160,1321
1288,Logan Aronhalt,2009,2013,Total,Total,132,3122,445,1138,213,515,232,623,198,245,133,266,399,110,69,35,191,122,1320
1289,Olu Ashaolu,2009,2012,Total,Total,134,3279,499,939,479,857,20,82,302,553,311,591,902,134,88,42,322,418,1320
1290,Tanner Samson,2013,2016,Elon,Total,129,3616,390,1008,66,146,324,862,216,262,62,438,500,220,133,35,116,306,1320
1291,Aleksa Jugovic,2015,2018,Tennessee Tech,OVC,116,3328,417,978,187,380,230,598,255,292,24,211,235,288,96,10,190,173,1319
1292,Bryce Washington,2015,2018,Louisiana,Sun Belt,136,3865,519,922,513,893,6,29,275,432,407,695,1102,243,134,88,225,284,1319
1293,Jordan Hulls,2010,2013,Indiana,Big Ten,135,3898,444,952,190,377,254,575,176,205,50,262,312,365,115,9,210,248,1318
1294,Terone Johnson,2011,2014,Purdue,Big Ten,134,3507,496,1207,376,842,120,365,206,376,133,341,474,299,90,22,197,257,1318
1295,Albert Owens,2015,2018,Oral Roberts,Summit,126,2840,529,1127,523,1101,6,26,254,377,198,336,534,76,45,159,155,215,1318
1296,Troy Caupain,2014,2017,Cincinnati,AAC,137,3981,433,1092,279,637,154,455,297,390,69,421,490,515,151,32,222,200,1317
1297,Adam Grant,2017,2019,Bryant,NEC,89,3204,462,1163,258,591,204,572,189,250,82,217,299,196,106,10,190,200,1317
1298,Martaveous McKnight,2018,2019,Arkansas-Pine Bluff,SWAC,67,2311,443,991,305,618,138,373,293,409,38,272,310,218,116,16,179,70,1317
1299,Devon Moore,2009,2013,James Madison,CAA,124,4177,441,934,381,758,60,176,375,491,135,296,431,501,116,33,316,310,1317
1300,Khalid Mutakabbir,2011,2013,Presbyterian,Big South,92,3452,470,1061,325,685,145,376,232,291,69,219,288,209,99,16,248,192,1317
1301,Cashmere Wright,2010,2013,Cincinnati,Big East,139,3650,451,1134,265,601,186,533,229,321,72,297,369,482,198,5,268,262,1317
1302,Akwasi Yeboah,2017,2019,Stony Brook,AEC,95,2588,436,1049,266,542,170,507,275,346,130,436,566,109,70,38,189,236,1317
1303,Luke Babbitt,2009,2010,Nevada,WAC,68,2370,445,927,370,749,75,178,351,393,133,421,554,119,59,51,146,148,1316
1304,Grant Mullins,2013,2017,Total,Total,117,3535,407,938,189,400,218,538,284,334,44,340,384,277,102,17,164,226,1316
1305,Demajeo Wiggins,2016,2019,Bowling Green State,MAC,129,3101,465,880,465,880,0,0,386,611,319,747,1066,80,42,67,235,263,1316
1306,Tre'Von Willis,2009,2011,Nevada-Las Vegas,MWC,94,2741,412,947,296,580,116,367,376,465,88,281,369,323,122,17,217,237,1316
1307,Sandy Cohen,2015,2019,Total,Total,125,3218,432,945,298,549,134,396,317,429,46,472,518,316,145,76,232,294,1315
1308,Tyler Cook,2017,2019,Iowa,Big Ten,93,2601,494,911,491,890,3,21,324,507,196,423,619,164,63,49,238,231,1315
1309,David Lighty,2008,2011,Ohio State,Big Ten,118,3945,467,994,334,640,133,354,248,399,159,330,489,334,171,48,239,251,1315
1310,Corey Stokes,2008,2011,Villanova,Big East,134,3298,413,1008,149,331,264,677,225,257,93,345,438,123,88,34,148,274,1315
1311,Aaron Craft,2011,2014,Ohio State,Big Ten,148,4818,440,958,348,682,92,276,342,464,72,420,492,694,337,20,324,364,1314
1312,Durrell Summers,2008,2011,Michigan State,Big Ten,145,3171,474,1094,313,661,161,433,205,278,174,358,532,103,74,31,201,243,1314
1313,Muhammad-Ali Abdur-Rahkman,2015,2018,Michigan,Big Ten,144,4147,467,1051,309,619,158,432,221,293,84,325,409,295,108,20,125,249,1313
1314,Darell Combs,2014,2017,Total,Total,99,2521,436,1076,279,643,157,433,284,377,37,158,195,210,71,6,238,241,1313
1315,John Dickson,2010,2013,Sacramento State,Big Sky,115,2933,456,1077,384,836,72,241,329,456,164,344,508,96,76,100,199,293,1313
1316,James Feldeine,2008,2010,Quinnipiac,NEC,93,2920,480,1126,365,799,115,327,238,311,123,370,493,208,122,22,213,203,1313
1317,Damian Jones,2014,2016,Vanderbilt,SEC,99,2684,508,897,507,889,1,8,296,524,207,423,630,71,37,167,197,301,1313
1318,Emile Blackman,2015,2017,Total,Total,94,2990,477,1074,353,719,124,355,234,295,113,244,357,133,71,22,205,241,1312
1319,Jim Mower,2009,2012,Lafayette,Patriot,120,3098,432,992,197,405,235,587,213,249,39,228,267,169,52,20,134,215,1312
1320,Corey Raji,2008,2011,Boston College,ACC,126,3228,518,991,469,830,49,161,227,350,347,377,724,162,81,15,122,249,1312
1321,Christian Terrell,2015,2018,Florida Gulf Coast,A-Sun,136,3375,472,1038,298,567,174,471,194,260,103,404,507,291,105,38,191,205,1312
1322,Mikal Bridges,2016,2018,Villanova,Big East,116,3171,458,873,287,445,171,428,224,265,131,373,504,183,163,101,124,257,1311
1323,Tyler Kalinoski,2012,2015,Davidson,Total,132,3570,450,1026,207,403,243,623,168,221,144,367,511,336,124,26,141,284,1311
1324,Daxter Miles,2015,2018,West Virginia,Big 12,136,3256,464,1070,283,530,181,540,202,317,149,181,330,241,177,7,146,354,1311
1325,Chris Smith,2008,2012,Total,Total,125,3474,449,1115,288,657,161,458,251,357,157,387,544,222,107,13,191,188,1310
1326,Elston Turner,2009,2013,Total,Total,132,3194,456,1109,246,548,210,561,188,243,49,295,344,207,98,23,167,151,1310
1327,Maurice Barrow,2011,2014,Fairfield,MAAC,137,3839,484,1041,441,899,43,142,298,429,288,421,709,193,121,87,256,331,1309
1328,Mike Brown,2013,2016,Western Carolina,Southern,133,3396,446,1065,333,730,113,335,304,421,248,370,618,235,127,51,226,347,1309
1329,Stephen Brown,2015,2018,Bucknell,Patriot,131,3450,457,967,320,608,137,359,258,344,58,328,386,524,147,15,207,254,1309
1330,Branden Dawson,2012,2015,Michigan State,Big Ten,130,3456,566,1013,566,1004,0,9,177,317,329,573,902,181,163,142,219,212,1309
1331,James Harden,2008,2009,Arizona State,Pac-10,69,2412,417,824,315,553,102,271,373,494,92,282,374,258,132,30,207,171,1309
1332,Carlon Brown,2008,2012,Total,Total,134,3516,478,1085,388,790,90,295,262,370,121,424,545,307,92,30,270,239,1308
1333,Dion Nesmith,2012,2015,Total,Total,127,3587,451,1110,283,632,168,478,238,315,92,264,356,330,147,10,230,369,1308
1334,Miye Oni,2017,2019,Yale,Ivy,87,2756,450,1052,276,563,174,489,234,301,71,468,539,287,74,91,222,245,1308
1335,Alphonso Dawson,2008,2011,Delaware,CAA,113,3483,497,1334,341,792,156,542,157,218,204,347,551,136,93,34,196,263,1307
1336,Marcus Jackson,2014,2018,Total,Total,122,3692,429,1066,204,440,225,626,224,291,50,272,322,369,106,18,240,179,1307
1337,Chase Plummer,2011,2014,Maryland-Baltimore County,AEC,118,2708,457,1140,396,938,61,202,332,538,214,449,663,144,157,33,302,326,1307
1338,Umar Shannon,2010,2014,Total,Total,100,3033,404,1078,213,550,191,528,308,383,55,168,223,226,46,3,216,205,1307
1339,Rasheed Sulaimon,2013,2016,Total,Total,126,3491,425,991,253,562,172,429,285,373,48,322,370,309,115,7,173,244,1307
1340,Allonzo Trier,2016,2018,Arizona,Pac-12,78,2456,397,828,253,447,144,381,369,446,28,257,285,185,42,19,153,141,1307
1341,Patric Young,2011,2014,Florida,SEC,150,3638,536,929,536,929,0,0,235,413,345,505,850,115,98,160,187,358,1307
1342,Chase Fieler,2011,2014,Florida Gulf Coast,A-Sun,134,3458,487,971,384,644,103,327,229,317,253,461,714,203,108,134,201,362,1306
1343,Jordon Talley,2015,2018,North Carolina-Wilmington,CAA,125,3097,419,1052,302,711,117,341,351,447,69,239,308,479,129,7,219,386,1306
1344,Antwaine Wiggins,2008,2012,College of Charleston,Southern,136,3939,487,1156,313,611,174,545,158,286,235,467,702,232,127,122,205,205,1306
1345,Josh Davis,2010,2014,Total,Total,131,3675,475,1033,464,1003,11,30,344,562,389,667,1056,176,100,88,229,245,1305
1346,Kris Davis,2012,2015,Southern Illinois-Edwardsville,OVC,111,3493,450,1015,268,597,182,418,223,338,35,311,346,278,100,7,263,168,1305
1347,Derrick Gordon,2012,2016,Total,Total,134,3819,463,1127,422,963,41,164,338,518,174,446,620,280,158,41,294,253,1305
1348,Scotty Hopson,2009,2011,Tennessee,SEC,103,2757,475,1071,324,645,151,426,204,304,87,237,324,134,83,21,217,168,1305
1349,Derek Jackson,2011,2015,Total,MAC,129,4092,447,1100,246,559,201,541,210,296,78,288,366,293,225,20,195,178,1305
1350,Anthony James,2009,2013,Northern Iowa,MVC,128,3074,481,1107,351,779,130,328,213,280,48,335,383,148,87,2,182,195,1305
1351,Jon Severe,2014,2017,Total,Total,118,2885,431,1130,247,614,184,516,259,324,89,234,323,218,101,23,241,242,1305
1352,Frank Bartley,2014,2018,Total,Total,133,2758,409,962,235,485,174,477,312,426,80,311,391,214,128,23,163,194,1304
1353,Tyrone Conley,2008,2011,New Hampshire,AEC,116,3520,442,1216,220,536,222,680,198,293,122,260,382,173,115,48,215,297,1304
1354,Rashun Davis,2013,2016,Radford,Big South,130,3237,441,1062,355,761,86,301,336,449,44,281,325,457,170,3,323,275,1304
1355,Darryl Partin,2008,2012,Total,Total,116,2708,445,1111,280,619,165,492,249,336,75,215,290,109,85,18,242,184,1304
1356,Marquis Weddle,2008,2010,Tennessee-Martin,OVC,84,2653,458,1186,218,482,240,704,148,187,32,184,216,111,76,1,174,111,1304
1357,Malachi Alexander,2014,2017,Holy Cross,Patriot,131,3743,433,984,299,648,134,336,303,456,180,469,649,224,128,53,230,333,1303
1358,Braxton Huggins,2015,2019,Total,Total,124,2536,414,997,180,384,234,613,241,297,51,253,304,142,63,26,170,189,1303
1359,Payton Pritchard,2017,2019,Oregon,Pac-12,113,3719,441,1042,241,495,200,547,221,280,74,342,416,487,164,6,207,259,1303
1360,Isaiah Wilkerson,2010,2012,NJIT,GWC,91,2709,449,1080,328,731,121,349,284,375,184,353,537,164,115,16,189,261,1303
1361,Kenny Lawson,2008,2011,Creighton,MVC,141,2776,503,972,464,869,39,103,257,340,227,526,753,71,42,153,156,231,1302
1362,James Sinclair,2012,2015,Western Carolina,Southern,129,3384,465,1162,337,743,128,419,244,323,172,376,548,241,179,47,202,247,1302
1363,Marquis Vance,2014,2017,Alcorn State,SWAC,124,3659,433,1144,327,800,106,344,330,543,237,567,804,209,72,78,232,247,1302
1364,Calvin Hermanson,2015,2018,Saint Mary's (CA),WCC,131,3329,451,943,197,345,254,598,144,187,82,260,342,99,60,27,98,266,1300
1365,Hassan Martin,2014,2017,Rhode Island,A-10,121,3284,518,894,515,870,3,24,261,427,247,539,786,71,75,320,164,342,1300
1366,James McGee,2015,2018,Southern Utah,Big Sky,120,3299,390,930,101,255,289,675,231,302,37,210,247,243,92,17,147,253,1300
1367,Cedric Hankerson,2014,2018,Boston University,Patriot,121,3079,387,990,152,341,235,649,290,449,79,281,360,162,178,14,162,289,1299
1368,Jordan Miller,2008,2011,Furman,Southern,118,3204,424,1117,264,640,160,477,291,373,60,289,349,185,113,39,225,285,1299
1369,Keyshawn Woods,2015,2019,Total,Total,128,3500,480,1042,326,653,154,389,185,236,66,325,391,294,80,8,188,277,1299
1370,Jarrod Uthoff,2014,2016,Iowa,Big Ten,100,2648,458,1018,321,660,137,358,245,308,148,431,579,121,81,177,104,141,1298
1371,Ray Bowles,2015,2018,Total,Total,124,3700,438,1076,315,697,123,379,298,437,136,323,459,271,106,18,218,315,1297
1372,Trevon Hughes,2008,2010,Wisconsin,Big Ten,101,3198,404,1023,235,554,169,469,320,444,87,273,360,266,166,21,203,268,1297
1373,Lorne Jackson,2009,2013,Pepperdine,WCC,125,3129,422,1013,278,574,144,439,309,399,65,280,345,311,159,15,314,319,1297
1374,Jaron Lane,2010,2014,North Carolina-Asheville,Big South,120,2934,431,832,362,641,69,191,366,489,162,310,472,128,86,53,167,223,1297
1375,Brian Bernardi,2013,2017,Total,Total,130,3782,410,1042,131,320,279,722,197,231,23,248,271,174,77,11,141,175,1296
1376,Obi Enechionyia,2015,2018,Temple,AAC,130,3449,457,1114,257,568,200,546,182,245,170,443,613,100,60,170,130,346,1296
1377,T.J. Warren,2013,2014,North Carolina State,ACC,70,2182,528,951,483,808,45,143,195,298,187,209,396,68,105,36,117,174,1296
1378,James Demery,2015,2018,Saint Joseph's,A-10,117,3191,483,1077,437,888,46,189,283,459,164,370,534,115,82,35,176,215,1295
1379,Phil Fayne,2017,2019,Illinois State,MVC,97,2681,508,888,508,887,0,1,279,482,285,361,646,69,91,108,143,270,1295
1380,Xavier Silas,2008,2011,Total,Total,74,2298,390,940,266,589,124,351,391,487,80,247,327,127,70,24,209,205,1295
1381,Robert Vaden,2008,2009,Alabama-Birmingham,CUSA,67,2410,427,1061,173,382,254,679,187,231,38,246,284,155,67,28,181,126,1295
1382,Kahlil Dukes,2014,2018,Total,Total,105,2498,427,983,248,548,179,435,261,287,17,163,180,254,63,2,175,133,1294
1383,Montrezl Harrell,2013,2015,Louisville,Total,112,2961,533,910,522,870,11,40,217,407,294,483,777,102,91,118,145,214,1294
1384,George King,2014,2018,Colorado,Pac-12,127,2866,444,1001,263,550,181,451,225,308,183,498,681,88,50,37,196,224,1294
1385,Billy White,2008,2011,San Diego State,MWC,134,3530,529,881,514,831,15,50,221,332,261,353,614,161,149,102,222,366,1294
1386,Kyle Anderson,2012,2015,Delaware,CAA,122,4048,435,1152,166,372,269,780,153,198,91,322,413,138,85,42,149,279,1292
1387,Canyon Barry,2014,2017,Total,Total,105,2882,423,1093,263,625,160,468,286,354,79,288,367,125,77,42,180,167,1292
1388,Kevon Harris,2017,2019,Stephen F. Austin,Southland,96,2642,420,858,291,527,129,331,323,456,171,323,494,137,86,38,204,180,1292
1389,Jerome Hill,2013,2015,Gardner-Webb,Big South,98,2703,440,907,434,867,6,40,406,643,306,458,764,122,59,43,200,236,1292
1390,Zach Lewis,2014,2018,Total,Total,129,3600,426,1168,198,481,228,687,212,276,48,264,312,273,175,31,161,260,1292
1391,Gary Bell,2012,2015,Gonzaga,WCC,135,3823,433,968,214,432,219,536,206,274,50,287,337,265,111,9,162,279,1291
1392,Alec Burks,2010,2011,Colorado,Big 12,68,2100,423,855,376,705,47,150,398,495,149,248,397,165,76,24,157,163,1291
1393,Wayne Chism,2008,2010,Tennessee,SEC,107,2697,473,1013,368,687,105,326,240,348,235,512,747,123,100,131,170,308,1291
1394,Keith Hornsby,2012,2016,Total,Total,117,3217,446,1015,270,564,176,451,223,269,79,305,384,213,123,31,158,176,1291
1395,Andre Jones,2009,2012,Winthrop,Big South,123,3423,465,1168,330,751,135,417,226,302,81,282,363,212,121,33,209,214,1291
1396,Tajuan Porter,2008,2010,Oregon,Pac-10,91,2881,423,1108,188,464,235,644,210,245,50,172,222,188,74,6,223,194,1291
1397,Andrew White III,2013,2017,Total,Total,111,2514,427,944,210,394,217,550,220,280,79,329,408,63,103,28,127,191,1291
1398,Kadeem Batts,2011,2014,Providence,Big East,122,3257,455,1019,442,979,13,40,366,521,349,432,781,103,58,78,198,410,1289
1399,Carrington Love,2013,2016,Green Bay,Horizon,134,3575,421,1052,261,550,160,502,287,444,65,271,336,356,205,27,205,250,1289
1400,John Papale,2013,2016,Boston University,Total,129,4315,447,1058,160,346,287,712,108,138,56,253,309,249,84,20,106,189,1289
1401,Scoochie Smith,2014,2017,Dayton,A-10,138,3851,422,983,263,551,159,432,286,400,45,325,370,498,172,17,247,270,1289
1402,Brandon Taylor,2013,2016,Penn State,Big Ten,129,3366,463,1169,280,611,183,558,180,239,147,499,646,106,50,91,199,341,1289
1403,Coron Williams,2010,2014,Total,Total,140,3360,442,1021,161,348,281,673,123,158,72,233,305,165,113,10,92,263,1288
1404,Jerrelle Benimon,2010,2014,Total,Total,128,3101,443,848,407,738,36,110,365,532,229,636,865,233,61,129,294,292,1287
1405,Siyani Chambers,2013,2017,Harvard,Ivy,119,4140,393,1016,234,584,159,432,342,430,49,243,292,601,163,2,300,177,1287
1406,Davante Gardner,2011,2014,Marquette,Big East,127,2410,427,767,424,744,3,23,430,544,246,318,564,103,58,45,144,251,1287
1407,Jeremy Granger,2009,2012,Eastern Illinois,OVC,118,3344,451,1021,385,843,66,178,319,367,75,263,338,313,110,10,202,207,1287
1408,Marcus Ottey,2017,2019,Illinois-Chicago,Horizon,98,2760,477,973,410,774,67,199,266,346,58,261,319,195,89,23,221,232,1287
1409,Tony White,2008,2010,College of Charleston,Southern,103,3134,396,934,177,374,219,560,276,334,19,198,217,293,73,6,225,166,1287
1410,Michael Buchanan,2014,2017,South Carolina Upstate,A-Sun,127,2381,527,909,526,908,1,1,231,423,321,457,778,109,57,98,199,297,1286
1411,Michael Glover,2011,2012,Iona,MAAC,70,2378,499,801,499,798,0,3,288,454,244,427,671,66,61,72,173,199,1286
1412,Thomas Coleman,2008,2011,North Carolina A&T,MEAC,126,3351,489,810,489,806,0,4,307,533,342,617,959,149,99,296,249,313,1285
1413,R.J. Evans,2009,2013,Total,Total,123,3213,517,1140,490,996,27,144,224,428,208,316,524,233,155,30,270,283,1285
1414,Arnaud William Adala Moto,2013,2017,Total,Total,130,2957,413,964,379,827,34,137,424,609,242,541,783,129,88,20,246,348,1284
1415,Cameron Clark,2011,2014,Oklahoma,Big 12,128,3385,497,1079,429,908,68,171,222,297,150,425,575,122,104,43,160,242,1284
1416,Kyle Guy,2017,2019,Virginia,ACC,104,2997,453,1049,205,467,248,582,130,163,45,266,311,169,73,4,113,113,1284
1417,Chimezie Metu,2016,2018,Southern California,Pac-12,104,2809,495,928,482,885,13,43,281,406,191,465,656,121,74,168,180,261,1284
1418,Shawn Lewis,2008,2011,Cal Poly,Big West,116,3012,421,1081,278,651,143,430,298,412,117,399,516,188,112,36,243,253,1283
1419,Marshawn Powell,2010,2013,Arkansas,SEC,94,2482,497,1011,455,866,42,145,247,383,186,342,528,120,93,96,173,260,1283
1420,Nick Dixon,2016,2018,Texas-Rio Grande Valley,WAC,67,1899,400,840,318,598,82,242,400,514,102,213,315,188,109,8,178,141,1282
1421,Frank Hassell,2008,2011,Old Dominion,CAA,138,3183,516,981,516,979,0,2,250,375,372,537,909,127,101,151,194,280,1282
1422,Sam Hauser,2017,2019,Marquette,Big East,101,3123,444,931,198,378,246,553,148,169,99,504,603,224,82,53,110,223,1282
1423,Antino Jackson,2015,2018,Total,Total,138,3171,429,1108,205,469,224,639,200,263,54,253,307,407,140,4,267,285,1282
1424,Jared Sullinger,2011,2012,Ohio State,Big Ten,74,2295,450,849,431,797,19,52,363,495,247,470,717,89,80,59,130,199,1282
1425,Ehab Amin,2015,2019,Total,Total,139,2967,458,1034,347,661,111,373,254,362,147,415,562,225,273,28,229,311,1281
1426,Dion Dixon,2009,2012,Cincinnati,Big East,137,3426,421,1108,276,610,145,498,294,409,175,220,395,221,128,25,177,181,1281
1427,Anthony Marshall,2010,2013,Nevada-Las Vegas,MWC,136,3803,444,973,373,710,71,263,321,472,127,425,552,514,182,61,311,303,1280
1428,David Schneider,2008,2010,William & Mary,CAA,95,3199,372,1084,136,363,236,721,300,361,100,347,447,299,142,5,148,229,1280
1429,Mike Davis,2008,2011,Illinois,Big Ten,138,3683,555,1100,555,1099,0,1,169,259,216,693,909,167,77,85,163,250,1279
1430,Ja'Dante' Frye,2014,2017,Nicholls State,Southland,123,3148,453,952,385,752,68,200,305,402,155,365,520,125,91,37,197,204,1279
1431,Kevin McClain,2016,2019,Belmont,OVC,128,2863,437,986,273,504,164,482,241,343,57,266,323,256,96,23,201,204,1279
1432,Cameron Payne,2014,2015,Murray State,OVC,69,2238,435,1007,279,573,156,434,253,324,31,221,252,394,125,37,197,168,1279
1433,John Simons,2013,2016,Central Michigan,MAC,127,3928,398,893,142,240,256,653,227,294,194,582,776,111,101,37,111,266,1279
1434,Blake Griffin,2008,2009,Oklahoma,Big 12,68,2102,484,783,481,773,3,10,307,521,243,562,805,141,72,69,192,171,1278
1435,Marvin Jordan,2011,2014,Niagara,MAAC,127,3889,420,1152,146,338,274,814,164,234,57,242,299,253,153,4,184,319,1278
1436,T.J. Wallace,2014,2017,Pacific,WCC,118,3255,425,1089,294,702,131,387,297,409,101,384,485,265,106,18,244,332,1278
1437,Jimmy Butler,2009,2011,Marquette,Big East,106,3134,390,768,354,674,36,94,461,596,247,332,579,180,115,50,110,183,1277
1438,Joe Rahon,2013,2017,Total,Total,134,4773,454,1086,279,595,175,491,194,285,60,440,500,607,138,34,248,248,1277
1439,Justin Stommes,2008,2011,Eastern Kentucky,OVC,119,3521,430,908,220,404,210,504,207,272,40,332,372,300,117,29,207,179,1277
1440,Casey Cantey,2009,2012,Alabama A&M,SWAC,110,2837,415,1047,344,782,71,265,375,566,134,308,442,131,151,64,295,248,1276
1441,Julien Lewis,2012,2016,Total,Total,131,3437,476,1202,339,779,137,423,187,248,96,338,434,155,156,19,192,345,1276
1442,Cedrick Lindsay,2011,2014,Richmond,A-10,121,3272,403,937,305,641,98,296,372,489,67,202,269,355,129,10,209,222,1276
1443,Terrell Vinson,2010,2013,Massachusetts,A-10,132,3256,453,1005,362,702,91,303,279,417,242,378,620,132,91,62,208,412,1276
1444,Toney Douglas,2008,2009,Florida State,ACC,69,2484,417,950,270,555,147,395,294,363,53,192,245,200,153,26,182,166,1275
1445,Trant Simpson,2008,2011,Total,SWAC,86,2780,396,1115,261,734,135,381,348,423,65,185,250,296,138,2,285,147,1275
1446,Ryan Sypkens,2010,2014,UC-Davis,Big West,126,3240,435,1038,120,288,315,750,90,117,57,223,280,203,69,29,202,298,1275
1447,Kyle Washington,2014,2018,Total,Total,142,3049,520,1066,478,953,42,113,193,278,207,511,718,76,35,150,166,304,1275
1448,Zane Waterman,2015,2018,Manhattan,MAAC,122,2730,431,916,310,572,121,344,292,406,204,451,655,76,72,44,212,349,1275
1449,Zach Auguste,2013,2016,Notre Dame,Total,128,2726,507,894,507,893,0,1,260,424,285,537,822,80,69,87,194,279,1274
1450,Darien Brothers,2010,2013,Richmond,A-10,132,2926,399,958,194,447,205,511,271,321,47,210,257,146,82,14,129,218,1274
1451,Aaron Cosby,2012,2016,Total,Total,118,3535,395,1077,150,413,245,664,239,307,53,286,339,239,55,8,221,165,1274
1452,Wes Eikmeier,2009,2013,Total,Total,122,3164,425,1098,257,633,168,465,256,291,18,164,182,220,68,4,197,231,1274
1453,Zach Graham,2008,2011,Mississippi,SEC,135,3168,423,1001,287,633,136,368,292,375,127,327,454,178,89,35,198,213,1274
1454,Tevon Saddler,2014,2018,Total,Total,92,2690,434,1001,402,865,32,136,374,535,119,339,458,297,134,38,326,294,1274
1455,Jerron Granberry,2010,2014,Total,Total,134,3766,365,978,132,324,233,654,310,378,73,319,392,167,103,32,204,270,1273
1456,Troy Harper,2015,2019,Total,Total,109,2718,369,969,275,631,94,338,441,582,34,237,271,164,72,11,219,259,1273
1457,Sebastian Saiz,2014,2017,Mississippi,SEC,129,3389,464,936,441,853,23,83,322,464,344,664,1008,77,104,127,175,375,1273
1458,Jackson Stevenett,2010,2013,Southern Utah,Total,104,2959,463,954,428,846,35,108,312,395,179,323,502,144,56,64,165,265,1273
1459,Keita Bates-Diop,2015,2018,Ohio State,Big Ten,109,2702,469,993,346,644,123,349,211,272,124,497,621,121,68,128,134,155,1272
1460,Justin Graham,2008,2011,San Jose State,WAC,119,4100,460,1024,403,861,57,163,295,441,103,373,476,508,209,41,397,288,1272
1461,Angelo Caloiaro,2009,2012,San Francisco,WCC,128,3781,402,894,215,395,187,499,280,364,168,510,678,234,121,26,179,293,1271
1462,Andrew Chrabascz,2014,2017,Butler,Big East,128,3568,441,934,364,722,77,212,312,429,201,292,493,254,99,47,149,316,1271
1463,Jared Cunningham,2010,2012,Oregon State,Total,98,2733,380,835,296,591,84,244,427,566,93,201,294,193,219,24,251,247,1271
1464,Sam Dower,2011,2014,Gonzaga,WCC,137,2552,490,872,470,811,20,61,271,340,174,402,576,79,62,75,152,253,1271
1465,Scottie Lindsey,2015,2018,Northwestern,Big Ten,126,3053,454,1097,256,541,198,556,164,203,66,321,387,187,70,45,143,282,1270
1466,Marquise Moore,2014,2017,George Mason,A-10,117,3554,440,987,423,918,17,69,373,518,110,584,694,363,91,77,259,250,1270
1467,Raymar Morgan,2008,2010,Michigan State,Big Ten,107,2763,473,877,453,806,20,71,304,455,218,409,627,162,94,51,214,296,1270
1468,Laurent Rivard,2011,2014,Harvard,Ivy,123,3694,377,872,90,172,287,700,229,276,86,284,370,95,97,12,106,221,1270
1469,Robert Sacre,2008,2012,Gonzaga,WCC,136,2946,409,812,408,808,1,4,451,614,241,438,679,91,70,186,220,306,1270
1470,Brandon Taylor,2013,2016,Utah,Pac-12,133,3877,419,992,175,372,244,620,188,233,28,261,289,428,164,4,259,194,1270
1471,Josh Ajayi,2017,2019,South Alabama,Sun Belt,95,2709,454,881,402,741,52,140,309,439,172,448,620,108,62,52,215,213,1269
1472,Jordan Callahan,2010,2013,Tulane,CUSA,120,3493,437,1094,220,512,217,582,178,247,59,232,291,304,136,9,213,259,1269
1473,Greg Logins,2008,2011,Canisius,MAAC,123,2858,477,1053,341,697,136,356,179,235,221,537,758,69,52,21,209,341,1269
1474,Demond Watt,2008,2011,Texas A&M-Corpus Christi,Southland,120,3221,457,802,453,782,4,20,351,529,352,499,851,135,101,137,226,252,1269
1475,Landry Fields,2008,2010,Stanford,Pac-10,99,2621,454,954,371,719,83,235,277,409,177,396,573,188,104,50,173,173,1268
1476,Paris Lee,2014,2017,Illinois State,MVC,135,4000,417,1042,237,545,180,497,254,335,45,317,362,495,248,10,275,245,1268
1477,Royce O'Neale,2012,2015,Total,Total,134,4057,411,862,266,499,145,363,301,401,207,549,756,400,160,45,258,324,1268
1478,Mike Talley,2011,2015,Total,Total,135,3471,378,975,260,600,118,375,394,577,51,179,230,414,132,2,239,268,1268
1479,Jeremy Green,2009,2011,Stanford,Pac-10,97,2622,428,1031,200,479,228,552,183,227,67,231,298,78,63,9,129,199,1267
1480,David Hanson,2009,2012,Cal Poly,Big West,122,3324,467,1127,313,647,154,480,179,276,217,411,628,166,95,26,138,227,1267
1481,Brian Williams,2011,2014,Jacksonville State,OVC,120,3645,466,1182,318,721,148,461,187,305,48,244,292,368,137,27,209,166,1267
1482,Bryce Dejean-Jones,2011,2015,Total,Total,117,2888,441,1028,321,671,120,357,264,386,116,355,471,272,110,29,212,250,1266
1483,Jon Axel Gudmundsson,2017,2019,Davidson,A-10,98,3419,402,895,242,457,160,438,302,378,65,507,572,438,124,6,209,187,1266
1484,David Kravish,2012,2015,University of California,Pac-12,135,3943,554,1065,548,1043,6,22,152,213,276,641,917,127,70,219,158,356,1266
1485,Blake Hoffarber,2008,2011,Minnesota,Big Ten,132,3451,420,955,141,274,279,681,146,182,101,320,421,266,92,6,162,127,1265
1486,Scoop Jardine,2008,2012,Syracuse,Big East,140,3480,465,1022,344,690,121,332,214,312,53,229,282,619,184,14,311,215,1265
1487,Zeke Marshall,2010,2013,Akron,MAC,138,3213,470,857,468,849,2,8,323,518,265,458,723,97,59,368,196,377,1265
1488,Chace Stanback,2008,2012,Total,Total,126,2956,468,1030,300,593,168,437,161,200,160,402,562,147,131,64,159,237,1265
1489,Robert Olson,2010,2013,Loyola (MD),MAAC,127,3495,429,1040,218,477,211,563,195,252,118,313,431,233,119,20,176,314,1264
1490,Stephan Jiggetts,2015,2018,Total,Total,114,3477,392,1069,246,655,146,414,333,428,53,222,275,350,85,7,292,293,1263
1491,Will Walker,2008,2010,DePaul,Big East,93,2914,462,1154,279,636,183,518,156,228,80,162,242,160,134,10,119,151,1263
1492,Dion Wright ,2013,2016,St. Bonaventure,A-10,108,3042,509,1020,478,919,31,101,214,280,270,413,683,102,81,55,120,264,1263
1493,Jahii Carson,2013,2014,Arizona State,Pac-12,68,2471,442,975,373,780,69,195,308,424,40,221,261,330,64,4,240,161,1261
1494,Louis Montes,2011,2014,Sacred Heart,NEC,120,2952,435,967,348,703,87,264,304,424,196,422,618,104,74,56,201,354,1261
1495,Clint Sargent,2009,2011,South Dakota State,Summit,90,2737,401,972,182,416,219,556,240,304,65,208,273,131,46,8,108,196,1261
1496,Scott Thomas,2009,2012,Bowling Green State,MAC,125,3634,450,1064,299,595,151,469,210,320,168,512,680,317,199,43,239,272,1261
1497,Eric Garcia,2014,2017,Wofford,Southern,128,3777,360,829,152,343,208,486,332,409,34,258,292,537,81,2,177,217,1260
1498,DeWayne Reed,2008,2010,Auburn,SEC,98,3173,407,1072,250,578,157,494,289,445,43,206,249,384,169,28,289,212,1260
1499,Barry Stewart,2008,2010,Mississippi State,SEC,106,3583,393,1049,181,444,212,605,262,356,102,319,421,250,130,22,188,237,1260
1500,O.D. Anosike,2010,2013,Siena,MAAC,128,3621,493,970,492,968,1,2,272,530,404,672,1076,102,100,92,231,313,1259
1501,Elgin Cook,2014,2016,Oregon,Pac-12,108,2838,437,864,409,768,28,96,357,487,167,342,509,162,113,35,189,311,1259
1502,Avry Holmes,2013,2017,Total,Total,126,3444,377,912,160,383,217,529,288,368,47,241,288,251,115,3,161,196,1259
1503,Jimond Ivey,2016,2019,Akron,MAC,133,3461,438,977,299,520,139,457,244,325,150,494,644,316,126,37,207,269,1259
1504,Jamar Samuels,2009,2012,Kansas State,Big 12,133,3136,411,860,364,708,47,152,390,641,296,420,716,169,109,93,206,414,1259
1505,Drew Spradlin,2009,2012,Elon,Southern,122,2951,433,1060,253,577,180,483,213,338,126,310,436,164,75,17,196,233,1259
1506,Aaron Urbanus,2010,2013,Texas-Rio Grande Valley,GWC,127,3482,409,1039,171,413,238,626,203,272,31,264,295,306,104,6,261,237,1259
1507,Adam Weary,2013,2016,High Point,Big South,116,2987,449,940,378,728,71,212,289,386,80,249,329,297,115,27,221,295,1258
1508,Jesse Berry,2011,2014,Ball State,MAC,119,3089,377,999,153,338,224,661,279,379,30,165,195,181,51,9,233,169,1257
1509,Antonio Campbell,2014,2017,Ohio,MAC,114,2396,498,929,403,657,95,272,166,251,184,616,800,64,53,119,129,321,1257
1510,Ty Cockfield,2016,2019,Total,Total,73,2226,431,987,302,622,129,365,266,329,56,166,222,176,71,10,176,132,1257
1511,Erik Etherly,2009,2013,Total,Total,105,2969,455,936,450,913,5,23,342,508,232,447,679,140,124,112,202,212,1257
1512,Que Johnson,2014,2017,Total,Total,125,3122,423,1065,237,551,186,514,225,297,68,304,372,142,67,22,163,251,1257
1513,Anthony Livingston,2015,2017,Total,Total,92,2755,445,1007,341,701,104,306,263,343,178,520,698,74,39,58,163,214,1257
1514,Desonta Bradford,2015,2018,East Tennessee State,Southern,132,3189,424,894,325,608,99,286,309,404,82,394,476,349,146,62,219,250,1256
1515,Lasan Kromah,2010,2014,Total,Total,132,3303,481,1092,370,745,111,347,183,293,153,327,480,240,194,53,254,252,1256
1516,Ike Nwamu,2012,2016,Total,Total,130,2815,404,951,228,479,176,472,272,377,73,267,340,150,80,34,198,220,1256
1517,Flenard Whitfield,2009,2012,Western Michigan,MAC,125,3086,505,1023,502,989,3,34,243,390,279,402,681,78,59,58,258,361,1256
1518,Amir Coffey,2017,2019,Minnesota,Big Ten,87,2933,416,929,322,642,94,287,329,448,65,266,331,277,81,18,182,147,1255
1519,Ricardo Glenn,2011,2014,South Carolina Upstate,A-Sun,127,3046,476,858,473,845,3,13,300,484,424,504,928,204,83,32,213,309,1255
1520,Julian Simmons,2009,2012,Army,Patriot,117,2568,419,1140,190,526,229,614,188,242,42,201,243,58,85,4,151,208,1255
1521,Dyricus Simms-Edwards,2010,2013,Bradley,MVC,123,3680,429,1084,306,685,123,399,274,378,89,323,412,337,180,24,254,208,1255
1522,Brandon Britt,2011,2014,William & Mary,CAA,113,2932,407,947,279,576,128,371,312,444,40,198,238,199,87,4,203,189,1254
1523,Reggie Jackson,2009,2011,Boston College,ACC,99,2775,455,979,334,634,121,345,223,296,135,298,433,350,83,46,203,172,1254
1524,Reggie Johnson,2013,2016,Total,Total,98,2917,418,1124,292,697,126,427,292,434,110,180,290,225,139,15,211,272,1254
1525,Victor Rudd,2010,2014,Total,Total,113,3197,435,1103,312,663,123,440,261,355,102,514,616,140,67,43,187,204,1254
1526,Isaiah Taylor,2014,2016,Texas,Big 12,92,2831,412,1019,377,900,35,119,395,499,33,250,283,415,89,12,207,228,1254
1527,Desmond Bane,2017,2019,Texas Christian,Big 12,109,3127,462,895,305,528,157,367,172,213,91,367,458,209,85,37,146,236,1253
1528,Cole Dickerson,2011,2014,San Francisco,WCC,125,2852,487,966,372,662,115,304,164,310,212,536,748,131,76,54,191,273,1253
1529,Jeremy Sexton,2010,2013,Charleston Southern,Big South,118,3507,441,1091,234,519,207,572,164,213,58,186,244,248,121,13,240,190,1253
1530,Brad Tinsley,2009,2012,Vanderbilt,SEC,134,3919,410,944,221,443,189,501,244,291,26,354,380,482,85,22,258,172,1253
1531,Mark Tollefsen,2013,2016,Total,Total,130,3309,474,885,340,529,134,356,171,240,168,330,498,166,65,95,102,235,1253
1532,Trent Wiedeman,2011,2015,Total,Total,124,3349,486,935,477,895,9,40,272,388,251,573,824,117,82,109,203,280,1253
1533,Stephon Carter,2011,2013,Cal State Bakersfield,Ind,89,2734,453,1043,428,927,25,116,321,482,120,267,387,244,188,28,247,246,1252
1534,Brandon Provost,2009,2013,Total,Total,110,3096,371,856,138,335,233,521,277,345,33,308,341,190,84,30,191,153,1252
1535,Josh Richardson,2012,2015,Tennessee,SEC,136,3842,458,1005,360,697,98,308,238,314,116,323,439,246,147,88,209,301,1252
1536,Thomas van der Mars,2012,2015,Portland,WCC,127,3218,497,893,497,892,0,1,258,392,304,527,831,98,64,120,176,329,1252
1537,Kwadzo Ahelegbe,2009,2011,Northern Iowa,MVC,103,3144,392,966,304,705,88,261,379,493,43,267,310,305,60,12,258,225,1251
1538,Jacob Parker,2012,2015,Stephen F. Austin,Southland,130,3090,439,898,333,637,106,261,267,335,200,427,627,201,116,44,160,290,1251
1539,Eric Washington,2012,2016,Total,Total,115,3498,389,892,296,610,93,282,380,469,78,283,361,560,147,5,340,218,1251
1540,Preston Blackmon,2010,2013,Savannah State,Total,123,3690,468,1221,309,712,159,509,155,198,46,206,252,541,138,19,387,212,1250
1541,Dikembe Dixson,2016,2018,Illinois-Chicago,Horizon,72,2345,404,1035,317,759,87,276,355,504,74,317,391,91,90,23,249,153,1250
1542,LaVone Holland,2016,2018,Northern Kentucky,Horizon,95,2860,428,1022,283,619,145,403,249,357,48,314,362,396,108,17,273,196,1250
1543,Nazareth Mitrou-Long,2013,2017,Iowa State,Big 12,131,3206,430,954,170,269,260,685,130,173,48,306,354,235,87,9,154,240,1250
1544,Christian Standhardinger,2010,2014,Total,Total,85,2304,417,866,383,753,34,113,382,527,221,385,606,106,98,41,170,200,1250
1545,Tavon Allen,2013,2016,Drexel,CAA,117,3146,434,1206,274,716,160,490,221,291,48,262,310,220,79,46,188,265,1249
1546,Wayne Ellington,2008,2009,North Carolina,ACC,77,2369,452,952,289,553,163,399,182,227,98,262,360,179,80,13,128,119,1249
1547,Javan Felix,2013,2016,Texas,Big 12,132,3427,448,1159,278,674,170,485,183,232,53,219,272,366,102,4,217,230,1249
1548,Wesley Iwundu,2014,2017,Kansas State,Big 12,132,3728,425,917,374,766,51,151,348,506,152,466,618,366,121,52,280,277,1249
1549,Laurence Bowers,2009,2013,Missouri,Total,128,2608,513,944,482,852,31,92,191,273,257,386,643,132,105,157,130,293,1248
1550,Jack Eggleston,2008,2011,Pennsylvania,Ivy,115,3737,456,972,375,754,81,218,255,328,171,528,699,219,103,74,191,272,1248
1551,Darius Miller,2009,2012,Kentucky,SEC,152,3789,444,990,269,528,175,462,185,227,150,339,489,278,114,100,214,351,1248
1552,Thomas Welsh,2015,2018,UCLA,Pac-12,132,3295,532,990,486,877,46,113,138,173,311,724,1035,103,55,143,90,331,1248
1553,Juan Fernandez,2009,2012,Temple,A-10,119,3514,425,1083,218,568,207,515,190,239,38,263,301,423,96,11,237,303,1247
1554,James Harvey,2016,2019,McNeese State,Southland,118,3270,399,1074,136,306,263,768,186,231,42,179,221,120,67,12,155,160,1247
1555,Abdul Lewis,2015,2019,Total,Total,121,3530,457,991,427,887,30,104,303,478,303,697,1000,180,48,84,316,351,1247
1556,Colter Lasher,2014,2017,Houston Baptist,Southland,117,2796,471,1042,332,652,139,390,165,228,121,336,457,214,90,40,193,233,1246
1557,J.R. Lynch,2017,2019,Hartford,AEC,98,3465,416,959,253,541,163,418,251,301,43,302,345,340,152,6,189,240,1246
1558,Ahmad Starks,2011,2015,Total,Total,130,3478,445,1186,212,534,233,652,123,144,27,198,225,289,131,5,167,221,1246
1559,Markel Starks,2011,2014,Georgetown,Big East,126,3361,438,1026,273,567,165,459,205,252,38,163,201,300,100,9,201,241,1246
1560,Perris Blackwell,2010,2014,Total,Total,122,3046,477,872,477,870,0,2,291,511,347,403,750,99,61,54,210,357,1245
1561,Will Cummings,2012,2015,Temple,Total,120,3144,392,942,317,672,75,270,386,499,81,255,336,357,159,21,193,275,1245
1562,Jarred Dixon,2016,2019,Missouri State,MVC,128,3430,458,1083,354,770,104,313,225,294,86,239,325,229,126,25,154,263,1245
1563,Donovan Fields,2017,2019,Cal Poly,Big West,91,2796,457,1109,348,797,109,312,222,254,37,203,240,303,112,17,195,222,1245
1564,Rick Jackson,2008,2011,Syracuse,Big East,143,3456,532,900,532,899,0,1,181,353,334,596,930,192,132,259,232,260,1245
1565,Sean Johnson,2010,2013,Duquesne,A-10,123,2659,405,975,300,653,105,322,330,449,94,207,301,181,81,29,204,254,1245
1566,Dwight Lewis,2008,2010,Southern California,Pac-10,96,3336,442,1066,313,684,129,382,232,317,55,220,275,159,96,13,212,178,1245
1567,Jared Mintz,2008,2011,Lafayette,Patriot,114,2734,428,821,416,774,12,47,377,466,174,342,516,171,63,35,207,239,1245
1568,LaMarcus Reed,2009,2012,Texas-Arlington,Southland,115,2685,405,920,279,576,126,344,309,400,97,311,408,140,89,31,236,242,1245
1569,Kris Yanku,2014,2016,Northern Arizona,Big Sky,98,2819,336,956,281,787,55,169,518,639,54,356,410,419,141,6,282,248,1245
1570,Brandon Boyd,2016,2019,Idaho State,Big Sky,94,2693,416,976,281,585,135,391,277,339,50,232,282,219,113,4,191,177,1244
1571,Sean O'Brien,2014,2017,Southern Illinois,MVC,131,3754,500,1036,463,886,37,150,207,355,220,585,805,244,109,71,255,336,1244
1572,Devin Price,2010,2013,Marist,MAAC,114,3375,385,1050,211,537,174,513,300,377,58,214,272,274,107,6,232,177,1244
1573,Phil Greene,2012,2015,St. John's (NY),Big East,130,4041,491,1262,353,838,138,424,123,175,79,280,359,281,113,11,154,172,1243
1574,Justin Reynolds,2008,2011,Texas A&M-Corpus Christi,Southland,124,3134,466,981,416,809,50,172,261,435,259,518,777,124,119,97,247,349,1243
1575,Mike Tisdale,2008,2011,Illinois,Big Ten,139,3103,495,926,466,851,29,75,224,281,228,403,631,100,42,176,168,389,1243
1576,Kevin Vannatta,2015,2018,North Carolina-Asheville,Big South,130,4166,412,889,283,523,129,366,290,383,93,481,574,378,136,12,215,231,1243
1577,Nic Wise,2008,2010,Arizona,Pac-10,93,3087,386,904,233,529,153,375,318,376,29,223,252,382,160,8,229,208,1243
1578,Zach Braxton,2016,2019,Weber State,Big Sky,128,3065,456,774,456,773,0,1,330,542,225,553,778,113,45,99,189,350,1242
1579,Kyle Casey,2010,2014,Harvard,Ivy,118,2828,439,881,395,739,44,142,320,426,151,503,654,124,78,127,207,395,1242
1580,A.J. Davis,2009,2013,Total,Total,119,2678,422,933,294,535,128,398,270,375,77,325,402,120,149,27,219,210,1242
1581,Cole Huff,2013,2017,Total,Total,132,3132,416,944,225,457,191,487,219,270,129,458,587,82,68,45,120,281,1242
1582,Dennis Mavin,2011,2015,Total,Total,124,3002,412,1008,350,798,62,210,356,578,97,325,422,201,120,4,266,190,1242
1583,Lee Skinner,2012,2015,Wofford,Southern,133,4074,455,985,439,904,16,81,316,481,325,589,914,269,128,29,227,288,1242
1584,Kamau Stokes,2016,2019,Kansas State,Big 12,119,3602,385,1049,178,454,207,595,265,352,52,266,318,415,135,6,258,221,1242
1585,Matisse Thybulle,2016,2019,Washington,Pac-12,135,3963,441,1027,250,493,191,534,169,216,119,296,415,276,330,182,252,381,1242
1586,Aaron Bright,2011,2015,Total,Total,135,3626,386,1027,188,471,198,556,271,326,29,169,198,428,68,0,247,266,1241
1587,Robert Hatter,2014,2017,Cornell,Ivy,100,2577,432,1068,289,596,143,472,234,327,48,241,289,200,90,16,223,233,1241
1588,Kevin Puryear,2016,2019,Missouri,SEC,128,3295,426,987,361,774,65,213,324,409,197,433,630,108,46,24,197,270,1241
1589,Clarke Rosenberg,2012,2015,Chicago State,Total,126,3252,428,1041,341,749,87,292,298,411,136,281,417,237,139,27,258,301,1241
1590,Isaac Sosa,2009,2013,Total,Total,130,3082,427,996,142,314,285,682,102,137,46,194,240,126,58,10,144,145,1241
1591,Spencer Weisz,2014,2017,Princeton,Ivy,119,3723,422,979,213,424,209,555,188,255,94,511,605,383,128,33,194,247,1241
1592,Brenton Butler,2008,2011,Fordham,A-10,91,3025,387,1129,204,550,183,579,283,361,63,204,267,237,65,3,203,192,1240
1593,Shaquille Johnson,2009,2012,Marshall,CUSA,134,3562,407,933,303,587,104,346,322,450,107,317,424,300,125,23,226,343,1240
1594,Bryce Scott,2013,2016,Lafayette,Patriot,124,3606,419,944,206,421,213,523,189,231,70,272,342,270,95,15,139,202,1240
1595,Tracy Smith,2008,2011,North Carolina State,ACC,106,2422,471,905,471,905,0,0,298,463,217,326,543,79,69,59,140,201,1240
1596,A.D. Vassallo,2008,2009,Virginia Tech,ACC,69,2448,438,981,270,540,168,441,196,246,74,297,371,165,52,45,172,152,1240
1597,Cameron Bairstow,2011,2014,New Mexico,MWC,134,2787,418,808,416,802,2,6,401,559,234,403,637,102,62,99,157,282,1239
1598,Junior Etou,2014,2018,Total,Total,121,3418,403,898,283,558,120,340,313,436,214,576,790,125,49,35,221,263,1239
1599,Jordair Jett,2011,2014,Saint Louis,A-10,134,3497,453,953,426,844,27,109,306,500,95,333,428,422,174,43,295,239,1239
1600,Tirrell Baines,2008,2011,Marshall,CUSA,124,2999,468,888,467,881,1,7,301,432,307,351,658,81,64,42,173,255,1238
1601,Pierria Henry,2012,2015,Charlotte,Total,123,3947,413,997,336,724,77,273,335,481,159,442,601,566,296,75,339,341,1238
1602,Ronnie Johnson,2013,2017,Total,Total,129,3177,441,1082,368,854,73,228,283,417,91,256,347,420,93,6,248,238,1238
1603,Ryan Nicholas,2011,2014,Portland,WCC,119,3000,450,968,382,788,68,180,270,364,236,596,832,113,59,26,181,300,1238
1604,Mike Cunningham,2016,2019,Total,Total,103,3134,415,1065,188,462,227,603,180,231,43,219,262,289,100,4,158,153,1237
1605,Shawn Johnson,2015,2018,Incarnate Word,Southland,115,3322,394,901,197,396,197,505,252,360,120,590,710,148,137,150,150,271,1237
1606,Austin Arians,2013,2017,Total,Total,130,3529,422,984,175,313,247,671,145,179,91,304,395,153,85,16,109,236,1236
1607,Michael Harper,2009,2012,Coppin State,MEAC,106,3008,444,998,239,489,205,509,143,180,60,288,348,129,120,31,174,187,1236
1608,Jeremy Major,2014,2017,Pepperdine,WCC,126,3809,429,1074,270,643,159,431,219,373,80,318,398,494,153,32,248,281,1236
1609,Xavier Rathan-Mayes,2015,2017,Florida State,ACC,100,3047,430,1014,303,582,127,432,249,374,50,266,316,451,101,4,256,213,1236
1610,Deon Thompson,2008,2010,North Carolina,ACC,114,2773,502,1033,502,1031,0,2,232,353,250,400,650,98,102,127,166,256,1236
1611,James Blackmon,2015,2017,Indiana,Big Ten,76,2223,424,938,219,444,205,494,182,221,99,275,374,128,58,8,136,124,1235
1612,Donte Ingram,2015,2018,Loyola (IL),MVC,136,3611,448,981,273,526,175,455,164,231,118,570,688,147,83,33,152,228,1235
1613,Pierre Jackson,2012,2013,Baylor,Big 12,74,2424,390,884,233,470,157,414,298,369,57,188,245,478,122,3,256,168,1235
1614,Rodney Pierce,2008,2010,Buffalo,MAC,92,2623,439,1123,302,731,137,392,220,295,54,240,294,238,94,9,209,191,1235
1615,Jesse Sanders,2009,2012,Liberty,Big South,127,4143,390,844,339,672,51,172,404,540,292,523,815,727,155,18,342,299,1235
1616,Connor Frizzelle,2009,2012,Rice,CUSA,129,3537,412,1086,249,615,163,471,247,292,36,228,264,226,114,0,210,216,1234
1617,Jordan Gregory,2012,2015,Montana,Big Sky,111,3102,380,903,188,400,192,503,282,340,50,254,304,210,61,4,142,147,1234
1618,Chris Long,2008,2011,Elon,Southern,127,3694,372,983,200,482,172,501,318,409,91,214,305,528,155,4,237,231,1234
1619,Mickey McConnell,2008,2011,Saint Mary's (CA),WCC,124,3364,395,808,208,404,187,404,257,311,39,184,223,476,114,19,220,193,1234
1620,Dylan Ennis,2012,2017,Total,Total,143,3681,412,991,247,516,165,475,244,353,93,417,510,440,123,62,247,251,1233
1621,Jacob Evans,2016,2018,Cincinnati,AAC,105,3051,423,985,249,523,174,462,213,282,139,316,455,263,120,92,133,209,1233
1622,Ayron Hardy,2008,2011,Jacksonville,A-Sun,127,3781,487,906,428,723,59,183,200,273,284,423,707,254,218,118,195,351,1233
1623,Corey Henson,2015,2019,Total,Total,124,3210,426,1030,230,485,196,545,185,227,57,215,272,246,99,6,195,248,1233
1624,Wesley Myers,2014,2018,Total,Total,124,3198,417,1006,299,687,118,319,281,393,96,301,397,184,102,36,210,255,1233
1625,Ethan O'Day,2013,2016,Vermont,AEC,127,3098,523,944,523,943,0,1,187,291,204,404,608,104,89,217,181,343,1233
1626,Jaye Crockett,2011,2014,Texas Tech,Big 12,125,2883,466,933,417,777,49,156,251,338,209,468,677,111,106,65,207,296,1232
1627,Frankie Dobbs,2009,2013,Total,Total,122,3744,355,920,164,371,191,549,331,416,39,299,338,505,106,9,269,209,1232
1628,Thomas Gipson,2012,2015,Kansas State,Big 12,131,2972,450,844,450,844,0,0,332,497,272,428,700,70,49,56,214,322,1232
1629,Jorge Gutierrez,2009,2012,University of California,Total,129,3425,412,959,327,709,85,250,323,438,96,398,494,423,147,15,274,315,1232
1630,Brandon Hazzard,2008,2010,Troy,Sun Belt,92,2400,423,977,219,478,204,499,182,241,29,152,181,119,75,0,133,134,1232
1631,Ike Iroegbu,2014,2017,Washington State,Pac-12,124,3409,418,965,302,636,116,329,280,387,64,316,380,375,82,14,252,230,1232
1632,James Michael McAdoo,2012,2014,North Carolina,ACC,108,2696,467,1044,467,1035,0,9,298,524,232,408,640,111,132,58,173,229,1232
1633,Quincy McKnight,2016,2019,Total,Total,93,2875,439,1007,384,816,55,191,299,433,69,322,391,297,149,24,309,281,1232
1634,Adreian Payne,2011,2014,Michigan State,Big Ten,138,2759,447,850,386,701,61,149,277,367,211,524,735,85,76,141,187,297,1232
1635,Brock Young,2008,2011,East Carolina,CUSA,121,3290,354,955,260,649,94,306,430,532,46,300,346,612,154,2,375,220,1232
1636,Chris Allen,2008,2012,Total,Total,140,3079,411,1065,194,459,217,606,192,243,89,215,304,220,64,10,203,238,1231
1637,Trey Burke,2012,2013,Michigan,Big Ten,73,2605,436,969,303,607,133,362,226,291,43,199,242,416,93,33,180,126,1231
1638,Nick Coppola,2014,2017,Louisiana-Monroe,Sun Belt,132,4768,430,1087,241,564,189,523,182,269,47,339,386,555,88,3,253,248,1231
1639,Paul Jackson,2015,2019,Total,Total,121,3409,438,1093,358,825,80,268,275,395,46,165,211,502,126,6,270,297,1231
1640,Terran Petteway,2012,2015,Total,Total,91,2468,398,979,270,575,128,404,307,410,59,306,365,159,70,56,227,241,1231
1641,Cortez Seales,2016,2019,North Dakota,Total,121,3362,497,1064,465,944,32,120,205,322,112,309,421,247,97,54,151,148,1231
1642,Martino Brock,2010,2014,Total,Total,122,3342,445,1002,381,786,64,216,276,464,203,316,519,208,166,36,227,186,1230
1643,Rui Hachimura,2017,2019,Gonzaga,WCC,102,2012,462,798,438,722,24,76,282,378,111,341,452,82,60,50,120,163,1230
1644,Kevin Palmer,2009,2010,Texas A&M-Corpus Christi,Southland,65,2040,393,883,288,550,105,333,339,433,111,233,344,182,163,27,250,132,1230
1645,Johnathan Motley,2015,2017,Baylor,Big 12,102,2477,479,923,467,873,12,50,259,396,279,373,652,132,44,122,205,303,1229
1646,Andy Ogide,2009,2011,Colorado State,MWC,94,2499,486,883,476,852,10,31,247,363,185,442,627,69,70,49,214,259,1229
1647,Jarvis Varnado,2008,2010,Mississippi State,SEC,106,3121,473,814,472,811,1,3,282,469,285,665,950,78,64,497,172,270,1229
1648,Dave Coley,2011,2014,Stony Brook,AEC,128,3373,418,1136,315,824,103,312,289,382,112,406,518,198,108,9,256,247,1228
1649,Yaw Gyawu,2009,2012,Colgate,Patriot,110,2880,473,962,470,946,3,16,279,430,169,244,413,91,48,2,220,243,1228
1650,Jackson Kent,2014,2017,James Madison,CAA,129,3771,398,990,217,486,181,504,251,317,57,409,466,216,97,10,194,160,1228
1651,Dwayne Lathan,2008,2012,Total,Total,113,2785,403,915,331,674,72,241,350,467,127,394,521,138,88,61,262,249,1228
1652,Christian Vital,2017,2019,Connecticut,AAC,96,2891,380,926,181,377,199,549,269,333,77,391,468,188,137,7,174,235,1228
1653,Trevis Wyche,2014,2017,Saint Peter's,MAAC,130,3871,394,919,305,667,89,252,351,483,55,311,366,501,167,11,237,296,1228
1654,Dimitri Batten,2012,2015,Total,Total,134,3250,425,1048,259,558,166,490,211,324,76,333,409,161,137,43,197,349,1227
1655,Jabari Bird,2014,2017,University of California,Pac-12,114,3013,450,1018,263,514,187,504,140,186,90,284,374,132,58,35,137,197,1227
1656,B.J. Monteiro,2009,2012,Duquesne,A-10,121,2901,475,1028,393,766,82,262,195,367,149,314,463,211,90,80,173,275,1227
1657,Jereal Scott,2009,2012,Stephen F. Austin,Southland,108,2328,462,878,462,878,0,0,303,438,201,345,546,66,47,57,184,260,1227
1658,Montrael Scott,2012,2015,Prairie View,SWAC,125,3142,428,1018,275,571,153,447,218,300,107,318,425,199,138,11,222,215,1227
1659,Derrick Williams,2010,2011,Arizona,Pac-10,69,2016,388,662,342,572,46,90,405,563,173,360,533,65,56,46,160,184,1227
1660,Diante Baldwin,2014,2017,North Carolina-Greensboro,Southern,124,3491,446,1050,361,804,85,246,249,388,114,341,455,437,170,32,257,294,1226
1661,Harrison Barnes,2011,2012,North Carolina,ACC,75,2198,438,1018,322,686,116,332,234,319,149,265,414,96,68,29,146,140,1226
1662,Oscar Bellfield,2009,2012,Nevada-Las Vegas,MWC,134,4050,426,1095,219,525,207,570,167,221,69,246,315,584,133,36,279,238,1226
1663,Brandon Giles,2008,2010,Western Carolina,Southern,92,2415,459,1104,317,724,142,380,166,227,110,251,361,114,75,40,173,288,1226
1664,Samme Givens,2009,2012,Drexel,CAA,128,3418,481,954,481,953,0,1,264,437,416,643,1059,154,85,97,207,384,1226
1665,Calvin Haynes,2008,2011,Oregon State,Pac-10,122,3061,427,1060,295,662,132,398,240,332,54,243,297,199,115,11,236,174,1226
1666,Gilvydas Biruta,2011,2015,Total,Total,129,3039,455,901,436,823,19,78,296,437,306,415,721,139,87,72,223,410,1225
1667,Jason Flagler,2008,2010,South Carolina State,MEAC,95,1980,526,970,511,929,15,41,158,198,189,374,563,104,55,40,146,173,1225
1668,London Perrantes,2014,2017,Virginia,ACC,138,4425,397,981,186,465,211,516,220,271,40,332,372,569,120,16,211,182,1225
1669,Ricky Taylor,2009,2012,Chattanooga,Southern,115,2659,408,998,251,548,157,450,252,334,80,282,362,159,60,6,182,147,1225
1670,Josh Cunningham,2015,2019,Total,Total,106,3052,463,795,434,683,29,112,269,417,232,500,732,125,71,31,197,253,1224
1671,Chris Crawford,2011,2014,Memphis,Total,140,3911,431,1102,189,443,242,659,119,158,54,436,490,468,223,65,258,268,1223
1672,Andre Young,2009,2012,Clemson,ACC,129,3489,406,1004,170,375,236,629,175,227,62,206,268,342,184,4,163,176,1223
1673,Jordan Bohannon,2017,2019,Iowa,Big Ten,102,3140,367,922,103,279,264,643,224,255,24,210,234,471,74,2,202,175,1222
1674,T.J. Carpenter,2013,2016,Nicholls State,Southland,115,3271,403,1094,206,457,197,637,218,317,109,399,508,219,94,16,241,328,1221
1675,Tavrion Dawson,2016,2018,Cal State Northridge,Big West,90,2659,456,968,401,767,55,201,254,345,159,400,559,141,70,50,154,204,1221
1676,Marial Shayok,2015,2019,Total,Total,137,2842,455,968,329,637,126,331,185,235,75,301,376,174,92,33,176,213,1221
1677,Conner Toolson,2017,2019,Utah Valley,WAC,99,2972,429,989,234,437,195,552,168,217,55,302,357,138,135,32,140,220,1221
1678,Michael Tveidt,2009,2011,North Dakota State,Summit,91,2806,474,983,365,709,109,274,164,215,94,284,378,135,81,45,140,245,1221
1679,Rob Brandenberg,2011,2014,Virginia Commonwealth,Total,145,3242,423,1089,244,564,179,525,194,281,118,215,333,191,159,49,148,225,1219
1680,Rob Edwards,2016,2019,Total,Total,91,2778,391,1008,228,570,163,438,274,353,59,297,356,135,106,11,241,194,1219
1681,Matthew Fisher-Davis,2015,2018,Vanderbilt,SEC,117,3044,388,985,119,300,269,685,174,217,57,327,384,138,68,42,129,215,1219
1682,Anthony Hickey,2012,2015,Total,Total,128,4007,456,1165,230,513,226,652,81,161,85,364,449,469,280,21,209,312,1219
1683,Andrew Lawrence,2010,2013,College of Charleston,Southern,134,3606,381,940,174,359,207,581,250,336,37,252,289,393,162,33,232,268,1219
1684,Tyler Smith,2008,2010,Tennessee,SEC,82,2445,424,866,382,730,42,136,329,448,180,314,494,280,92,30,165,188,1219
1685,Ivan Aska,2009,2012,Murray State,OVC,126,3020,477,925,475,920,2,5,262,380,230,448,678,57,75,48,187,281,1218
1686,Chris Eversley,2010,2014,Total,Total,113,2761,444,1037,358,747,86,290,244,348,218,406,624,143,83,20,139,200,1218
1687,Shelton Mitchell,2015,2019,Total,Total,125,3553,393,977,259,598,134,379,298,365,42,271,313,421,80,6,258,162,1218
1688,Jeremy Morgan,2014,2017,Northern Iowa,MVC,131,3669,393,908,220,433,173,475,259,331,118,432,550,235,179,99,165,288,1218
1689,Cody Doolin,2011,2015,Total,Total,136,4345,416,966,284,556,132,410,253,328,55,368,423,579,188,13,240,293,1217
1690,Daniel Fowler,2015,2018,Furman,Southern,133,3784,420,939,268,528,152,411,225,306,165,371,536,369,153,31,249,298,1217
1691,Brian Barbour,2010,2013,Columbia,Ivy,106,3149,356,903,253,584,103,319,401,447,36,187,223,346,124,6,159,178,1216
1692,Chase Hallam,2010,2013,Denver,Total,122,3853,430,916,268,534,162,382,194,272,121,370,491,263,201,56,187,334,1216
1693,Jerel McNeal,2008,2009,Marquette,Big East,70,2282,434,968,313,637,121,331,227,314,84,246,330,261,147,36,201,196,1216
1694,Dominic Artis,2013,2017,Total,Total,118,3321,430,1065,310,689,120,376,235,359,67,417,484,502,163,22,269,236,1215
1695,V.J. Beachem,2014,2017,Notre Dame,ACC,132,3067,435,994,207,412,228,582,117,159,67,284,351,81,75,78,96,148,1215
1696,Alandise Harris,2011,2015,Total,Total,125,2884,429,888,393,783,36,105,321,480,184,377,561,149,86,132,223,298,1215
1697,David Loubeau,2009,2012,Texas A&M,Big 12,133,2959,472,942,470,934,2,8,269,408,255,326,581,52,50,35,175,346,1215
1698,Geovonie McKnight,2013,2016,Miami (OH),MAC,126,3510,452,1101,426,985,26,116,285,400,104,321,425,237,163,24,277,304,1215
1699,Anthony Nelson,2008,2011,Niagara,MAAC,125,4443,339,896,253,577,86,319,451,635,188,383,571,647,230,15,343,303,1215
1700,Devin Patterson,2014,2016,Omaha,Summit,91,2709,379,897,263,569,116,328,341,422,44,197,241,311,175,0,247,207,1215
1701,Peyton Siva,2010,2013,Louisville,Big East,144,3774,412,989,313,649,99,340,292,396,48,302,350,677,254,19,384,379,1215
1702,Dantrell Thomas,2011,2014,Nicholls State,Southland,102,2575,431,902,378,722,53,180,300,401,141,278,419,207,111,37,187,295,1215
1703,Lucas Woodhouse,2013,2017,Total,Total,127,3731,400,924,220,480,180,444,235,278,42,297,339,662,126,9,285,225,1215
1704,Kris Dunn,2013,2016,Providence,Big East,95,2997,424,943,351,737,73,206,293,423,106,380,486,552,208,38,315,280,1214
1705,Richard Howell,2010,2013,North Carolina State,ACC,132,3058,485,936,481,918,4,18,240,379,392,663,1055,147,111,64,194,345,1214
1706,Ben Moore,2014,2017,Southern Methodist,AAC,135,3303,459,852,458,847,1,5,295,445,303,477,780,242,102,125,195,316,1214
1707,Kyle Tresnak,2011,2014,Weber State,Big Sky,131,2894,489,866,489,866,0,0,236,346,194,340,534,64,61,125,149,346,1214
1708,Kellen Brand,2008,2010,Appalachian State,Southern,99,2916,407,873,280,543,127,330,272,354,94,190,284,165,71,2,190,196,1213
1709,Chase Budinger,2008,2009,Arizona,Pac-10,69,2517,423,913,283,553,140,360,227,298,83,318,401,217,88,22,165,131,1213
1710,Chavis Holmes,2008,2009,Virginia Military Institute,Big South,60,1926,398,833,233,417,165,416,252,320,98,170,268,169,175,44,132,155,1213
1711,Greg Mangano,2009,2012,Yale,Ivy,102,2418,451,973,373,743,78,230,233,350,204,530,734,41,32,213,144,246,1213
1712,Ja Morant,2018,2019,Murray State,OVC,65,2295,398,821,314,576,84,245,333,411,95,301,396,532,88,40,249,112,1213
1713,Julius Coles,2008,2011,Canisius,MAAC,117,3206,415,1089,263,641,152,448,230,347,118,303,421,173,94,39,242,194,1212
1714,Jordon Crawford,2010,2013,Bowling Green State,MAC,127,3343,455,1101,333,709,122,392,180,240,45,194,239,473,184,3,337,213,1212
1715,Joe Kilgore,2015,2018,Texas A&M-Corpus Christi,Southland,122,3022,430,1012,352,763,78,249,274,352,91,326,417,235,109,64,217,225,1212
1716,Mike McCall,2011,2014,Saint Louis,A-10,133,3704,413,998,252,549,161,449,225,285,83,260,343,339,165,10,197,256,1212
1717,Frank Eaves,2013,2016,Appalachian State,Total,96,2388,357,958,194,492,163,466,334,417,66,210,276,136,80,1,160,171,1211
1718,Ben Finney,2008,2011,Old Dominion,CAA,139,3873,415,1008,292,598,123,410,258,421,363,442,805,302,189,51,216,281,1211
1719,Jonny Flynn,2008,2009,Syracuse,Big East,73,2661,410,892,309,589,101,303,290,371,44,154,198,439,107,12,224,106,1211
1720,Ryan Kemrite,2015,2018,Liberty,Big South,132,3575,381,836,123,236,258,600,191,249,76,282,358,104,91,8,97,299,1211
1721,Romero Osby,2009,2013,Total,Total,134,2757,427,868,387,766,40,102,317,430,208,426,634,102,54,82,160,241,1211
1722,Drake Reed,2008,2009,Austin Peay,OVC,67,2314,436,839,415,777,21,62,318,437,161,280,441,146,56,35,182,152,1211
1723,Joshua Smith,2011,2015,Total,Total,117,2283,446,755,446,754,0,1,319,520,303,321,624,85,99,90,210,379,1211
1724,Jerrell Williams,2008,2011,La Salle,A-10,121,2933,450,992,425,896,25,96,286,488,341,425,766,195,109,51,339,340,1211
1725,Sam Prescott,2010,2014,Total,Total,114,3148,418,1053,254,575,164,478,210,288,121,315,436,150,101,33,200,279,1210
1726,Max Strus,2018,2019,DePaul,Big East,65,2374,401,944,208,400,193,544,215,260,87,289,376,162,72,32,149,190,1210
1727,Augustus Gilchrist,2009,2012,South Florida,Big East,106,2888,436,1019,395,896,41,123,296,431,211,351,562,61,40,102,214,252,1209
1728,Byron Hawkins,2015,2019,Total,Total,123,2991,393,1020,226,505,167,515,256,338,59,196,255,197,73,12,146,217,1209
1729,Christian James,2016,2019,Oklahoma,Big 12,131,3075,414,998,238,512,176,486,205,273,112,407,519,162,108,13,196,257,1209
1730,Hernst Laroche,2009,2012,New Mexico State,WAC,135,4417,405,934,293,631,112,303,287,398,75,313,388,552,216,9,285,272,1209
1731,Rico Gathers,2013,2016,Baylor,Big 12,141,3127,430,879,429,878,1,1,347,583,482,652,1134,46,115,96,136,341,1208
1732,Russell Johnson,2010,2013,Robert Morris,NEC,129,3300,424,1060,291,665,133,395,227,324,204,542,746,192,159,72,267,382,1208
1733,Tyler Murray,2009,2012,Wagner,NEC,117,3189,389,896,202,466,187,430,243,306,65,322,387,287,114,19,230,147,1208
1734,Noruwa Agho,2009,2012,Columbia,Ivy,86,2773,413,1024,279,689,134,335,247,356,81,275,356,226,103,23,205,159,1207
1735,Tyshawn Bell,2012,2015,Delaware State,MEAC,125,3154,414,996,208,452,206,544,173,207,122,357,479,90,100,37,103,291,1207
1736,Rashad Green,2008,2012,Total,Total,124,3123,414,944,320,649,94,295,285,375,179,448,627,259,155,26,323,254,1207
1737,Chris McNealy,2011,2014,UC-Irvine,Big West,135,3480,439,1062,308,707,131,355,198,278,127,391,518,277,103,47,177,249,1207
1738,Alex Mitola,2013,2016,Total,Total,123,3390,375,979,135,354,240,625,217,253,49,223,272,276,93,1,172,195,1207
1739,Obi Muonelo,2008,2010,Oklahoma State,Big 12,101,2928,414,991,193,428,221,563,158,249,101,427,528,199,90,12,200,210,1207
1740,Abdel Nader,2012,2016,Total,Total,117,2845,432,1106,304,686,128,420,215,294,104,399,503,127,95,71,267,287,1207
1741,Quentin Snider,2015,2018,Louisville,ACC,131,3482,407,1049,223,567,184,482,209,277,69,231,300,415,71,1,166,184,1207
1742,Tre Bussey,2011,2014,Georgia Southern,Southern,127,3303,429,1038,274,612,155,426,193,285,90,248,338,138,91,8,176,176,1206
1743,Demitrius Conger,2010,2013,St. Bonaventure,A-10,118,3510,390,824,284,527,106,297,320,412,256,389,645,249,83,47,254,243,1206
1744,T.J. Cromer,2016,2017,East Tennessee State,Southern,71,2262,406,912,230,459,176,453,218,269,42,180,222,221,72,16,170,175,1206
1745,Davis Baker,2008,2010,Southern Utah,Summit,86,2603,444,971,347,712,97,259,220,257,58,301,359,92,68,13,181,131,1205
1746,Matt Harris,2015,2018,Massachusetts-Lowell,AEC,115,2902,375,905,141,293,234,612,221,255,52,243,295,130,85,9,163,249,1205
1747,Vander Joaquim,2011,2013,Hawaii,Total,96,2658,456,880,443,845,13,35,280,405,266,561,827,85,44,129,197,277,1205
1748,Tim Rusthoven,2011,2014,William & Mary,CAA,112,2624,470,831,465,799,5,32,260,389,206,394,600,167,49,86,167,330,1205
1749,Terry Taylor,2018,2019,Austin Peay,OVC,67,2162,454,848,366,613,88,235,209,284,244,341,585,82,55,64,125,151,1205
1750,Devon Turk,2013,2016,Loyola (IL),Total,131,3046,413,973,151,323,262,650,117,143,35,281,316,96,67,23,147,271,1205
1751,Davon Usher,2013,2014,Total,Total,63,2197,374,858,228,470,146,388,311,409,99,283,382,102,107,24,134,156,1205
1752,John Bohannon,2011,2014,Texas-El Paso,CUSA,125,3063,455,800,451,775,4,25,290,444,206,619,825,194,67,165,252,331,1204
1753,Jabarie Hinds,2012,2016,Total,Total,129,3318,461,1111,334,727,127,384,155,225,47,204,251,326,150,15,232,222,1204
1754,Demetrius Jackson,2014,2016,Notre Dame,ACC,103,3243,415,888,282,539,133,349,241,308,90,232,322,335,114,23,170,197,1204
1755,Brandon Fields,2008,2010,Nevada,WAC,99,2832,404,972,263,535,141,437,254,357,37,244,281,210,68,24,164,139,1203
1756,Greg Pryor,2014,2017,Chattanooga,Southern,126,3366,356,879,211,444,145,435,346,446,60,224,284,343,170,10,246,313,1203
1757,Andrey Semenov,2009,2014,James Madison,CAA,132,3321,393,945,225,504,168,441,249,319,125,393,518,170,90,101,182,327,1203
1758,Quinton Upshur,2012,2015,Total,Total,101,2635,383,940,209,445,174,495,263,359,56,261,317,97,129,69,137,251,1203
1759,Jeremy Hollowell,2013,2017,Total,Total,125,2825,411,988,301,639,110,349,270,353,128,383,511,145,82,66,213,277,1202
1760,Wayne Selden,2014,2016,Kansas,Big 12,109,3217,422,969,260,526,162,443,196,310,96,228,324,282,75,41,211,223,1202
1761,Chris Wroblewski,2009,2012,Cornell,Ivy,119,3594,367,912,178,456,189,456,279,339,47,337,384,481,139,6,259,225,1202
1762,Jerome Dyson,2008,2010,Connecticut,Big East,82,2494,392,979,301,690,91,289,326,440,89,241,330,268,130,45,246,209,1201
1763,Brandon Bos,2012,2015,South Dakota,Summit,113,2895,376,959,231,577,145,382,303,355,76,273,349,223,48,6,184,152,1200
1764,Daniel Dion,2014,2017,New Hampshire,AEC,118,3310,383,997,139,348,244,649,190,240,35,232,267,235,78,8,186,202,1200
1765,Kory Holden,2015,2019,Total,Total,99,2811,402,1009,242,615,160,394,236,312,46,193,239,350,39,9,252,189,1200
1766,Dorenzo Hudson,2008,2012,Virginia Tech,ACC,135,3437,419,1032,312,672,107,360,255,332,103,233,336,177,83,17,201,196,1200
1767,Moses Kingsley,2014,2017,Arkansas,SEC,136,2701,424,835,416,817,8,18,344,508,266,502,768,106,88,256,172,290,1200
1768,Deon Mitchell,2012,2015,Northern Iowa,MVC,135,3207,406,964,301,679,105,285,283,414,41,252,293,373,129,7,283,181,1200
1769,J.C. Show,2015,2019,Total,Total,110,3068,405,1039,171,396,234,643,156,190,51,280,331,145,87,4,151,175,1200
1770,Jordan Strawberry,2015,2018,Mercer,Southern,133,3320,399,1003,250,596,149,407,253,293,70,275,345,494,92,4,219,194,1200
1771,C.J. Carter,2013,2015,Omaha,Summit,90,2817,422,957,308,591,114,366,241,322,51,188,239,267,115,30,227,162,1199
1772,Clayton Custer,2015,2019,Total,Total,111,3299,425,903,243,458,182,445,167,218,35,187,222,332,125,6,193,200,1199
1773,Kierre Greenwood,2010,2013,Coastal Carolina,Big South,118,3448,424,933,363,754,61,179,290,386,69,300,369,481,178,32,282,252,1199
1774,Paris Horne,2008,2011,St. John's (NY),Big East,129,3452,444,1023,296,607,148,416,163,259,155,222,377,189,126,42,196,262,1199
1775,Cullen Neal,2014,2018,Total,Total,139,3032,359,958,167,437,192,521,288,366,37,234,271,302,67,1,256,297,1198
1776,Trevor Lacey,2012,2015,Total,Total,104,3199,404,971,233,503,171,468,218,293,48,349,397,295,110,24,202,168,1197
1777,Maze Stallworth,2008,2010,Morehead State,OVC,98,3059,371,934,121,295,250,639,205,261,173,256,429,125,105,47,139,304,1197
1778,Kevin Tiggs,2008,2009,East Tennessee State,A-Sun,66,2099,418,779,371,643,47,136,314,406,155,184,339,118,120,14,206,152,1197
1779,Isaac Fleming,2015,2019,Total,Total,115,3064,455,985,373,662,82,323,204,314,120,264,384,389,146,10,293,291,1196
1780,Tyler Harris,2012,2016,Total,Total,118,3021,408,942,346,734,62,208,318,437,210,359,569,131,87,44,200,304,1196
1781,Ryan Andino,2015,2019,Maryland-Eastern Shore,MEAC,130,3342,384,1079,55,164,329,915,98,120,29,165,194,105,74,1,104,138,1195
1782,Martin Breunig,2012,2016,Total,Total,95,2143,457,759,451,730,6,29,275,383,191,371,562,112,42,68,164,247,1195
1783,Ryan Funk,2016,2019,Marist,MAAC,113,3099,379,916,115,232,264,684,173,209,48,253,301,57,51,12,88,225,1195
1784,Artsiom Parakhouski,2009,2010,Radford,Big South,64,2109,451,804,448,787,3,17,290,483,292,491,783,70,45,115,147,147,1195
1785,Jhivvan Jackson,2018,2019,Texas-San Antonio,CUSA,58,1639,395,978,215,474,180,504,224,278,22,190,212,123,65,4,138,150,1194
1786,"David Jenkins, Jr.",2018,2019,South Dakota State,Summit,67,2091,388,872,192,405,196,467,222,279,24,197,221,106,28,0,143,156,1194
1787,Evan Kelley,2011,2015,Sacred Heart,NEC,117,3327,435,1015,379,786,56,229,268,414,77,312,389,243,130,17,259,240,1194
1788,Sam Rowley,2012,2015,Albany (NY),AEC,127,3202,453,888,453,882,0,6,288,379,241,515,756,166,129,64,268,348,1194
1789,Tate Unruh,2011,2014,Northern Colorado,Big Sky,112,2963,406,890,165,331,241,559,141,150,55,303,358,139,86,8,142,220,1194
1790,Shivaughn Wiggins,2013,2017,Total,Total,113,3344,357,818,268,571,89,247,391,545,72,227,299,335,134,8,160,195,1194
1791,Eric Cooper,2015,2019,Total,Total,122,3153,386,1051,168,411,218,640,203,249,55,214,269,128,76,6,127,214,1193
1792,Shavar Newkirk,2015,2018,Saint Joseph's,A-10,111,2966,372,964,272,649,100,315,349,466,68,267,335,333,116,19,180,148,1193
1793,Mike Phillips,2010,2013,Howard,MEAC,121,3527,427,1040,423,1017,4,23,335,502,317,424,741,95,85,62,268,326,1193
1794,Nate Rohnert,2008,2010,Denver,Sun Belt,93,3160,395,799,325,573,70,226,333,459,69,397,466,335,112,19,255,252,1193
1795,Malcolm Thomas,2008,2011,Total,Total,103,3156,446,841,442,824,4,17,297,512,297,545,842,211,67,191,233,236,1193
1796,Dmitri Thompson,2015,2018,Elon,CAA,129,3272,448,944,362,675,86,269,211,321,145,461,606,163,91,21,191,235,1193
1797,Bobby Word,2014,2018,Total,Total,131,3412,382,1012,134,326,248,686,181,248,70,290,360,113,75,31,124,266,1193
1798,Cameron Johnson,2008,2011,Texas State,Southland,118,2348,440,948,439,945,1,3,311,509,245,393,638,82,106,55,238,375,1192
1799,Joshua Jones,2009,2012,Eastern Kentucky,OVC,125,3615,405,943,205,433,200,510,182,255,55,280,335,236,123,29,170,275,1192
1800,Keith McDougald,2011,2014,Jacksonville,A-Sun,104,2548,405,1022,253,561,152,461,230,302,89,237,326,158,116,4,217,268,1192
1801,A.J. Abrams,2008,2009,Texas,Big 12,72,2647,412,1000,189,426,223,574,144,173,32,153,185,101,106,6,79,138,1191
1802,Tracy Abrams,2012,2017,Illinois,Big Ten,138,3605,399,1041,278,654,121,387,272,369,75,347,422,374,142,18,255,302,1191
1803,Aaric Armstead,2014,2017,Northern Illinois,MAC,124,3530,395,1055,289,707,106,348,295,435,202,432,634,121,152,59,213,248,1191
1804,Rashid Gaston,2013,2017,Total,Total,120,2798,485,835,485,835,0,0,221,414,339,510,849,86,28,86,189,290,1191
1805,Noah Hartsock,2009,2012,Brigham Young,Total,134,3331,461,847,422,748,39,99,230,282,194,444,638,158,74,177,123,274,1191
1806,Mick Hedgepeth,2009,2012,Belmont,A-Sun,134,2673,413,765,404,736,9,29,356,522,259,432,691,62,57,78,180,335,1191
1807,Jarvis Threatt,2012,2014,Delaware,CAA,87,2714,338,868,285,679,53,189,462,613,94,349,443,308,159,18,190,148,1191
1808,Maalik Wayns,2010,2012,Villanova,Big East,95,2464,379,919,285,596,94,323,339,400,46,206,252,323,87,3,223,217,1191
1809,Quadir Welton,2014,2017,Saint Peter's,MAAC,131,3482,435,924,435,924,0,0,321,575,329,555,884,165,84,136,246,370,1191
1810,Kaelon Wilson,2015,2018,Texas-Arlington,Sun Belt,132,3021,412,913,319,623,93,290,274,418,168,341,509,156,93,30,174,262,1191
1811,Chris Denson,2011,2014,Auburn,SEC,100,2496,401,873,354,702,47,171,341,527,88,187,275,156,82,10,129,171,1190
1812,Gee McGhee,2013,2017,Total,Total,124,3527,354,879,251,542,103,337,378,575,164,400,564,277,133,25,187,280,1189
1813,Shawn Roundtree,2015,2019,Total,Total,104,2931,368,898,228,507,140,391,313,397,36,207,243,301,64,3,233,171,1189
1814,B.J. Johnson,2014,2018,Total,Total,91,2317,403,947,274,562,129,385,253,300,125,371,496,62,83,41,157,160,1188
1815,Jarred Jones,2013,2017,Loyola (MD),Total,124,2853,433,909,422,863,11,46,311,424,177,445,622,140,135,126,234,317,1188
1816,Bobby Hain,2013,2016,Youngstown State,Horizon,110,2786,469,925,445,821,24,104,225,324,225,454,679,151,45,54,144,267,1187
1817,Rich Williams,2014,2018,Manhattan,MAAC,123,2693,434,989,295,617,139,372,180,238,111,325,436,160,92,26,228,269,1187
1818,Jordan Ford,2017,2019,Saint Mary's (CA),WCC,99,2410,426,870,295,557,131,313,203,257,38,170,208,162,78,3,104,117,1186
1819,Jordan Fox,2016,2019,Army,Patriot,127,3188,409,1019,197,435,212,584,156,200,42,300,342,436,89,6,225,255,1186
1820,Madarious Gibbs,2012,2015,Texas Southern,SWAC,130,3932,404,904,337,691,67,213,311,474,76,335,411,469,130,9,313,287,1186
1821,Amorrow Morgan,2008,2010,Idaho State,Big Sky,90,3030,417,917,354,731,63,186,289,414,63,233,296,249,78,16,293,167,1186
1822,L.J. Peak,2015,2017,Georgetown,Big East,98,2709,395,857,307,594,88,263,308,405,80,225,305,199,87,45,187,271,1186
1823,Dorian Pickens,2015,2018,Stanford,Pac-12,116,2916,371,887,175,380,196,507,248,335,94,246,340,162,88,11,135,175,1186
1824,Tyrese Rice,2008,2009,Boston College,ACC,63,2245,362,854,237,499,125,355,337,396,40,185,225,325,95,13,228,160,1186
1825,Reggie Middleton,2009,2012,Winthrop,Big South,116,3174,415,1076,302,712,113,364,242,361,82,307,389,410,173,33,246,283,1185
1826,Kaleb Tarczewski,2013,2016,Arizona,Pac-12,135,3489,415,740,415,740,0,0,355,504,277,602,879,63,39,117,204,372,1185
1827,Breein Tyree,2017,2019,Mississippi,SEC,99,2575,403,966,260,563,143,403,236,308,31,200,231,247,76,23,209,182,1185
1828,Solomon Bozeman,2008,2011,Total,Total,97,2659,314,772,177,407,137,365,419,514,40,165,205,270,77,4,206,205,1184
1829,Todd Brown,2008,2010,Wright State,Horizon,96,3129,410,1007,243,592,167,415,197,275,109,325,434,188,83,27,139,186,1184
1830,Rokas Gustys,2015,2018,Hofstra,CAA,120,3179,507,824,507,824,0,0,170,445,449,856,1305,113,104,83,191,394,1184
1831,Jamelle Hagins,2010,2013,Delaware,CAA,124,3602,466,919,466,917,0,2,252,377,291,786,1077,86,86,291,226,396,1184
1832,Cleon Roberts,2013,2017,Total,Total,127,3666,368,945,173,421,195,524,253,334,113,242,355,140,171,38,175,320,1184
1833,Isiah Brown,2009,2012,East Tennessee State,A-Sun,135,3511,473,857,473,855,0,2,237,445,315,475,790,119,126,183,259,390,1183
1834,Demetrius Dyson,2014,2018,Total,Total,118,2487,393,870,208,420,185,450,212,294,97,301,398,91,66,18,161,196,1183
1835,Jack McClinton,2008,2009,Miami (FL),ACC,64,2037,379,863,184,420,195,443,230,255,29,147,176,173,48,2,163,110,1183
1836,Matthew Bryan-Amaning,2008,2011,Washington,Pac-10,136,2822,483,954,483,953,0,1,216,381,279,449,728,73,115,158,182,334,1182
1837,Jarell Eddie,2011,2014,Virginia Tech,ACC,123,3176,383,995,191,469,192,526,224,276,101,462,563,139,43,58,183,247,1182
1838,KJ Feagin,2016,2019,Santa Clara,WCC,83,2757,431,973,279,591,152,382,168,200,26,195,221,328,66,9,191,179,1182
1839,Tarkus Ferguson,2017,2019,Illinois-Chicago,Horizon,95,3118,388,972,199,436,189,536,217,279,52,503,555,479,126,71,291,201,1182
1840,Geno Luzcando,2015,2018,Idaho State,Big Sky,121,3283,410,848,325,585,85,263,277,410,107,358,465,201,217,19,287,360,1182
1841,Dererk Pardon,2016,2019,Northwestern,Big Ten,112,3234,471,783,465,754,6,29,234,380,328,456,784,134,72,148,134,301,1182
1842,Christopher Anderson,2012,2015,San Diego,WCC,129,4108,390,935,289,664,101,271,300,462,92,341,433,757,254,18,365,279,1181
1843,Jace Hogan,2015,2019,Total,Total,98,2451,473,984,468,965,5,19,230,328,185,330,515,84,55,44,148,185,1181
1844,Cedric Kuakumensah,2013,2016,Brown,Ivy,115,3135,439,1007,381,857,58,150,245,368,246,661,907,119,44,311,229,349,1181
1845,Trent Lockett,2010,2013,Total,Total,122,3341,408,844,360,704,48,140,317,451,172,418,590,219,109,45,263,295,1181
1846,Trent Mackey,2012,2016,Total,Total,125,3589,381,879,78,198,303,681,116,140,41,216,257,175,64,6,144,255,1181
1847,Sviatoslav Mykhailiuk,2015,2018,Kansas,Big 12,136,3070,422,986,185,407,237,579,100,134,93,247,340,202,97,27,146,227,1181
1848,Dusan Ristic,2015,2018,Arizona,Pac-12,141,2640,484,857,470,827,14,30,199,285,204,439,643,77,31,66,137,271,1181
1849,Kendall Stephens,2014,2018,Total,Total,127,2777,376,980,75,205,301,775,128,158,40,200,240,123,55,51,104,232,1181
1850,Jordan Barnes,2017,2019,Indiana State,MVC,92,2685,365,939,150,370,215,569,235,271,36,289,325,275,90,6,197,195,1180
1851,Jason Brickman,2011,2014,Long Island University,NEC,130,4241,348,792,145,301,203,491,281,337,55,286,341,1007,122,1,432,90,1180
1852,Andrew Nicholas,2012,2015,Monmouth,Total,107,2919,431,1129,262,617,169,512,149,218,91,249,340,164,117,39,183,285,1180
1853,Jacques Streeter,2009,2013,Total,Total,127,4283,368,923,204,482,164,441,280,381,64,314,378,600,112,6,251,220,1180
1854,Micah Williams,2008,2011,East Tennessee State,A-Sun,130,2845,399,922,270,548,129,374,253,347,117,257,374,99,85,32,163,187,1180
1855,Garrison Carr,2008,2009,American,Patriot,65,2340,379,919,130,327,249,592,172,207,38,171,209,109,54,3,157,127,1179
1856,Joey Lynch-Flohr,2008,2010,Radford,Big South,94,2892,442,875,441,871,1,4,294,405,232,376,608,119,56,26,197,313,1179
1857,Pancake Thomas,2013,2017,Total,Total,130,2883,378,911,200,468,178,443,245,301,89,319,408,208,76,8,124,173,1179
1858,Julian Eleby,2014,2017,Virginia Military Institute,Total,113,2865,364,931,188,414,176,517,274,348,77,391,468,234,103,23,223,160,1178
1859,D.J. Gay,2008,2011,San Diego State,MWC,140,4223,379,1046,160,439,219,607,201,288,51,210,261,344,126,10,191,156,1178
1860,Cody Martin,2015,2019,Total,Total,122,3526,450,899,398,739,52,160,226,328,171,388,559,434,155,96,201,278,1178
1861,Demarquelle Tabb,2011,2014,Alabama A&M,SWAC,112,3004,443,915,443,908,0,7,292,501,279,540,819,120,113,184,194,332,1178
1862,Keith Wright,2009,2012,Harvard,Ivy,109,2926,487,870,487,868,0,2,204,290,250,493,743,89,62,146,221,250,1178
1863,Michael Gbinije,2012,2016,Total,ACC,120,3061,409,900,250,489,159,411,200,313,101,276,377,310,154,31,194,257,1177
1864,Z Mason,2012,2014,Chattanooga,Southern,88,2206,420,883,355,684,65,199,272,385,214,469,683,55,64,129,146,164,1177
1865,Edward Townsel,2011,2014,Arkansas State,Sun Belt,129,3366,392,1027,216,531,176,496,217,299,97,305,402,240,173,6,247,273,1177
1866,Reggie Lewis,2011,2014,Florida A&M,MEAC,120,3169,432,1139,244,622,188,517,124,172,63,142,205,167,88,13,143,163,1176
1867,Retin Obasohan,2013,2016,Alabama,SEC,125,2937,380,877,291,611,89,266,327,479,61,286,347,182,154,63,206,278,1176
1868,Jahaad Proctor,2016,2019,Total,Total,88,2357,414,917,287,547,127,370,221,288,50,224,274,209,78,20,150,116,1176
1869,Marquis Hall,2008,2010,Lehigh,Patriot,91,2895,371,1021,206,553,165,468,268,358,60,285,345,433,130,8,228,191,1175
1870,Gary Johnson,2008,2011,Texas,Big 12,124,3005,427,898,425,890,2,8,319,485,200,486,686,99,51,48,168,277,1175
1871,Andrew Kostecka,2017,2019,Loyola (MD),Patriot,87,2440,410,829,309,555,101,274,254,322,77,249,326,157,166,70,159,229,1175
1872,Rihards Kuksiks,2008,2011,Arizona State,Pac-10,121,3310,395,933,115,237,280,696,105,132,81,285,366,192,93,25,134,246,1175
1873,Jordan Reed,2013,2017,Total,Total,93,2743,387,958,357,835,30,123,371,533,239,498,737,105,93,56,227,233,1175
1874,Abdul-Malik Abu,2015,2018,North Carolina State,ACC,128,2934,462,934,460,915,2,19,248,395,291,485,776,110,41,82,184,340,1174
1875,Marquez Haynes,2009,2010,Texas-Arlington,Southland,60,1965,381,795,282,537,99,258,313,410,70,211,281,215,82,17,201,134,1174
1876,Arinze Onuaku,2008,2010,Syracuse,Big East,105,2815,517,792,517,792,0,0,140,358,289,435,724,69,83,135,169,283,1174
1877,Nick Emery,2016,2019,Brigham Young,WCC,93,2641,401,962,202,431,199,531,172,211,26,242,268,214,132,14,146,264,1173
1878,Ako Kaluna,2014,2017,Northern Arizona,Big Sky,130,2814,437,977,343,701,94,276,205,300,203,382,585,113,65,50,167,315,1173
1879,Austin Morgan,2010,2013,Yale,Ivy,118,3117,332,840,133,332,199,508,310,361,34,164,198,245,95,6,201,198,1173
1880,Rhamel Brown,2011,2014,Manhattan,MAAC,130,3155,478,867,478,863,0,4,216,463,371,439,810,79,113,367,202,382,1172
1881,Nolan Cressler,2013,2017,Total,Total,124,2827,432,976,258,512,174,464,134,184,87,358,445,153,55,7,156,234,1172
1882,Ashley Hamilton,2009,2013,Loyola Marymount,WCC,113,3020,400,911,362,792,38,119,334,459,198,457,655,108,76,57,292,321,1172
1883,Denzel Livingston,2014,2015,Incarnate Word,Southland,56,1959,364,767,264,496,100,271,344,435,83,262,345,187,142,76,153,143,1172
1884,Shaquille Morris,2015,2018,Wichita State,Total,134,2337,456,835,434,774,22,61,238,332,164,400,564,104,50,147,143,346,1172
1885,Khristian Smith,2013,2016,Indiana State,MVC,130,3402,415,1014,339,738,76,276,266,376,124,425,549,172,99,39,174,287,1172
1886,Worth Smith,2012,2015,Navy,Patriot,111,3205,477,1058,405,827,72,231,146,218,216,387,603,89,107,107,180,236,1172
1887,Alex Oriakhi,2010,2013,Total,Total,143,3640,447,843,447,842,0,1,277,432,395,636,1031,49,53,220,168,335,1171
1888,Kendall Pollard,2014,2017,Dayton,A-10,125,2714,421,797,409,749,12,48,317,555,114,381,495,122,97,72,206,313,1171
1889,Terence Smith,2011,2015,Total,Total,118,3096,370,877,245,557,125,320,306,380,95,249,344,293,81,13,202,271,1171
1890,John Williams,2008,2011,North Carolina-Asheville,Big South,119,3217,457,828,450,806,7,22,250,441,225,459,684,121,86,256,171,212,1171
1891,JT Yoho,2013,2016,Wright State,Horizon,119,2848,426,972,269,560,157,412,162,222,81,377,458,182,49,11,190,242,1171
1892,Michael Alvarado,2011,2014,Manhattan,MAAC,117,3175,346,884,288,691,58,193,420,565,65,230,295,364,159,8,299,260,1170
1893,Devonte Brown,2013,2016,Indiana State,MVC,130,3309,339,824,278,610,61,214,431,623,67,371,438,281,113,22,312,288,1170
1894,Antwan Burrus,2010,2014,Liberty,Big South,125,2980,475,936,472,928,3,8,217,299,276,340,616,60,49,124,176,278,1170
1895,Nick Calathes,2008,2009,Florida,SEC,72,2374,380,836,249,491,131,345,279,390,72,307,379,452,126,9,223,145,1170
1896,Brynton Lemar,2014,2017,UC-Davis,Big West,123,3147,380,957,232,563,148,394,262,356,51,262,313,214,72,9,190,253,1170
1897,Aurimas Majauskas,2014,2017,Sam Houston State,Southland,126,2122,398,705,358,595,40,110,334,437,204,311,515,118,39,29,150,362,1170
1898,Tahjere McCall,2013,2017,Total,Total,117,3047,388,908,357,773,31,135,363,536,175,305,480,363,220,32,322,339,1170
1899,Matt Thomas,2014,2017,Iowa State,Big 12,138,3510,394,923,140,289,254,634,128,157,51,380,431,181,92,21,114,211,1170
1900,Kevin Hardy,2012,2015,McNeese State,Southland,125,3750,465,998,428,889,37,109,202,366,230,435,665,430,241,102,220,290,1169
1901,Javontae Hawkins,2013,2017,Total,Total,116,2559,406,893,323,639,83,254,274,351,111,264,375,107,72,34,188,257,1169
1902,Isaiah Philmore,2010,2014,Total,Total,121,3212,412,819,388,737,24,82,321,441,255,377,632,69,56,36,165,291,1169
1903,Chad White,2010,2014,South Dakota State,Summit,132,3445,389,852,174,326,215,526,176,242,126,313,439,203,72,59,169,265,1169
1904,Tweety Carter,2008,2010,Baylor,Big 12,100,3184,393,911,176,364,217,547,165,224,41,196,237,391,116,0,180,220,1168
1905,Brandon Reed,2010,2014,Total,Total,124,3121,400,1062,236,569,164,493,204,287,64,295,359,216,80,9,191,159,1168
1906,Lorenzo Brown,2011,2013,North Carolina State,ACC,101,3289,410,955,346,745,64,210,283,382,74,351,425,589,172,50,304,190,1167
1907,Tyree Griffin,2015,2019,Total,Total,129,3497,403,976,276,603,127,373,234,327,66,320,386,586,159,8,250,185,1167
1908,Luis Jacobo,2011,2014,Total,Total,97,2806,413,935,242,483,171,452,170,221,90,330,420,120,79,33,174,204,1167
1909,Gani Lawal,2008,2010,Georgia Tech,ACC,99,2403,446,814,446,811,0,3,275,498,268,444,712,43,59,127,211,240,1167
1910,Tavon Blackmon,2014,2017,Brown,Ivy,111,3468,388,957,295,710,93,247,297,400,36,170,206,465,99,4,310,247,1166
1911,Gilberto Clavell,2010,2011,Sam Houston State,Southland,64,1862,418,739,414,718,4,21,326,454,191,244,435,72,45,9,186,214,1166
1912,Jonathan Holmes,2012,2015,Texas,Big 12,127,2931,397,869,303,570,94,299,278,384,293,456,749,92,77,113,179,351,1166
1913,Shake Milton,2016,2018,Southern Methodist,AAC,87,3019,388,859,198,414,190,445,200,253,38,298,336,337,99,33,159,135,1166
1914,Iman Shumpert,2009,2011,Georgia Tech,ACC,92,2877,387,977,276,613,111,364,281,381,102,310,412,382,207,17,280,245,1166
1915,Phillip Carr,2016,2018,Morgan State,MEAC,87,2861,409,959,356,803,53,156,294,363,234,508,742,104,50,78,147,207,1165
1916,Carlton Fay,2008,2011,Southern Illinois,MVC,126,2911,399,920,279,552,120,368,247,300,124,308,432,83,50,25,156,317,1165
1917,Trey Finn,2010,2013,Arkansas State,Sun Belt,121,3845,360,894,176,403,184,491,261,349,197,471,668,210,161,32,162,262,1165
1918,DJ Laster,2017,2019,Gardner-Webb,Big South,99,2333,484,923,425,759,59,164,138,219,175,303,478,44,47,42,147,224,1165
1919,Adam Leonard,2008,2011,Total,Total,100,3404,377,965,113,275,264,690,147,192,15,202,217,237,82,3,138,145,1165
1920,Jamal Webb,2011,2014,North Dakota,Total,131,3935,438,969,322,635,116,334,173,296,136,444,580,483,241,44,389,289,1165
1921,Gary Blackston,2018,2019,Prairie View,SWAC,67,2126,393,904,300,638,93,266,285,413,108,306,414,179,108,9,168,201,1164
1922,Clarence Jackson,2008,2011,Siena,MAAC,118,2359,410,998,224,467,186,531,158,227,68,174,242,90,115,19,167,165,1164
1923,Sergio Kerusch,2009,2011,Western Kentucky,Sun Belt,86,2408,442,953,338,616,104,337,176,277,222,427,649,46,42,18,111,186,1164
1924,Conner Avants,2016,2019,North Dakota,Total,119,2818,467,838,458,811,9,27,220,326,193,371,564,94,86,46,178,319,1163
1925,Jordan Chatman,2016,2019,Total,Total,129,3362,373,932,153,356,220,576,197,229,43,221,264,170,54,17,124,197,1163
1926,Allen Huddleston,2010,2014,Total,Total,134,2996,341,889,167,368,174,521,307,467,51,219,270,170,138,8,166,222,1163
1927,Halil Kanacevic,2010,2014,Total,Total,128,3707,444,980,396,800,48,180,227,364,301,727,1028,407,91,220,343,448,1163
1928,Casey Kasperbauer,2013,2016,South Dakota,Summit,123,3378,379,891,122,281,257,610,148,163,17,247,264,168,99,3,101,128,1163
1929,Stefan Perunicic,2009,2012,St. Francis (NY),NEC,118,3437,377,1000,97,234,280,766,129,188,54,247,301,112,82,36,223,339,1163
1930,Jamaal Franklin,2011,2013,San Diego State,MWC,85,2198,362,849,264,524,98,325,340,436,128,468,596,162,86,51,218,182,1162
1931,Darrin Govens,2008,2010,Saint Joseph's,A-10,97,3073,400,1044,189,448,211,596,151,211,53,214,267,256,143,11,172,237,1162
1932,Joe Willman,2010,2013,Bucknell,Patriot,134,3232,504,1013,503,1003,1,10,153,188,228,417,645,154,82,64,152,344,1162
1933,Tony Carr,2017,2018,Penn State,Big Ten,70,2392,386,974,265,668,121,306,268,341,55,286,341,325,52,20,171,141,1161
1934,Brian Conklin,2009,2012,Saint Louis,A-10,133,3137,404,792,403,788,1,4,352,498,233,306,539,105,59,37,206,317,1161
1935,Tyler Hood,2012,2015,Samford,Southern,119,2988,409,898,241,425,168,473,175,241,112,279,391,128,73,38,131,287,1161
1936,Ricky Johnson,2012,2016,Bethune-Cookman,MEAC,128,3574,322,959,184,495,138,464,379,467,78,230,308,295,108,3,242,291,1161
1937,Jonathan Lee,2010,2013,Northeastern,CAA,98,2914,374,811,266,544,108,267,305,382,99,231,330,293,119,6,255,189,1161
1938,Alex Olah,2013,2016,Northwestern,Big Ten,122,3225,439,902,409,790,30,112,253,367,179,484,663,171,52,181,181,290,1161
1939,Davion Berry,2013,2014,Weber State,Big Sky,68,2217,342,727,221,425,121,302,355,447,28,257,285,262,75,16,161,137,1160
1940,Marvin Dominique,2011,2015,Total,Total,114,2882,417,925,346,722,71,203,255,339,266,457,723,48,76,67,158,245,1160
1941,Tacko Fall,2016,2019,Central Florida,AAC,115,2649,497,672,497,671,0,1,166,384,307,580,887,50,25,280,240,299,1160
1942,Spencer Parker,2013,2016,Bowling Green State,MAC,114,3015,395,882,337,689,58,193,312,438,142,336,478,135,66,29,233,247,1160
1943,Craig Ponder,2012,2016,North Carolina-Wilmington,CAA,130,3216,393,965,271,644,122,321,252,367,56,282,338,257,101,20,222,295,1160
1944,Davell Roby,2015,2018,Saint Louis,A-10,128,3536,345,893,179,438,166,455,304,430,51,308,359,281,100,16,224,313,1160
1945,Jeff Thomas,2016,2019,Georgia State,Sun Belt,132,3264,402,943,187,394,215,549,141,177,91,350,441,116,100,81,113,243,1160
1946,Kevin Dukes,2010,2013,Bethune-Cookman,MEAC,136,3712,376,982,100,237,276,745,131,171,54,169,223,264,104,8,181,150,1159
1947,Desmond Haymon,2011,2014,Stephen F. Austin,Southland,112,3141,376,896,238,485,138,411,269,408,147,292,439,191,85,3,148,188,1159
1948,Cory Jefferson,2010,2014,Baylor,Big 12,130,2589,431,794,414,744,17,50,280,424,243,479,722,51,42,166,101,226,1159
1949,Garrison Johnson,2008,2010,Jackson State,SWAC,97,2782,374,990,253,628,121,362,290,395,97,254,351,99,77,32,169,159,1159
1950,Deandre Burnett,2015,2018,Total,Total,92,2354,319,879,163,436,156,443,364,437,38,151,189,243,67,10,184,123,1158
1951,Jeremy Bynum,2008,2011,Jacksonville State,OVC,110,2865,406,1004,177,420,229,584,117,158,63,280,343,137,58,18,142,200,1158
1952,Nikola Cvetinovic,2009,2012,Akron,MAC,141,3065,452,964,433,903,19,61,235,365,238,436,674,197,111,20,232,354,1158
1953,Ryan Wedel,2008,2011,Total,Total,94,2892,384,910,157,331,227,579,163,197,32,195,227,162,97,8,138,162,1158
1954,Rodney Williams,2014,2017,Drexel,CAA,114,3055,420,860,417,846,3,14,315,479,242,445,687,125,40,128,182,389,1158
1955,David Hicks,2008,2011,Long Island University,NEC,124,3591,393,1032,246,581,147,451,224,302,141,329,470,138,119,22,174,255,1157
1956,Sam Hunt,2014,2018,Total,Total,124,2942,352,899,144,325,208,574,245,270,22,138,160,152,64,2,178,211,1157
1957,Lorenzo Keeler,2008,2010,Cal Poly,Big West,88,2575,342,970,182,470,160,500,313,363,38,181,219,164,41,4,182,157,1157
1958,Edward Stephens,2015,2018,Total,Total,107,2852,391,960,166,360,225,600,150,191,50,198,248,169,85,5,115,159,1157
1959,Neil Watson,2012,2014,Southern Mississippi,CUSA,106,3322,329,823,165,408,164,415,335,393,47,244,291,473,160,4,229,274,1157
1960,Cody Zeller,2012,2013,Indiana,Big Ten,72,2087,399,674,399,672,0,2,359,475,188,337,525,92,86,87,141,177,1157
1961,Hayden Dalton,2016,2018,Wyoming,MWC,100,2544,363,815,216,421,147,394,283,341,113,557,670,214,56,63,207,239,1156
1962,Jackson Emery,2009,2011,Brigham Young,MWC,105,3155,381,829,164,271,217,558,177,229,58,354,412,293,239,29,113,276,1156
1963,Matty McConnell,2016,2019,Robert Morris,NEC,129,3790,375,1064,173,409,202,655,204,278,94,426,520,304,241,45,170,284,1156
1964,Colton Weisbrod,2015,2018,Total,Southland,90,2618,413,834,394,782,19,52,311,461,216,397,613,102,70,18,171,210,1156
1965,Isaac Williams,2015,2017,Mississippi Valley State,SWAC,99,2529,409,1082,234,557,175,525,163,197,92,280,372,88,69,15,101,181,1156
1966,Alpha Diallo,2017,2019,Providence,Big East,99,2893,395,907,331,680,64,227,301,428,189,403,592,218,117,31,192,259,1155
1967,Zach Filzen,2008,2012,Total,Total,117,2733,394,946,124,275,270,671,97,122,27,203,230,103,47,3,140,119,1155
1968,Johnny O'Bryant,2012,2014,Louisiana State,SEC,91,2465,446,956,440,929,6,27,257,415,277,425,702,115,47,72,267,255,1155
1969,Ethan Wragge,2010,2014,Creighton,Total,149,2732,360,816,26,55,334,761,101,116,74,358,432,72,47,22,69,297,1155
1970,Devin Booker,2010,2013,Clemson,ACC,128,3089,445,897,423,817,22,80,242,368,267,461,728,99,80,83,199,291,1154
1971,John Bryant,2008,2009,Santa Clara,WCC,64,1885,440,746,440,744,0,2,274,358,218,547,765,56,32,160,168,177,1154
1972,Jaire Grayer,2016,2019,George Mason,A-10,105,3090,421,1051,237,526,184,525,128,185,155,405,560,97,79,74,158,251,1154
1973,Joe McDonald,2013,2016,George Washington,A-10,133,3965,378,930,285,660,93,270,305,465,192,465,657,447,172,11,273,294,1154
1974,Tywain McKee,2008,2009,Coppin State,MEAC,66,2380,371,882,241,552,130,330,282,336,90,241,331,237,143,7,185,163,1154
1975,John Schoof,2012,2015,American,Patriot,127,4062,390,909,163,356,227,553,147,185,69,264,333,230,64,17,187,258,1154
1976,Vincent Simpson,2008,2010,Hampton,MEAC,94,2501,404,1050,216,474,188,576,158,244,61,158,219,209,122,3,248,151,1154
1977,Akeem Springs,2013,2017,Total,Total,110,3014,407,982,257,532,150,450,190,266,100,356,456,159,74,13,155,168,1154
1978,Connar Tava,2013,2017,Total,Total,134,3407,409,777,400,722,9,55,327,501,202,488,690,314,123,44,322,349,1154
1979,Pablo Bertone,2011,2014,Florida Atlantic,Total,119,2625,422,954,311,638,111,316,198,278,93,283,376,173,86,22,211,243,1153
1980,Alex Copeland,2016,2019,Yale,Ivy,102,2419,434,897,359,680,75,217,210,255,38,164,202,244,95,3,163,122,1153
1981,Darryl Crawford,2008,2010,Manhattan,MAAC,92,2488,381,912,318,710,63,202,328,451,123,292,415,177,105,34,155,201,1153
1982,Jake Gollon,2009,2014,Mercer,A-Sun,154,3754,392,891,302,631,90,260,279,345,191,484,675,320,162,43,297,331,1153
1983,JD Miller,2016,2019,Texas Christian,Big 12,140,3128,409,932,327,656,82,276,253,378,221,411,632,153,92,69,175,206,1153
1984,Sammy Mojica,2015,2018,Drexel,CAA,120,3657,414,1101,221,511,193,590,132,207,152,329,481,233,135,46,171,252,1153
1985,Tai Odiase,2015,2018,Illinois-Chicago,Horizon,130,3227,453,839,453,838,0,1,247,450,322,423,745,33,67,361,131,317,1153
1986,Jordan Sibert,2011,2015,Total,Total,122,2660,366,852,182,346,184,506,237,321,35,225,260,158,113,11,138,180,1153
1987,Devin Sweetney,2008,2010,Saint Francis (PA),NEC,80,2625,376,895,308,643,68,252,333,433,157,375,532,124,90,35,250,197,1153
1988,Kerry Blackshear Jr.,2016,2019,Virginia Tech,ACC,103,2552,406,761,366,632,40,129,300,426,223,393,616,143,67,72,148,313,1152
1989,Brian Darden,2012,2016,Total,Total,110,2762,330,947,99,275,231,672,261,315,36,168,204,140,79,3,157,245,1152
1990,Willis Hall,2010,2014,College of Charleston,Total,137,3482,453,914,356,643,97,271,149,196,284,559,843,119,70,45,184,307,1152
1991,Marcus Jordan,2010,2012,Central Florida,CUSA,94,2928,348,886,234,513,114,373,342,464,52,217,269,256,83,13,208,154,1152
1992,James Washington,2008,2011,Total,Total,95,3041,321,791,145,346,176,445,334,417,46,183,229,292,122,3,218,235,1152
1993,Ryan Brooks,2008,2010,Temple,A-10,103,3351,408,980,243,515,165,465,170,210,70,289,359,183,79,20,112,180,1151
1994,Fred Brown,2008,2012,Total,Total,119,2716,416,1042,233,563,183,479,135,184,65,162,227,207,110,9,219,191,1150
1995,Temple Gibbs,2017,2019,Notre Dame,ACC,104,3042,360,950,195,485,165,465,265,328,52,163,215,278,101,7,119,177,1150
1996,Jeremy Wise,2008,2009,Southern Mississippi,CUSA,65,2280,354,818,287,583,67,235,375,458,27,185,212,287,81,24,214,189,1150
1997,Alan Herndon,2015,2018,Wyoming,MWC,134,3608,423,859,299,493,124,366,179,293,114,519,633,169,73,185,147,280,1149
1998,Mike Moser,2010,2014,Total,Total,112,2729,430,995,313,643,117,352,172,226,192,617,809,177,131,79,221,251,1149
1999,Jaaron Simmons,2014,2018,Total,Total,131,3009,386,879,310,668,76,211,301,403,28,250,278,547,69,2,308,244,1149
2000,Sam Willard,2008,2011,Pacific,Big West,124,3170,434,881,394,767,40,114,241,328,284,594,878,153,83,61,178,284,1149
2001,Ben Brust,2011,2014,Wisconsin,Big Ten,124,3332,392,952,157,345,235,607,129,156,90,347,437,156,88,4,95,121,1148
2002,Jamaya Burr,2014,2017,McNeese State,Southland,117,3149,341,857,261,623,80,234,386,540,69,211,280,361,117,2,266,160,1148
2003,Steven Cook,2014,2017,Princeton,Ivy,110,2913,400,858,244,464,156,394,192,271,126,301,427,159,135,50,149,200,1148
2004,Ryan Jones,2016,2019,Massachusetts-Lowell,AEC,115,3177,396,902,241,480,155,422,201,279,69,295,364,282,75,22,245,203,1148
2005,Patrick Sullivan,2008,2010,Southeastern Louisiana,Southland,91,2525,464,828,463,823,1,5,219,327,190,478,668,173,65,226,242,271,1148
2006,Jay Wright,2015,2017,Louisiana,Sun Belt,101,2997,383,935,267,608,116,327,266,408,55,229,284,372,132,27,232,213,1148
2007,Cezar Guerrero,2012,2016,Total,Total,121,3004,373,938,204,460,169,478,232,287,45,290,335,309,124,4,197,293,1147
2008,Luke Kennard,2016,2017,Duke,ACC,73,2275,378,820,235,447,143,373,248,286,78,239,317,146,65,19,87,152,1147
2009,Charlie Lee,2012,2015,Cleveland State,Horizon,121,3566,359,889,192,471,167,418,262,299,50,248,298,455,130,6,285,298,1147
2010,Kenyon McNeaill,2011,2014,Louisiana Tech,Total,136,3049,351,927,127,314,224,613,221,293,50,243,293,223,128,10,203,239,1147
2011,D.J. Seeley,2009,2013,Total,Total,110,2276,373,846,232,503,141,343,260,344,107,241,348,194,112,16,189,204,1147
2012,Andrew Smith,2010,2013,Butler,Total,134,2968,409,773,373,661,36,112,293,435,251,397,648,97,78,65,133,323,1147
2013,Marvin Smith,2015,2018,North Carolina-Greensboro,Southern,124,3112,380,1060,180,436,200,624,187,264,169,407,576,94,107,54,142,342,1147
2014,Daniel Utomi,2016,2019,Akron,MAC,97,2504,382,894,175,363,207,531,176,242,75,311,386,110,59,24,144,188,1147
2015,Tony Hicks,2013,2017,Total,Total,106,2410,400,990,288,662,112,328,234,305,39,222,261,223,69,4,262,230,1146
2016,Phillip McDonald,2009,2012,New Mexico,MWC,133,2951,397,934,190,386,207,548,145,206,149,253,402,116,62,25,132,232,1146
2017,Randy Onwuasor,2014,2018,Total,Total,127,2601,374,944,290,655,84,289,314,408,110,297,407,211,113,23,232,259,1146
2018,A.J. Smith,2008,2010,Stetson,A-Sun,89,2720,361,952,215,518,146,434,278,365,38,209,247,245,83,2,333,160,1146
2019,Kurt Steidl,2014,2017,Vermont,AEC,137,3461,362,851,138,284,224,567,198,244,73,455,528,135,98,52,129,270,1146
2020,Matt Frierson,2016,2019,Citadel,Southern,125,2652,349,961,26,69,323,892,124,136,42,163,205,138,99,5,91,128,1145
2021,Ja'Quan Newton,2015,2018,Miami (FL),ACC,127,2953,409,916,378,813,31,103,296,432,57,238,295,308,99,15,264,180,1145
2022,Chris Stephenson,2009,2012,North Carolina-Asheville,Big South,127,2911,432,1004,357,725,75,279,206,282,185,377,562,248,131,49,282,327,1145
2023,Rodney Williams,2010,2013,Minnesota,Big Ten,134,3289,450,879,404,698,46,181,199,342,198,339,537,197,110,141,172,286,1145
2024,Anthlon Bell,2013,2016,Arkansas,SEC,129,2360,394,1012,157,370,237,642,119,149,52,147,199,121,56,16,96,196,1144
2025,Will Figures,2008,2010,Northern Colorado,Big Sky,93,2509,329,779,192,463,137,316,349,414,49,185,234,196,76,1,207,207,1144
2026,Micah Seaborn,2016,2018,Monmouth,MAAC,85,2357,380,937,206,472,174,465,210,248,32,231,263,177,82,17,170,172,1144
2027,Justin Tuoyo,2013,2017,Total,Total,122,2837,413,743,398,688,15,55,303,455,253,358,611,97,75,281,151,319,1144
2028,Justin Burrell,2012,2015,Holy Cross,Patriot,120,3439,380,1017,240,611,140,406,243,292,30,197,227,414,97,2,253,196,1143
2029,Michael Carrera,2013,2016,South Carolina,SEC,122,2743,368,860,291,645,77,215,330,462,291,509,800,86,79,102,182,346,1143
2030,Eugene Harris,2008,2010,High Point,Big South,89,2858,383,991,157,358,226,633,151,186,34,194,228,201,96,5,158,159,1143
2031,Khalif Toombs,2010,2013,South Carolina State,MEAC,125,3844,363,1000,243,607,120,393,297,402,46,253,299,508,144,3,309,311,1143
2032,Joel Wright,2011,2014,Total,Total,92,2001,380,854,348,739,32,115,351,474,178,308,486,114,84,51,266,266,1143
2033,Gabe York,2013,2016,Arizona,Pac-12,124,2904,379,915,150,346,229,569,156,208,40,236,276,191,72,26,131,173,1143
2034,Brent Jones,2012,2015,St. Francis (NY),NEC,126,3306,380,985,284,676,96,309,286,399,77,287,364,616,171,12,370,292,1142
2035,Brett Mcknight,2008,2011,Akron,MAC,125,2150,417,981,321,688,96,293,212,296,140,268,408,112,62,20,152,289,1142
2036,Arnett Moultrie,2009,2012,Total,Total,100,3020,441,863,413,766,28,97,232,343,296,540,836,100,101,85,206,237,1142
2037,Sandro Carissimo,2011,2014,Vermont,AEC,134,3610,394,946,259,601,135,345,218,270,64,306,370,278,137,31,176,215,1141
2038,Keith Cothran,2008,2010,Rhode Island,A-10,98,2633,437,969,348,693,89,276,178,272,99,168,267,196,170,30,151,192,1141
2039,David DiLeo,2017,2019,Central Michigan,MAC,103,3198,355,879,102,211,253,668,178,223,151,420,571,103,83,25,71,214,1141
2040,Nick Duncan,2014,2017,Boise State,MWC,130,3587,362,894,112,211,250,683,167,224,128,321,449,155,77,54,147,366,1141
2041,Kahlil Thomas,2014,2017,Rider,MAAC,117,2889,448,851,436,812,12,39,233,377,241,494,735,107,75,92,194,308,1141
2042,Manny Atkins,2010,2014,Total,Total,121,2885,375,841,219,460,156,381,234,290,123,388,511,138,123,37,141,208,1140
2043,Marcus Damas,2012,2014,Towson,CAA,98,3140,387,960,265,582,122,378,244,344,159,352,511,139,67,80,210,266,1140
2044,Corey Hassan,2008,2010,Sacred Heart,NEC,90,2364,407,980,203,454,204,526,122,166,117,298,415,193,77,5,176,142,1140
2045,Brady Heslip,2012,2014,Baylor,Big 12,112,3015,359,829,58,140,301,689,121,147,26,123,149,102,63,1,42,135,1140
2046,Joey King,2013,2016,Total,Total,131,3250,372,829,199,382,173,447,223,268,116,287,403,146,57,44,153,351,1140
2047,Dakota Mathias,2015,2018,Purdue,Big Ten,141,3604,385,887,135,290,250,597,120,149,21,414,435,408,104,18,153,250,1140
2048,Khyri Thomas,2016,2018,Creighton,Big East,102,2773,429,839,298,516,131,323,151,210,116,355,471,255,141,26,165,180,1140
2049,Dwayne Bacon,2016,2017,Florida State,ACC,69,1987,418,930,329,645,89,285,214,292,81,263,344,111,68,5,145,128,1139
2050,Reginald Gee,2017,2019,Alabama State,SWAC,92,2534,361,894,211,507,150,387,267,362,95,285,380,81,52,25,160,162,1139
2051,Ky Howard,2013,2016,NJIT,Total,113,3172,380,795,334,671,46,124,333,479,126,409,535,416,85,16,319,285,1139
2052,Nathaniel Lester,2008,2012,Hofstra,CAA,128,3109,377,970,312,715,65,255,320,433,237,346,583,108,105,51,210,283,1139
2053,Dom Morris,2011,2014,Boston University,Total,129,3410,439,856,398,742,41,114,220,312,230,510,740,94,66,37,182,273,1139
2054,Vernon Teel,2009,2011,Loyola Marymount,WCC,80,2565,367,847,338,730,29,117,376,552,152,283,435,353,136,38,285,194,1139
2055,Will Triggs,2011,2014,Austin Peay,OVC,125,2964,412,779,412,776,0,3,315,519,235,358,593,154,73,69,197,245,1139
2056,Khalen Cumberlander,2013,2017,Central Connecticut State,NEC,114,3386,432,1020,312,639,120,381,154,283,71,278,349,242,109,15,251,243,1138
2057,Garlon Green,2010,2013,Texas Christian,Total,129,3278,399,951,277,613,122,338,218,285,103,348,451,103,58,43,184,315,1138
2058,Terence Jones,2010,2013,Total,Total,126,3392,355,1027,171,454,184,573,244,347,36,229,265,328,116,18,345,258,1138
2059,Brian Mills,2008,2011,Mercer,A-Sun,128,2927,418,868,359,669,59,199,243,334,220,383,603,124,83,99,216,350,1138
2060,Trey Moses,2016,2019,Ball State,MAC,132,3301,425,800,421,787,4,13,284,503,274,632,906,283,66,138,278,358,1138
2061,Darryl Proctor,2008,2009,Maryland-Baltimore County,AEC,65,2462,448,932,445,913,3,19,239,336,168,390,558,114,104,30,130,173,1138
2062,Brandon Tabb,2017,2018,Bethune-Cookman,MEAC,62,2038,359,926,156,331,203,595,217,248,49,234,283,102,89,30,116,185,1138
2063,Mikey Thompson,2013,2016,Boise State,MWC,126,3394,363,864,287,650,76,214,336,436,59,223,282,298,87,2,211,187,1138
2064,Tim Abromaitis,2008,2012,Notre Dame,Big East,83,2382,368,792,208,402,160,390,241,289,95,303,398,121,45,27,104,154,1137
2065,Marcus Burton,2012,2015,Wagner,NEC,112,2580,377,962,229,511,148,451,235,290,40,179,219,174,101,10,160,174,1137
2066,Michael Kessens,2013,2017,Total,Total,127,3178,447,825,436,773,11,52,232,347,262,570,832,125,96,85,251,368,1137
2067,Shamir Davis,2010,2013,Northwestern State,Southland,125,2876,341,830,273,606,68,224,386,542,79,174,253,296,107,9,279,192,1136
2068,Jordan Fouse,2013,2016,Green Bay,Horizon,134,4171,421,924,369,737,52,187,242,396,316,718,1034,397,264,183,248,363,1136
2069,Tadric Jackson,2015,2018,Georgia Tech,ACC,131,2642,433,1071,331,695,102,376,168,283,60,219,279,200,70,19,173,216,1136
2070,Julysses Nobles,2010,2014,Total,Total,122,3286,360,928,242,585,118,343,298,435,46,326,372,376,162,14,283,290,1136
2071,Cleanthony Early,2013,2014,Wichita State,MVC,75,1965,371,790,258,465,113,325,280,342,137,288,425,50,58,63,131,183,1135
2072,Leland King,2014,2018,Total,Total,108,2281,439,956,337,658,102,298,155,223,164,522,686,120,55,37,141,168,1135
2073,Luke Kornet,2014,2017,Vanderbilt,SEC,128,3085,383,918,233,449,150,469,219,281,154,455,609,143,49,210,138,250,1135
2074,Travis Trice,2012,2015,Michigan State,Big Ten,134,3164,371,952,169,440,202,512,191,267,39,241,280,387,122,15,177,237,1135
2075,Isaiah Williams,2014,2018,Total,Total,126,2971,372,893,214,471,158,422,233,291,34,181,215,295,88,10,177,179,1135
2076,Javier Duren,2012,2015,Yale,Ivy,111,2724,333,849,217,508,116,341,352,445,84,337,421,312,127,19,267,284,1134
2077,Jarren Greenwood,2016,2019,McNeese State,Southland,115,3390,359,937,254,579,105,358,311,399,33,260,293,290,98,7,194,194,1134
2078,Cameron Johnson,2015,2018,College of Charleston,CAA,133,4130,401,965,232,506,169,459,163,244,85,331,416,233,112,42,191,335,1134
2079,Nathan Moran,2015,2019,Lipscomb,A-Sun,127,2761,330,871,72,176,258,695,216,253,37,221,258,403,110,4,229,240,1134
2080,Danero Thomas,2008,2010,Murray State,OVC,98,2721,414,963,300,625,114,338,192,273,135,303,438,166,153,64,182,238,1134
2081,Devin Williams,2014,2016,West Virginia,Big 12,102,2505,380,854,380,853,0,1,374,561,299,547,846,119,70,22,207,285,1134
2082,Harper Kamp,2008,2012,University of California,Total,133,3183,424,807,418,781,6,26,279,363,207,343,550,179,65,39,205,343,1133
2083,Malcolm McMillan,2012,2016,Total,Total,124,4051,348,842,254,561,94,281,343,457,69,357,426,462,129,48,227,307,1133
2084,Kyle Ohman,2008,2010,Liberty,Big South,93,2764,355,870,157,359,198,511,225,296,78,337,415,200,103,31,196,243,1133
2085,Jordan Burgason,2009,2012,Lipscomb,A-Sun,109,2574,360,835,78,193,282,642,130,164,65,211,276,182,58,16,148,153,1132
2086,Brayden Carlson,2011,2014,South Dakota State,Summit,132,3835,363,805,206,400,157,405,249,330,50,355,405,287,138,24,191,237,1132
2087,Glen Dean,2010,2014,Total,Total,117,3293,339,865,164,414,175,451,279,351,25,251,276,373,73,0,247,277,1132
2088,Leonard Washington,2009,2013,Total,Total,115,2790,414,813,379,660,35,153,269,404,169,536,705,111,131,113,197,257,1132
2089,Jordan Adams,2013,2014,UCLA,Pac-12,69,2081,373,798,275,502,98,296,287,342,88,231,319,142,168,17,94,147,1131
2090,Aaron Brown,2011,2015,Total,Total,129,2813,364,866,211,431,153,435,250,359,92,257,349,144,58,3,144,228,1131
2091,Robert Glenn,2009,2010,IUPUI,Summit,66,1867,414,700,409,669,5,31,298,402,142,261,403,98,74,100,184,195,1131
2092,Reggie Keely,2010,2013,Ohio,MAC,143,2823,445,847,444,841,1,6,240,384,263,391,654,86,78,107,203,351,1131
2093,Sean Sellers,2015,2018,Ball State,MAC,129,3225,364,841,135,275,229,566,174,222,83,337,420,156,60,41,145,209,1131
2094,TrayVonn Wright,2011,2014,North Dakota State,Summit,127,3128,443,957,341,637,102,320,143,201,199,423,622,84,102,176,114,274,1131
2095,Tarik Black,2011,2014,Total,Total,135,2797,443,722,443,721,0,1,244,440,267,362,629,41,81,146,158,425,1130
2096,Denzel Bowles,2008,2011,Total,Total,75,1953,441,754,441,754,0,0,248,364,168,369,537,136,33,90,203,169,1130
2097,Scott Christopherson,2008,2012,Total,Total,116,3107,382,890,178,428,204,462,162,188,20,255,275,196,63,3,160,132,1130
2098,Jeremy Crutcher,2011,2014,Alabama A&M,SWAC,114,3563,368,988,239,627,129,361,265,415,51,295,346,462,140,3,322,285,1130
2099,Nik Raivio,2008,2010,Portland,WCC,79,2357,405,938,295,609,110,329,210,302,92,329,421,170,86,8,177,143,1130
2100,Benzor Simmons,2008,2011,Tennessee-Martin,OVC,121,2402,367,813,312,619,55,194,341,417,152,322,474,54,70,23,168,258,1130
2101,Brandon Ewing,2008,2009,Wyoming,MWC,63,2404,327,749,218,435,109,314,366,441,33,184,217,287,70,8,191,137,1129
2102,Miguel Paul,2009,2013,Total,Total,133,2878,329,865,170,403,159,462,312,391,30,160,190,528,125,10,263,232,1129
2103,Jarnell Stokes,2012,2014,Tennessee,SEC,87,2587,411,776,411,773,0,3,307,489,337,499,836,129,65,94,180,190,1129
2104,Kris Brewer,2012,2015,Kent State,MAC,129,3291,354,897,227,535,127,362,293,402,54,252,306,304,97,22,226,221,1128
2105,Sebastian Koch,2011,2014,Elon,Southern,126,3502,371,873,129,274,242,599,144,187,108,439,547,262,73,27,177,204,1128
2106,Tony Mitchell,2010,2012,Alabama,SEC,89,2549,458,929,389,700,69,229,143,227,201,392,593,106,121,93,125,207,1128
2107,Tony Parker,2013,2016,UCLA,Pac-12,136,2485,456,822,456,822,0,0,216,419,275,419,694,41,56,94,159,383,1128
2108,Dana Smith,2008,2010,Longwood,Ind,72,2202,408,839,352,661,56,178,256,389,172,293,465,153,95,47,188,243,1128
2109,Miles Wright,2015,2018,Dartmouth,Ivy,111,3035,399,991,243,537,156,454,174,238,133,316,449,88,136,35,165,241,1128
2110,Jermaine Beal,2008,2010,Vanderbilt,SEC,98,3032,348,825,187,392,161,433,270,340,36,226,262,360,92,9,152,162,1127
2111,Connor Boehm,2013,2016,Dartmouth,Ivy,112,3007,457,906,407,767,50,139,163,256,224,375,599,137,54,14,193,279,1127
2112,Drew Eubanks,2016,2018,Oregon State,Pac-12,96,2715,447,747,447,747,0,0,233,336,185,445,630,87,49,163,194,270,1127
2113,Jay Harris,2011,2015,Total,Total,117,2981,338,894,168,377,170,517,281,312,55,201,256,296,92,7,243,164,1127
2114,Devin Morgan Jr.,2016,2019,Total,Total,94,2819,376,1032,160,409,216,623,159,197,59,214,273,264,83,0,171,134,1127
2115,Jaylen Nowell,2018,2019,Washington,Pac-12,70,2346,421,884,331,657,90,227,195,247,68,257,325,204,82,18,191,177,1127
2116,Anthony Smith,2008,2009,Liberty,Big South,67,2367,406,803,247,396,159,407,156,242,77,313,390,111,75,13,127,143,1127
2117,Raasean Davis,2015,2019,Total,Total,115,2319,483,744,483,743,0,1,160,246,251,412,663,33,52,87,164,225,1126
2118,Pascal Siakam,2015,2016,New Mexico State,WAC,68,2224,441,800,438,783,3,17,241,339,243,414,657,103,62,136,131,180,1126
2119,Justin Turner,2017,2019,Bowling Green State,MAC,69,2198,403,917,290,617,113,300,207,273,54,190,244,187,95,17,140,120,1126
2120,Lawrence Westbrook,2008,2010,Minnesota,Big Ten,100,2466,381,860,251,524,130,336,234,284,76,204,280,203,81,11,206,219,1126
2121,Daniel Bejarano,2011,2015,Total,Total,108,2902,374,1025,215,544,159,481,218,290,186,512,698,231,69,42,140,207,1125
2122,Austin Dahn,2008,2011,Citadel,Southern,127,3607,387,1045,144,363,243,682,108,140,80,265,345,176,64,8,233,258,1125
2123,Aaron Graham,2011,2014,Stetson,A-Sun,119,3007,348,937,142,338,206,599,223,284,71,277,348,200,115,15,238,247,1125
2124,Curtis Jerrells,2008,2009,Baylor,Big 12,71,2348,362,848,231,476,131,372,270,354,52,236,288,313,102,18,187,134,1125
2125,Bubba Parham,2018,2019,Virginia Military Institute,Southern,62,1980,355,857,181,390,174,467,241,303,22,188,210,186,44,1,165,127,1125
2126,Kenrich Williams,2015,2018,Texas Christian,Big 12,102,3281,416,860,315,591,101,269,192,307,304,573,877,271,141,71,145,253,1125
2127,Rion Brown,2011,2014,Miami (FL),ACC,136,3192,377,930,203,407,174,523,196,262,110,312,422,144,67,10,127,209,1124
2128,John Henson,2010,2012,North Carolina,ACC,109,2594,475,955,470,931,5,24,169,349,269,617,886,108,69,277,166,159,1124
2129,Isaiah Hicks,2014,2017,North Carolina,ACC,151,2442,426,743,425,737,1,6,271,374,221,325,546,100,50,79,159,370,1124
2130,Anthony Johnson,2009,2010,Montana,Big Sky,61,2023,348,700,284,544,64,156,364,417,36,146,182,185,44,9,174,106,1124
2131,Karvel Anderson,2013,2014,Robert Morris,NEC,69,1925,391,787,190,343,201,444,140,166,48,158,206,85,74,13,82,128,1123
2132,Justin Coleman,2015,2019,Total,Total,131,3506,349,971,186,450,163,521,262,322,34,239,273,489,108,0,257,186,1123
2133,Nemanja Djurisic,2012,2015,Georgia,SEC,131,3188,399,910,293,619,106,291,219,312,209,372,581,147,68,45,238,281,1123
2134,Lehmon Colbert,2008,2010,Jacksonville,A-Sun,91,2613,400,874,329,651,71,223,251,374,211,373,584,178,55,47,243,243,1122
2135,Rodney Cooper,2012,2015,Alabama,SEC,131,3514,401,988,263,545,138,443,182,245,174,334,508,161,81,32,182,314,1122
2136,Maurice Kemp,2010,2013,Total,Total,92,2258,401,818,367,695,34,123,286,387,194,350,544,132,114,72,155,192,1122
2137,Shawn Atupem,2008,2011,Mount St. Mary's,NEC,126,2895,451,858,451,857,0,1,219,372,171,282,453,108,82,44,208,348,1121
2138,Sedrick Barefield,2016,2019,Total,Total,92,2491,359,885,175,395,184,490,219,270,26,156,182,247,75,3,182,152,1121
2139,Derick Newton,2016,2017,Stetson,A-Sun,66,2073,355,783,237,496,118,287,293,357,94,288,382,87,34,23,138,114,1121
2140,James Rahon,2009,2013,Total,Total,132,3375,401,991,213,478,188,513,131,185,58,196,254,116,65,3,102,212,1121
2141,Devon Bookert,2013,2016,Florida State,ACC,131,3567,359,856,171,407,188,449,214,270,71,297,368,347,139,12,246,234,1120
2142,Sherwood Brown,2011,2013,Florida Gulf Coast,A-Sun,92,2461,406,873,257,490,149,383,159,236,142,351,493,74,102,23,125,197,1120
2143,Shawn Jones,2011,2014,Middle Tennessee,Total,131,2516,447,827,447,825,0,2,226,346,247,393,640,49,65,163,160,334,1120
2144,Will Sheehey,2011,2014,Indiana,Big Ten,130,2875,424,873,338,622,86,251,186,275,151,265,416,149,85,26,171,300,1120
2145,Melsahn Basabe,2011,2014,Iowa,Big Ten,136,2731,431,807,430,805,1,2,256,378,267,485,752,48,58,148,180,265,1119
2146,Chauncey Gilliam,2009,2013,Total,Total,124,2843,404,886,285,563,119,323,192,247,99,252,351,105,112,15,130,257,1119
2147,Nick Masterson,2015,2018,Kennesaw State,A-Sun,119,3113,398,830,181,371,217,459,106,126,71,159,230,245,75,20,132,200,1119
2148,Shayne Whittington,2010,2014,Western Michigan,MAC,114,2574,416,807,408,759,8,48,279,367,228,509,737,81,61,130,150,238,1119
2149,Darrion Allen,2014,2017,Longwood,Big South,126,3405,377,949,246,565,131,384,232,283,103,257,360,146,114,62,192,267,1117
2150,Victor Oladipo,2011,2013,Indiana,Big Ten,104,2558,406,754,358,612,48,142,257,359,207,330,537,175,161,56,203,248,1117
2151,Laquincy Rideau,2016,2019,Total,Total,100,2558,384,875,287,595,97,280,252,461,92,297,389,439,265,17,290,312,1117
2152,Talib Zanna,2010,2014,Pittsburgh,Total,135,2924,411,743,411,740,0,3,295,454,337,471,808,56,61,72,137,285,1117
2153,Michael Finke,2016,2019,Total,Total,124,2812,418,853,277,450,141,403,139,202,205,338,543,126,32,20,112,214,1116
2154,Noah Robotham,2015,2019,Total,Total,119,3696,356,906,153,359,203,547,201,264,53,223,276,446,130,6,204,196,1116
2155,Tai Webster,2014,2017,Nebraska,Big Ten,127,3295,382,922,303,639,79,283,273,382,86,335,421,288,133,23,269,286,1116
2156,Javon Bess,2015,2019,Total,Total,113,3016,342,856,250,553,92,303,339,462,157,440,597,170,105,31,135,216,1115
2157,Ned Cox,2010,2013,Evansville,MVC,126,3138,400,960,255,566,145,394,170,222,38,174,212,308,62,12,155,234,1115
2158,Spencer Dinwiddie,2012,2014,Colorado,Pac-12,86,2590,290,690,175,392,115,298,420,506,42,246,288,227,97,29,153,181,1115
2159,Max Guercy,2013,2016,Rice,CUSA,125,4035,338,893,203,465,135,428,304,366,82,274,356,503,146,2,282,244,1115
2160,A.J. Hess,2013,2017,Total,Total,124,3041,353,870,136,295,217,575,192,225,53,364,417,115,57,36,130,261,1115
2161,James Robinson,2013,2016,Pittsburgh,Total,136,4204,353,937,247,605,106,332,303,381,53,355,408,604,159,28,175,307,1115
2162,Ovie Soko,2010,2014,Total,Total,118,2891,379,806,360,726,19,80,338,523,223,451,674,124,74,62,210,334,1115
2163,Troy Williams,2014,2016,Indiana,Big Ten,99,2486,412,789,374,672,38,117,253,359,167,415,582,163,97,56,221,194,1115
2164,David Collette,2015,2018,Total,Total,87,2088,456,752,450,737,6,15,196,303,133,290,423,103,68,99,117,280,1114
2165,John Davis,2014,2017,Towson,CAA,116,2483,431,881,400,790,31,91,221,336,246,467,713,55,45,47,138,257,1114
2166,Lance Tejada,2015,2019,Total,Total,122,2654,366,936,157,410,209,526,173,250,29,186,215,247,78,3,181,244,1114
2167,Moritz Wagner,2016,2018,Michigan,Big Ten,107,2244,421,770,311,484,110,286,162,232,128,356,484,57,83,40,126,269,1114
2168,Tyler White,2013,2016,Northern Kentucky,Total,112,3084,394,1061,208,495,186,566,140,190,49,207,256,216,76,16,175,243,1114
2169,Hayden Graham,2014,2017,Air Force,MWC,108,2951,432,911,336,623,96,288,153,231,138,388,526,181,84,43,159,259,1113
2170,Stephon Jelks,2015,2018,Mercer,Southern,131,3123,390,847,264,509,126,338,207,268,252,592,844,192,80,45,146,269,1113
2171,Jake Koch,2010,2013,Northern Iowa,MVC,138,3334,325,792,202,409,123,383,340,426,147,530,677,262,118,123,222,275,1113
2172,Tasmin Mitchell,2008,2010,Louisiana State,SEC,69,2360,427,903,385,785,42,118,216,296,191,369,560,133,103,40,148,167,1112
2173,Jalen Ross,2013,2017,Total,Total,122,2920,345,921,210,531,135,390,287,380,30,265,295,233,102,3,219,167,1112
2174,Kellan Grady,2018,2019,Davidson,A-10,63,2290,413,867,282,501,131,366,154,200,35,207,242,121,58,8,82,114,1111
2175,Malik Pope,2015,2018,San Diego State,MWC,125,2732,421,910,329,669,92,241,177,260,170,466,636,122,58,113,159,209,1111
2176,Jamar Abrams,2008,2011,East Carolina,CUSA,124,3043,394,859,219,409,175,450,147,192,155,352,507,80,81,44,171,335,1110
2177,Sterling Brown,2014,2017,Southern Methodist,AAC,136,3492,394,782,266,498,128,284,194,252,190,463,653,294,139,51,210,304,1110
2178,Austin Nehls,2016,2019,Total,Total,119,3544,335,868,111,258,224,610,216,283,93,280,373,147,60,21,126,168,1110
2179,Garrett Sams,2017,2019,North Florida,A-Sun,94,2547,330,822,162,384,168,438,282,355,93,325,418,170,92,24,242,198,1110
2180,Dominique Sutton,2008,2012,Total,Total,122,3018,399,761,388,716,11,45,301,467,255,426,681,171,174,35,211,335,1110
2181,Raymond Taylor,2010,2014,Total,Total,95,2941,375,1031,204,524,171,507,189,266,47,227,274,462,134,1,245,245,1110
2182,Lawrence Johnson-Danner,2010,2014,Texas Southern,SWAC,131,3391,362,913,132,296,230,617,155,187,53,267,320,134,86,14,169,192,1109
2183,Nick McGlynn,2016,2019,Drake,MVC,127,2464,424,832,396,718,28,114,233,312,196,456,652,104,44,144,140,305,1109
2184,Brian Bennett,2013,2016,Cal Poly,Big West,125,2849,491,973,491,968,0,5,126,208,193,364,557,91,48,31,110,268,1108
2185,Lee Cummard,2008,2009,Brigham Young,MWC,68,2182,397,733,301,513,96,220,218,252,116,311,427,234,63,65,133,175,1108
2186,Braxton Ogbueze,2013,2017,Total,Total,118,3064,367,915,141,365,226,550,148,192,52,178,230,180,66,6,110,148,1108
2187,Travon Woodall,2009,2013,Pittsburgh,Big East,139,3327,374,898,227,461,147,437,213,283,36,301,337,580,116,18,276,306,1108
2188,Eric Eaves,2016,2017,South Carolina State,MEAC,65,1882,371,753,310,572,61,181,304,416,66,153,219,144,47,19,139,120,1107
2189,Stevie Jordan,2017,2019,Rider,MAAC,90,2897,397,866,313,607,84,259,229,354,86,252,338,475,145,31,284,240,1107
2190,Cady Lalanne,2012,2015,Massachusetts,A-10,111,2799,424,767,414,720,10,47,249,374,341,540,881,26,49,197,206,275,1107
2191,Colbey Ross,2018,2019,Pepperdine,WCC,66,2204,330,735,226,480,104,255,343,407,23,172,195,418,74,10,235,170,1107
2192,Dominic Calegari,2008,2010,UC-Davis,Big West,88,2273,383,798,253,467,130,331,210,282,104,295,399,143,72,63,153,243,1106
2193,Deontae Hawkins,2015,2018,Total,Total,100,2537,420,965,260,549,160,416,106,141,166,453,619,103,61,59,132,239,1106
2194,Jalen Jenkins,2014,2017,George Mason,A-10,128,3028,413,786,412,781,1,5,279,424,286,420,706,163,72,91,250,406,1106
2195,Rashad Madden,2012,2015,Arkansas,SEC,132,2997,336,782,216,429,120,353,314,390,103,304,407,369,89,30,246,261,1106
2196,Garrett Stutz,2009,2012,Wichita State,MVC,137,2330,413,802,384,703,29,99,251,331,196,428,624,98,36,101,183,317,1106
2197,Nik Cochran,2010,2013,Davidson,Southern,128,3059,296,682,141,295,155,387,358,401,63,219,282,318,80,3,180,236,1105
2198,Spencer Dixon,2010,2012,Kennesaw State,A-Sun,95,3193,386,1047,228,555,158,492,175,243,85,208,293,320,132,5,254,181,1105
2199,Dante Holmes,2012,2016,Total,Total,113,2711,391,934,245,525,146,409,177,274,96,303,399,158,115,11,189,331,1105
2200,Adam Pegg,2009,2013,Total,Total,121,2519,441,865,401,754,40,111,183,257,149,330,479,93,35,37,179,269,1105
2201,Joey Ptasinski,2012,2015,Lafayette,Patriot,119,3419,384,839,135,258,249,581,88,109,33,247,280,199,110,12,119,176,1105
2202,Matt Williams,2013,2017,Central Florida,Total,124,3115,363,950,89,210,274,740,105,136,47,292,339,138,61,6,126,185,1105
2203,Duane Wilson,2015,2018,Total,Total,117,2858,374,917,237,507,137,410,220,313,28,232,260,290,135,23,203,253,1105
2204,Kori Babineaux,2013,2016,Total,Total,82,2375,466,990,455,929,11,61,161,271,44,258,302,265,85,10,222,187,1104
2205,Courtney Pigram,2008,2009,East Tennessee State,A-Sun,66,2243,400,1012,263,595,137,417,167,228,43,174,217,247,103,10,210,144,1104
2206,Bryce Pressley,2013,2016,Portland,WCC,123,3372,388,882,233,494,155,388,173,234,124,315,439,314,117,49,163,239,1104
2207,Kareem South,2016,2019,Texas A&M-Corpus Christi,Southland,102,3016,384,925,251,560,133,365,203,247,150,278,428,168,101,7,151,231,1104
2208,Isaiah Walton,2017,2019,Longwood,Big South,72,2150,373,835,253,510,120,325,238,286,36,252,288,185,106,22,277,177,1104
2209,Paul Baxter,2013,2017,Sam Houston State,Southland,137,3501,377,905,256,558,121,347,228,339,71,296,367,362,144,37,216,389,1103
2210,Kenny Frease,2009,2012,Xavier,A-10,137,2862,453,882,451,870,2,12,195,341,198,525,723,127,43,130,210,292,1103
2211,Dario Hunt,2009,2012,Nevada,WAC,135,3655,424,828,424,828,0,0,255,464,409,623,1032,122,82,270,248,433,1103
2212,Brandon Johnson,2008,2010,San Diego,WCC,72,2415,360,919,211,494,149,425,234,325,35,219,254,251,144,2,213,135,1103
2213,Jared Maree,2009,2012,Texas-Rio Grande Valley,Total,118,3143,380,879,293,605,87,274,256,337,93,302,395,164,75,24,172,282,1103
2214,Sean Mosley,2009,2012,Maryland,ACC,132,3423,370,879,301,671,69,208,294,374,195,383,578,269,150,48,214,308,1103
2215,Donald Qualls,2008,2011,Grambling,SWAC,102,2789,347,944,146,370,201,574,208,262,43,166,209,185,103,2,190,159,1103
2216,Kris Richard,2008,2011,Tulane,CUSA,120,3212,398,995,260,562,138,433,169,250,134,338,472,223,186,50,218,267,1103
2217,Bryan Cohen,2009,2012,Bucknell,Patriot,130,3829,370,1003,233,603,137,400,225,320,113,374,487,313,75,41,288,352,1102
2218,Nathan Hoover,2017,2019,Wofford,Southern,102,2745,363,852,148,333,215,519,161,186,46,208,254,116,49,5,94,134,1102
2219,Jazz Johnson,2016,2019,Total,Total,98,2629,368,818,203,427,165,391,201,249,26,163,189,163,65,5,145,209,1102
2220,Jontrell Walker,2015,2019,Total,Total,100,2379,334,872,169,380,165,492,269,313,35,132,167,163,76,8,194,171,1102
2221,Luke Doyle,2014,2018,Total,Total,127,3111,390,962,157,311,233,651,88,118,47,304,351,177,88,15,113,199,1101
2222,Ethan Telfair,2016,2017,Idaho State,Big Sky,59,2121,325,879,220,583,105,296,346,419,48,196,244,301,130,10,208,138,1101
2223,Demetrius Treadwell,2012,2015,Akron,MAC,97,2554,424,875,423,862,1,13,252,454,274,432,706,143,76,59,194,173,1101
2224,Kyron Cartwright,2015,2018,Providence,Big East,136,3638,389,959,296,690,93,269,229,315,46,299,345,646,134,6,278,244,1100
2225,Joseph Chartouny,2016,2019,Total,Total,118,3366,352,898,210,471,142,427,254,348,53,444,497,505,272,18,274,238,1100
2226,Keron DeShields,2012,2016,Total,Total,118,2741,374,860,265,548,109,312,243,328,24,223,247,233,103,12,148,236,1100
2227,Donte Grantham,2015,2018,Clemson,ACC,114,3448,402,972,241,488,161,484,135,186,155,387,542,220,98,84,169,189,1100
2228,Rob Lewis,2008,2012,Denver,Sun Belt,118,2731,379,724,308,517,71,207,271,369,99,393,492,204,59,51,239,374,1100
2229,Skylar Mays,2017,2019,Louisiana State,SEC,99,2896,351,824,228,450,123,374,275,327,47,268,315,282,158,18,168,169,1100
2230,Aaron Parks,2014,2017,Cal State Northridge,Big West,111,2889,327,875,299,764,28,111,418,556,76,285,361,205,121,14,202,313,1100
2231,Antonio Pena,2008,2011,Villanova,Big East,138,3236,410,801,406,785,4,16,276,399,251,519,770,152,95,67,230,342,1100
2232,Michael Qualls,2013,2015,Arkansas,SEC,100,2379,364,851,261,539,103,312,269,372,143,302,445,147,86,55,133,135,1100
2233,Lagerald Vick,2016,2019,Kansas,Big 12,117,3017,416,875,249,463,167,412,101,137,85,325,410,168,85,34,168,168,1100
2234,Ronrico White,2012,2015,Chattanooga,Southern,120,2910,304,822,148,375,156,447,336,429,42,256,298,285,93,5,176,191,1100
2235,Nick Williams,2009,2013,Total,Total,133,3598,423,1012,327,701,96,311,158,210,140,342,482,157,96,12,172,251,1100
2236,Zahir Carrington,2008,2010,Lehigh,Patriot,88,2448,404,824,404,823,0,1,291,470,199,368,567,94,73,92,227,292,1099
2237,Travis Leslie,2009,2011,Georgia,SEC,90,2345,417,866,398,809,19,57,246,331,242,309,551,191,101,63,180,159,1099
2238,Danny Sumner,2008,2010,William & Mary,CAA,96,2710,404,943,272,546,132,397,159,275,123,255,378,100,54,53,146,143,1099
2239,Marqueze Coleman,2013,2016,Nevada,MWC,122,2694,333,837,280,651,53,186,379,505,55,267,322,226,104,16,226,280,1098
2240,Adam Koch,2008,2010,Northern Iowa,MVC,101,2675,320,666,276,526,44,140,414,522,150,378,528,168,58,32,202,240,1098
2241,Makai Mason,2015,2019,Total,Total,90,2496,360,859,226,489,134,370,244,310,39,182,221,259,58,4,195,161,1098
2242,Dexter McClanahan,2016,2018,Savannah State,MEAC,92,2211,359,853,205,374,154,479,226,321,69,258,327,154,89,15,145,154,1098
2243,Vlad Moldoveanu,2008,2011,Total,Total,90,2145,354,812,239,491,115,321,275,337,105,310,415,117,31,39,129,206,1098
2244,Brandon Peterson,2010,2013,Arkansas State,Sun Belt,127,3676,380,811,377,797,3,14,335,514,308,578,886,134,75,163,228,283,1098
2245,Matt Farrell,2015,2018,Notre Dame,ACC,110,2785,366,870,175,377,191,493,174,214,21,153,174,417,90,7,185,145,1097
2246,Markus Kennedy,2012,2016,Total,Total,120,2579,446,855,442,841,4,14,201,349,247,478,725,167,127,111,185,268,1097
2247,Dupree McBrayer,2016,2019,Minnesota,Big Ten,123,3451,354,938,228,547,126,391,263,383,30,234,264,332,117,25,159,214,1097
2248,Isaiah Miles,2013,2016,Saint Joseph's,A-10,107,2529,375,810,238,434,137,376,210,250,170,335,505,69,45,75,113,252,1097
2249,Brian Beard Jr.,2018,2019,Florida International,CUSA,65,2202,352,880,262,547,90,333,302,443,27,206,233,379,190,2,218,150,1096
2250,Michael Hunter,2008,2010,UC-Irvine,Big West,96,2754,361,862,158,329,203,533,171,208,35,175,210,225,128,7,202,174,1096
2251,Austin Loop,2014,2017,Marshall,CUSA,113,3155,337,793,44,79,293,714,129,149,56,146,202,105,84,23,65,178,1096
2252,Avery Moore,2011,2015,Total,Total,117,2783,363,1027,118,277,245,750,125,153,39,165,204,175,117,4,178,158,1096
2253,Will Darley,2014,2017,Maryland-Baltimore County,AEC,107,2746,378,798,220,414,158,384,181,217,74,279,353,155,45,18,172,173,1095
2254,Terrance Henry,2009,2012,Mississippi,SEC,132,3165,390,826,331,647,59,179,256,354,157,430,587,153,61,113,265,333,1095
2255,Ronnie Moss,2009,2011,Texas Christian,MWC,82,2459,388,939,267,602,121,337,198,279,41,208,249,323,62,9,262,187,1095
2256,Martin Smith,2012,2015,Lipscomb,A-Sun,104,2873,344,856,202,434,142,422,265,337,105,262,367,177,90,25,172,174,1095
2257,Ryan Weber,2013,2017,Total,Total,125,3090,350,829,137,267,213,562,182,224,96,308,404,173,81,28,173,208,1095
2258,Matthew Wilson,2017,2019,Army,Patriot,94,2122,465,771,465,771,0,0,165,292,159,445,604,40,23,21,144,215,1095
2259,Adjehi Baru,2012,2015,College of Charleston,Total,128,3606,393,797,393,797,0,0,308,521,314,602,916,98,71,126,200,368,1094
2260,Jarrett Culver,2018,2019,Texas Tech,Big 12,73,2138,391,836,288,540,103,296,209,304,88,318,406,201,94,46,154,144,1094
2261,Andy Diaz,2010,2013,North Florida,A-Sun,124,2666,460,844,460,841,0,3,174,425,251,326,577,95,102,98,283,378,1094
2262,Tilman Dunbar,2013,2016,Navy,Patriot,106,3240,379,926,353,843,26,83,310,450,39,216,255,434,103,2,259,225,1094
2263,Grayson Flittner,2008,2010,Gardner-Webb,Total,84,2495,334,867,96,247,238,620,188,233,51,168,219,274,98,4,167,144,1094
2264,Marques Oliver,2010,2013,Delaware State,MEAC,119,3212,401,771,399,758,2,13,290,430,283,434,717,123,159,222,214,344,1094
2265,Jeremy Allen,2008,2012,Total,Total,118,3076,372,939,255,578,117,361,232,293,144,173,317,125,180,13,206,317,1093
2266,Ryley Beaumont,2011,2014,Elon,Southern,127,3354,436,969,363,727,73,242,148,231,174,525,699,175,59,38,191,322,1093
2267,Denis Clemente,2009,2010,Kansas State,Big 12,69,2236,380,938,233,519,147,419,186,242,43,123,166,266,67,4,156,154,1093
2268,Jeremiah Samarrippas,2011,2014,Total,Total,128,3947,375,971,196,456,179,515,164,200,44,233,277,531,175,3,352,262,1093
2269,Mike Williams,2015,2018,Rutgers,Big Ten,119,2958,376,1008,243,541,133,467,208,269,165,281,446,130,105,53,132,246,1093
2270,Mo Alie-Cox,2014,2017,Virginia Commonwealth,A-10,142,3322,405,705,404,704,1,1,281,409,335,328,663,112,88,255,162,309,1092
2271,Matt Bohannon,2013,2016,Northern Iowa,MVC,138,3837,351,846,83,156,268,690,122,156,8,373,381,115,85,4,74,244,1092
2272,Paul Noonan,2008,2011,Boise State,WAC,130,2886,342,807,131,245,211,562,197,234,61,315,376,192,85,24,168,227,1092
2273,James Batemon,2018,2019,Loyola Marymount,WCC,64,2251,341,763,255,502,86,261,323,398,53,161,214,261,89,2,190,161,1091
2274,DaQuan Bracey,2017,2019,Louisiana Tech,CUSA,89,2510,400,908,304,623,96,285,195,305,66,168,234,420,94,7,183,175,1091
2275,Denzel Mahoney,2017,2018,Southeast Missouri State,OVC,64,1946,328,719,207,413,121,306,314,380,92,206,298,79,51,9,96,197,1091
2276,Anthony Stitt,2012,2015,College of Charleston,Total,111,3570,381,1004,215,544,166,460,163,263,54,220,274,309,95,14,240,204,1091
2277,Alex Caruso,2013,2016,Texas A&M,SEC,137,3933,382,840,291,572,91,268,235,343,104,409,513,649,276,59,346,343,1090
2278,Raymond Cowels,2010,2013,Santa Clara,WCC,137,3157,363,949,144,365,219,584,145,181,139,267,406,113,118,24,131,280,1090
2279,Nate Hutcheson,2010,2013,Western Michigan,MAC,135,3277,358,896,239,502,119,394,255,355,160,399,559,144,68,71,230,341,1090
2280,Dainan Swoope,2016,2019,Elon,CAA,101,2911,332,888,139,326,193,562,233,308,49,250,299,286,91,13,171,199,1090
2281,Brad Wanamaker,2008,2011,Pittsburgh,Big East,134,3153,356,815,289,620,67,195,311,431,126,398,524,454,130,33,257,285,1090
2282,Richaun Holmes,2013,2015,Bowling Green State,MAC,95,2518,403,728,373,643,30,85,253,363,250,402,652,62,75,244,143,233,1089
2283,Marcus Johnson,2008,2010,Dayton,A-10,105,2892,386,850,294,573,92,277,225,330,102,300,402,154,84,37,159,225,1089
2284,Ahmad Nivins,2008,2009,Saint Joseph's,A-10,65,2371,370,590,370,589,0,1,349,455,199,372,571,48,48,95,163,163,1089
2285,Martiz Washington,2009,2012,Longwood,Ind,124,2982,372,986,97,260,275,726,70,124,57,206,263,213,101,1,140,259,1089
2286,Tramaine Butler,2008,2012,Alabama State,SWAC,120,2847,376,984,266,610,110,374,226,433,167,285,452,191,168,24,217,319,1088
2287,Clide Geffrard,2013,2016,Total,Total,99,2244,372,771,258,462,114,309,230,322,153,283,436,105,73,51,159,215,1088
2288,Landon Milbourne,2008,2010,Maryland,ACC,101,2806,421,879,379,765,42,114,204,260,212,248,460,70,96,98,154,268,1088
2289,Brian Pegg,2013,2017,Stetson,A-Sun,113,2936,446,855,440,830,6,25,190,361,268,496,764,116,84,58,209,261,1088
2290,Erik Rush,2009,2011,Montana State,Big Sky,91,2754,351,837,275,590,76,247,310,442,111,275,386,217,96,32,210,220,1088
2291,Blake Simmons,2014,2018,Evansville,MVC,134,4198,379,879,234,475,145,404,185,239,52,324,376,326,100,37,201,253,1088
2292,Desmond Williams,2017,2018,Florida A&M,MEAC,63,2148,403,881,392,835,11,46,271,394,105,280,385,108,69,60,163,136,1088
2293,Jaylen Barford,2017,2018,Arkansas,SEC,71,2007,398,874,282,564,116,310,175,238,74,199,273,161,79,16,137,169,1087
2294,Devin Carter,2014,2017,Total,Total,76,2259,368,838,177,363,191,475,160,225,56,205,261,89,54,15,102,172,1087
2295,Eric Carter,2015,2019,Delaware,CAA,118,2807,402,722,400,715,2,7,281,411,233,585,818,184,53,67,209,323,1087
2296,Chris Flemmings,2016,2017,North Carolina-Wilmington,CAA,68,2268,373,762,246,406,127,356,214,270,83,305,388,128,93,49,120,136,1087
2297,Scottie Haralson,2009,2013,Total,Total,113,3131,363,948,108,271,255,677,106,128,93,220,313,136,41,22,120,150,1087
2298,DeAndre Haywood,2014,2017,Delaware State,MEAC,124,2709,378,872,308,637,70,235,261,418,82,216,298,207,129,11,222,237,1087
2299,Kasey Hill,2014,2017,Florida,SEC,137,3600,390,988,349,816,41,172,266,446,49,279,328,530,182,29,304,304,1087
2300,Tyler Laser,2008,2011,Eastern Illinois,OVC,98,2881,370,858,205,417,165,441,182,209,36,214,250,228,73,6,204,179,1087
2301,Dikymbe Martin,2017,2019,UC-Riverside,Big West,87,2642,398,886,271,585,127,301,164,193,33,211,244,232,96,4,177,170,1087
2302,Tshilidzi Nephawe,2011,2015,New Mexico State,WAC,136,2979,359,692,359,691,0,1,369,550,273,502,775,67,45,135,216,409,1087
2303,Ryan Spangler,2012,2016,Total,Total,127,3414,420,739,375,607,45,132,202,310,306,675,981,167,60,90,153,276,1087
2304,Jordan Dartis,2016,2018,Ohio,MAC,92,2983,339,754,108,235,231,519,177,203,20,261,281,158,97,12,103,170,1086
2305,Corey Davis Jr.,2018,2019,Houston,AAC,72,2278,350,815,136,279,214,536,172,203,49,181,230,187,69,4,103,134,1086
2306,Andrew Fitzgerald,2010,2013,Oklahoma,Big 12,121,2763,433,913,433,911,0,2,220,311,209,263,472,66,76,55,149,307,1086
2307,Sabri Thompson,2014,2017,Northwestern State,Southland,119,2649,362,883,169,399,193,484,169,225,112,250,362,179,82,24,168,194,1086
2308,Taylor Barnette,2013,2017,Total,Total,120,3130,360,897,120,215,240,682,125,162,23,229,252,181,52,11,98,178,1085
2309,Hakeem Baxter,2014,2017,Total,Total,128,3352,321,794,260,590,61,204,382,499,87,314,401,224,85,29,208,251,1085
2310,Connor Cashaw,2016,2019,Total,Total,130,3253,384,907,245,520,139,387,178,267,132,469,601,224,116,11,173,218,1085
2311,Evan Fjeld,2008,2011,Vermont,AEC,119,2711,439,807,435,787,4,20,203,293,192,370,562,94,61,131,140,312,1085
2312,Jalone Friday,2017,2019,Abilene Christian,Southland,81,1779,397,827,286,536,111,291,180,234,104,307,411,47,38,106,140,278,1085
2313,Dylan Frye,2017,2019,Bowling Green State,MAC,97,2688,385,945,202,446,183,499,132,187,34,216,250,194,77,9,156,219,1085
2314,Nick King,2014,2018,Total,Total,102,2080,400,845,344,684,56,161,229,348,179,365,544,108,62,28,148,129,1085
2315,Charles Mitchell,2013,2016,Total,ACC,137,2786,462,893,462,893,0,0,161,298,406,568,974,59,54,59,227,330,1085
2316,Cedric Blossom,2013,2016,Morgan State,MEAC,111,2886,403,879,397,848,6,31,272,414,255,345,600,76,72,17,126,228,1084
2317,Taariq Cephas,2012,2015,Coppin State,MEAC,124,3460,366,921,214,501,152,420,200,280,91,274,365,451,149,2,290,227,1084
2318,Lamontray Harris,2016,2019,Morehead State,OVC,119,2311,415,870,351,656,64,214,190,240,199,419,618,119,46,52,191,280,1084
2319,Gabas Maldunas,2012,2015,Dartmouth,Ivy,102,2761,431,908,430,899,1,9,221,373,234,498,732,153,100,161,225,313,1084
2320,A.J. Merriweather,2014,2017,East Tennessee State,Total,121,2935,384,778,315,618,69,160,247,344,185,418,603,151,160,21,217,292,1084
2321,Marc Eddy Norelia,2013,2017,Total,Total,101,2402,430,804,429,797,1,7,223,343,197,417,614,102,66,49,134,170,1084
2322,Emmanuel Nzekwesi,2017,2019,Oral Roberts,Summit,88,2414,439,918,395,751,44,167,162,241,205,437,642,121,74,57,168,205,1084
2323,Jordan Walker,2017,2019,Morehead State,OVC,92,2530,349,838,196,450,153,388,233,301,65,196,261,199,91,14,171,228,1084
2324,Tony Crocker,2008,2010,Oklahoma,Big 12,101,3081,362,872,199,430,163,442,196,264,125,306,431,169,97,28,178,232,1083
2325,Grant Golden,2017,2019,Richmond,A-10,74,2084,436,877,397,738,39,139,172,271,78,388,466,194,34,76,167,149,1083
2326,Mitchell Hahn,2015,2019,Total,Total,101,2600,363,838,205,414,158,424,198,249,91,400,491,126,63,46,114,179,1082
2327,Jaleel Hogan,2015,2018,Detroit Mercy,Horizon,111,2246,425,722,425,721,0,1,232,435,205,237,442,79,47,68,174,372,1082
2328,Zack Novak,2009,2012,Michigan,Big Ten,134,4357,353,876,140,285,213,591,163,209,148,461,609,215,94,17,114,342,1082
2329,Sterling Smith,2013,2016,Total,Total,126,3166,367,850,172,352,195,498,153,197,129,378,507,166,123,35,126,134,1082
2330,Mike Wilder,2010,2013,UC-Irvine,Big West,126,3473,330,865,106,233,224,632,198,285,125,471,596,272,88,20,176,303,1082
2331,Jashaun Agosto,2017,2019,Long Island University,NEC,96,3340,370,929,265,595,105,334,236,327,41,259,300,391,71,13,238,242,1081
2332,Julian DeBose,2012,2016,Total,Total,128,3284,410,949,305,630,105,319,156,236,106,299,405,148,128,52,161,267,1081
2333,Eugene Harvey,2008,2010,Seton Hall,Big East,94,3044,369,831,336,696,33,135,310,409,91,186,277,453,153,5,281,193,1081
2334,T.J. Holyfield,2016,2018,Stephen F. Austin,Southland,101,2512,402,753,338,583,64,170,213,283,212,383,595,101,96,133,235,332,1081
2335,Hamidu Rahman,2009,2012,New Mexico State,WAC,124,2691,386,699,386,699,0,0,309,593,336,402,738,48,42,137,226,319,1081
2336,Cameron Tatum,2008,2012,Tennessee,SEC,138,3039,368,921,213,445,155,476,190,286,84,317,401,232,97,27,194,235,1081
2337,Rayjon Tucker,2016,2019,Total,Total,98,2368,334,661,219,383,115,278,298,394,70,333,403,113,67,28,151,192,1081
2338,Evan Boudreaux,2016,2019,Total,Total,79,2070,366,818,292,618,74,200,274,359,158,429,587,72,48,23,165,165,1080
2339,Louis Dale,2008,2010,Cornell,Ivy,82,2298,367,799,247,484,120,315,226,262,69,242,311,366,104,16,211,213,1080
2340,Eric Mika,2014,2017,Brigham Young,WCC,67,1816,372,705,372,704,0,1,336,475,197,326,523,88,34,87,133,199,1080
2341,Kenneth Ortiz,2010,2014,Total,Total,119,3077,353,881,335,809,18,72,356,519,126,311,437,451,182,12,318,263,1080
2342,Johnathan Stove,2015,2018,Louisiana,Sun Belt,131,2939,362,776,312,627,50,149,306,397,155,255,410,220,46,40,182,345,1080
2343,Malcolm Duvivier,2014,2018,Total,Total,127,3296,371,953,210,509,161,444,176,263,47,224,271,289,80,15,255,272,1079
2344,Caleb Homesley,2016,2019,Liberty,Total,113,2610,406,863,277,469,129,394,138,210,59,473,532,234,89,55,159,243,1079
2345,Amile Jefferson,2013,2017,Duke,ACC,150,3344,426,687,426,687,0,0,227,395,361,583,944,142,90,137,140,338,1079
2346,Josh Reaves,2016,2019,Penn State,Big Ten,121,3482,406,925,297,589,109,336,158,225,180,360,540,310,250,91,217,355,1079
2347,Mike Rose,2008,2009,Eastern Kentucky,OVC,61,2219,375,840,216,459,159,381,170,218,111,185,296,144,107,9,144,82,1079
2348,Derek Thompson,2010,2013,Total,Total,118,2541,363,989,137,360,226,629,127,178,43,203,246,122,64,8,138,183,1079
2349,Brandon Edwards,2011,2014,Texas-Arlington,Total,126,3007,387,705,335,549,52,156,252,341,320,532,852,75,71,132,126,277,1078
2350,Tre'Shaun Fletcher,2014,2018,Total,Total,121,2568,365,825,254,509,111,316,237,322,124,338,462,219,55,20,174,217,1078
2351,Gary Flowers,2010,2011,Southern Mississippi,CUSA,64,1999,422,897,347,698,75,199,159,228,161,352,513,78,59,104,157,175,1078
2352,Yolonzo Moore,2012,2015,Hartford,AEC,125,3945,349,846,219,443,130,403,250,340,59,351,410,289,140,6,255,232,1078
2353,Sir'Dominic Pointer,2012,2015,St. John's (NY),Big East,130,3660,406,852,385,743,21,109,245,360,161,520,681,299,200,173,218,367,1078
2354,Garrett Sim,2009,2012,Oregon,Total,136,3320,368,884,183,394,185,490,157,192,74,208,282,256,103,16,183,204,1078
2355,Jordan Swopshire,2014,2018,Total,Total,121,2622,342,815,128,273,214,542,180,240,93,374,467,110,52,25,158,181,1078
2356,MaCio Teague,2017,2018,North Carolina-Asheville,Big South,67,2324,350,794,183,412,167,382,211,241,35,265,300,175,90,11,101,103,1078
2357,Glenn Cosey,2013,2014,Eastern Kentucky,OVC,63,2260,328,765,133,297,195,468,226,272,31,173,204,235,89,2,102,111,1077
2358,Tyler Hooker,2017,2019,Kennesaw State,A-Sun,88,2415,367,929,305,698,62,231,281,381,46,232,278,231,106,15,204,179,1077
2359,Bryant Mbamalu,2011,2014,Louisiana,Sun Belt,113,2949,385,878,283,581,102,297,205,286,144,265,409,119,82,6,183,290,1077
2360,Ben Mockford,2010,2014,Total,Total,108,2752,355,927,95,239,260,688,107,137,12,140,152,96,43,4,97,122,1077
2361,Kourtney Roberson,2011,2015,Texas A&M,Total,142,3011,435,718,435,718,0,0,207,359,323,510,833,96,78,71,153,280,1077
2362,Jherrod Stiggers,2013,2015,Houston,Total,97,2571,351,928,108,249,243,679,132,183,65,220,285,142,76,19,167,157,1077
2363,Jamil Wilson,2010,2014,Total,Total,127,3067,397,908,310,649,87,259,196,277,186,398,584,205,76,105,175,328,1077
2364,Austin Dufault,2009,2012,Colorado,Total,136,3439,410,866,353,681,57,185,199,304,169,360,529,118,76,44,143,373,1076
2365,Roman Martinez,2008,2010,New Mexico,MWC,102,2965,366,810,169,336,197,474,147,203,203,349,552,165,119,35,112,265,1076
2366,Alex Zampier,2008,2010,Yale,Ivy,84,2239,349,868,223,477,126,391,252,305,28,189,217,177,150,20,198,171,1076
2367,Aly Ahmed,2014,2016,Cal State Bakersfield,WAC,88,2411,409,852,406,843,3,9,254,364,186,402,588,94,43,79,193,254,1075
2368,Ryan Bacon,2008,2011,Saint Peter's,MAAC,114,2960,423,814,423,810,0,4,229,361,367,452,819,122,103,209,245,309,1075
2369,Shannon Bogues,2018,2019,Stephen F. Austin,Southland,65,1925,379,822,269,518,110,304,207,262,37,138,175,156,82,14,144,84,1075
2370,Randell Daigle,2008,2011,Louisiana,Sun Belt,108,2962,364,920,137,324,227,596,120,155,47,227,274,256,113,5,197,204,1075
2371,Josh Gasser,2011,2015,Wisconsin,Big Ten,148,4774,313,693,156,302,157,391,292,349,123,452,575,284,97,19,126,333,1075
2372,Josh Mayo,2008,2009,Illinois-Chicago,Horizon,63,2131,334,786,168,400,166,386,241,283,35,130,165,208,74,1,156,113,1075
2373,Stephen McDowell,2008,2009,Chattanooga,Southern,66,2194,344,847,101,236,243,611,144,183,53,131,184,92,72,0,114,105,1075
2374,Rashad Whack,2010,2014,Total,Total,105,2269,345,851,174,369,171,482,214,274,75,223,298,103,127,19,133,169,1075
2375,Jon Brockman,2008,2009,Washington,Pac-10,66,2045,427,803,427,802,0,1,220,378,285,476,761,74,52,11,141,196,1074
2376,Luke Nevill,2008,2009,Utah,MWC,67,2036,392,688,392,688,0,0,290,383,140,389,529,87,32,145,155,180,1074
2377,Stanley Robinson,2008,2010,Connecticut,Big East,95,2774,436,868,378,699,58,169,144,224,220,420,640,106,65,113,168,164,1074
2378,Tarin Smith,2015,2019,Total,Total,128,3282,382,928,307,664,75,264,235,365,62,293,355,303,119,48,204,201,1074
2379,Zac Cuthbertson,2018,2019,Coastal Carolina,Sun Belt,65,2000,341,723,268,507,73,216,318,409,133,354,487,129,61,37,152,188,1073
2380,Steve Forbes,2011,2015,Total,Total,95,2037,393,686,392,685,1,1,286,407,218,277,495,62,46,62,181,296,1073
2381,Jaron Hopkins,2014,2018,Total,Total,125,3005,430,916,379,750,51,166,162,290,111,408,519,274,165,24,253,292,1073
2382,Jason Washburn,2010,2013,Utah,Total,123,2756,441,780,437,771,4,9,187,236,188,432,620,63,45,155,143,281,1073
2383,Matthew Wright,2011,2014,St. Bonaventure,A-10,121,3111,352,890,196,422,156,468,213,254,68,212,280,292,112,16,210,217,1073
2384,Mike Gesell,2013,2016,Iowa,Big Ten,134,3490,384,973,290,671,94,302,210,290,51,274,325,557,160,24,227,254,1072
2385,Blake Hamilton,2013,2017,Total,Total,84,2048,364,838,249,524,115,314,229,308,76,387,463,233,86,29,226,209,1072
2386,Payton Henson,2014,2018,Total,Total,129,2975,374,842,291,576,83,266,241,314,177,381,558,124,51,40,151,204,1072
2387,Duncan Robinson,2016,2018,Michigan,Big Ten,115,2863,357,785,120,220,237,565,121,140,52,240,292,142,65,33,80,250,1072
2388,Jamarr Sanders,2008,2011,Total,Total,96,2789,381,924,198,436,183,488,127,166,90,305,395,195,87,26,191,136,1072
2389,Ivy Smith Jr.,2017,2019,Grambling,SWAC,95,2438,306,780,253,606,53,174,407,505,52,220,272,362,150,15,255,199,1072
2390,Malcolm Armstead,2010,2013,Total,Total,109,3172,411,972,299,639,112,333,137,184,79,265,344,462,230,5,272,263,1071
2391,Badou Diagne,2013,2016,Coastal Carolina,Big South,125,3102,386,843,288,553,98,290,201,313,216,573,789,97,78,99,206,321,1071
2392,Tommy Freeman,2008,2011,Ohio,MAC,133,3117,315,723,56,139,259,584,182,219,41,182,223,134,69,8,119,274,1071
2393,Jordan Hill,2008,2009,Arizona,Pac-10,68,2214,436,766,436,766,0,0,199,299,227,418,645,77,47,114,169,207,1071
2394,Justinian Jessup,2017,2019,Boise State,MWC,97,2867,371,853,144,303,227,550,102,134,42,347,389,189,107,46,125,207,1071
2395,Cameron Oliver,2016,2017,Nevada,MWC,73,2233,403,830,317,597,86,233,179,264,160,489,649,94,52,190,162,217,1071
2396,Ghiavonni Robinson,2014,2017,Arkansas-Pine Bluff,SWAC,123,3407,363,1059,168,421,195,638,150,224,71,282,353,167,138,13,223,245,1071
2397,Candon Rusin,2010,2014,Total,Total,124,3148,371,894,183,389,188,505,141,203,35,148,183,84,62,7,214,257,1071
2398,Andre Smith,2012,2015,Winthrop,Big South,125,3258,348,930,134,349,214,581,161,205,28,260,288,322,121,9,185,203,1071
2399,Ben Stywall,2008,2010,North Carolina-Greensboro,Southern,92,2945,383,769,372,717,11,52,294,461,299,466,765,121,113,54,191,208,1071
2400,Tahjai Teague,2017,2019,Ball State,MAC,98,2376,416,781,380,646,36,135,203,313,170,508,678,108,121,88,168,268,1071
2401,Malik Cook,2008,2012,Total,Total,128,3044,368,803,310,628,58,175,276,362,274,371,645,119,169,72,187,281,1070
2402,Zack Denny,2014,2017,Bowling Green State,MAC,101,2699,378,918,233,519,145,399,169,220,115,418,533,94,155,21,124,180,1070
2403,Caris LeVert,2013,2016,Michigan,Big Ten,103,2721,366,843,232,509,134,334,204,265,39,325,364,275,97,22,136,151,1070
2404,Daryl Macon,2017,2018,Arkansas,SEC,71,1990,315,700,165,330,150,370,290,333,32,164,196,218,77,4,128,127,1070
2405,Jordan Washington,2016,2017,Iona,MAAC,66,1339,400,747,399,743,1,4,269,416,178,285,463,33,46,32,144,238,1070
2406,Ryan Watkins,2011,2014,Boise State,Total,130,2651,409,745,408,742,1,3,251,346,377,437,814,72,80,69,122,337,1070
2407,Gary Winston,2012,2015,Portland State,Big Sky,113,3122,372,877,199,477,173,400,153,196,22,211,233,298,69,4,211,193,1070
2408,Henry Caruso,2014,2018,Total,Total,105,2535,355,705,272,496,83,209,276,350,162,359,521,128,90,10,143,154,1069
2409,Sayeed Pridgett,2017,2019,Montana,Big Sky,100,2420,452,835,428,767,24,68,141,213,114,323,437,165,96,47,195,278,1069
2410,Drew Valentine,2010,2013,Oakland,Summit,136,3494,396,779,303,517,93,262,184,276,232,480,712,241,148,19,237,281,1069
2411,Josh Davis,2008,2011,Samford,Total,123,3052,344,819,116,195,228,624,152,190,76,280,356,141,91,7,138,177,1068
2412,Brad Loesing,2009,2012,Wofford,Southern,132,3992,372,900,254,558,118,342,206,260,56,213,269,483,113,8,304,323,1068
2413,Mike Trimboli,2008,2009,Vermont,AEC,63,2260,349,781,237,469,112,312,258,311,58,173,231,292,104,8,201,158,1068
2414,Darren White,2010,2013,Total,Total,76,2295,394,805,307,539,87,266,193,299,150,235,385,118,77,48,163,167,1068
2415,Mouphtaou Yarou,2010,2013,Villanova,Big East,120,2946,384,784,383,782,1,2,299,421,311,525,836,72,56,101,163,284,1068
2416,Ricky Franklin,2008,2010,Milwaukee,Horizon,94,2998,353,907,184,429,169,478,192,272,89,301,390,283,83,19,197,258,1067
2417,Mychal Ladd,2009,2013,Total,Total,118,3226,380,885,243,505,137,380,170,260,166,306,472,178,85,18,145,223,1067
2418,Obi Okolie,2016,2019,Brown,Ivy,105,2943,364,799,269,546,95,253,244,350,97,327,424,156,73,16,156,179,1067
2419,Chris Singletary,2008,2010,Kent State,MAC,93,2339,361,771,315,627,46,144,299,459,124,249,373,273,163,21,224,312,1067
2420,Ivo Baltic,2010,2013,Ohio,MAC,143,3197,441,898,426,847,15,51,169,271,185,481,666,177,113,49,246,330,1066
2421,John Cantrell,2008,2009,Chicago State,Ind,60,1982,428,837,382,699,46,138,164,233,103,184,287,129,122,20,132,118,1066
2422,Terrell Stoglin,2011,2012,Maryland,ACC,65,1755,351,818,227,489,124,329,240,300,25,128,153,170,48,6,146,123,1066
2423,Thatch Unruh,2015,2019,Central Arkansas,Southland,126,2898,347,858,161,306,186,552,186,234,66,300,366,217,87,11,194,268,1066
2424,Troy Gillenwater,2009,2011,New Mexico State,WAC,70,1813,372,763,314,600,58,163,263,351,103,285,388,55,39,82,133,189,1065
2425,Javonte Maynor,2011,2015,Total,Total,125,3330,343,904,72,184,271,720,108,163,62,123,185,107,106,9,111,298,1065
2426,Demetre Rivers,2015,2018,Mercer,Southern,121,2794,369,789,243,435,126,354,201,233,110,205,315,103,43,26,174,184,1065
2427,Gary Wilkinson,2008,2009,Utah State,WAC,70,2098,387,665,372,614,15,51,276,336,132,352,484,85,32,35,117,134,1065
2428,Malik Benlevi,2016,2019,Georgia State,Sun Belt,130,3417,376,820,195,366,181,454,131,197,158,434,592,128,134,98,92,295,1064
2429,Godwin Boahen,2017,2019,Illinois-Chicago,Horizon,97,2682,354,802,158,317,196,485,160,206,55,265,320,275,104,20,208,259,1064
2430,J'Nathan Bullock,2008,2009,Cleveland State,Horizon,71,2210,357,819,296,625,61,194,289,383,146,341,487,89,65,20,138,157,1064
2431,Brekkott Chapman,2015,2019,Total,Total,131,2718,375,803,237,470,138,333,176,242,122,501,623,151,87,135,186,337,1064
2432,Jeremy Harris,2018,2019,Buffalo,MAC,72,2321,398,896,244,446,154,450,114,151,96,339,435,185,76,51,102,130,1064
2433,Terrence Jones,2011,2012,Kentucky,SEC,76,2311,383,820,341,692,42,128,256,401,188,420,608,111,92,140,137,182,1064
2434,Raijon Kelly,2012,2014,Samford,Southern,95,2795,394,889,270,548,124,341,152,192,47,198,245,303,79,8,213,214,1064
2435,Marcus Smart,2013,2014,Oklahoma State,Big 12,64,2120,314,760,227,465,87,295,349,465,94,281,375,287,188,40,193,183,1064
2436,Alzee Williams,2010,2014,North Texas,Total,124,3137,381,858,364,781,17,77,285,381,113,190,303,144,60,10,125,117,1064
2437,Jeremy Chappell,2008,2009,Robert Morris,NEC,67,2176,403,835,257,448,146,387,111,138,101,273,374,188,166,37,161,163,1063
2438,Richaud Gittens,2014,2018,Total,Total,135,3482,356,858,219,491,137,367,214,301,88,366,454,262,118,17,212,285,1063
2439,Nikola Jovanovic,2014,2016,Southern California,Pac-12,98,2440,406,783,388,724,18,59,233,347,201,401,602,43,32,59,162,244,1063
2440,Kyle Roemer,2008,2010,Colgate,Patriot,61,2058,362,860,204,448,158,412,181,234,76,231,307,89,85,11,158,143,1063
2441,Michael Sparks,2009,2012,Virginia Military Institute,Big South,124,2711,330,842,103,202,227,640,176,254,120,210,330,95,90,12,108,152,1063
2442,Isiah Williams,2011,2012,Utah Valley,GWC,63,2022,354,904,189,434,165,470,190,224,24,148,172,129,41,7,132,118,1063
2443,Jimmy Baron,2008,2009,Rhode Island,A-10,67,2039,349,777,132,273,217,504,147,163,57,102,159,129,41,5,82,101,1062
2444,Will Barton,2011,2012,Memphis,CUSA,70,2306,397,842,321,588,76,254,192,262,119,333,452,201,104,42,164,154,1062
2445,Marvin Clark,2015,2019,Total,Total,136,2773,367,817,198,367,169,450,159,202,117,385,502,97,85,49,155,353,1062
2446,Gian Clavell,2015,2017,Colorado State,MWC,70,2169,349,835,200,423,149,412,215,308,65,296,361,119,94,39,109,151,1062
2447,Cody Ellis,2010,2013,Saint Louis,A-10,112,2675,329,896,135,316,194,580,210,272,71,352,423,99,82,35,107,209,1062
2448,Jaron Martin,2014,2017,UC-Irvine,Big West,122,2540,370,890,180,436,190,454,132,165,37,164,201,226,72,6,138,140,1062
2449,Amu Saaka,2008,2011,Total,Total,92,2323,357,790,261,521,96,269,252,331,152,326,478,95,45,28,140,223,1062
2450,Parker Wentz,2014,2016,Abilene Christian,Southland,93,2852,333,741,123,261,210,480,186,217,18,170,188,157,135,7,132,199,1062
2451,Jalen Billups,2013,2016,Northern Kentucky,Total,97,1959,438,710,437,705,1,5,184,282,188,348,536,48,29,119,169,261,1061
2452,LaVell Boyd,2016,2017,Missouri-Kansas City,WAC,66,2100,338,806,170,397,168,409,217,263,32,215,247,206,61,5,134,173,1061
2453,Adrian Diaz,2012,2016,Total,Total,114,2418,401,653,401,653,0,0,259,436,268,306,574,88,56,207,190,308,1061
2454,DeVaughn Washington,2008,2011,Ohio,MAC,130,2757,381,765,380,761,1,4,298,459,191,350,541,75,103,46,204,348,1061
2455,Mitchell Watt,2009,2012,Buffalo,MAC,128,2495,415,796,404,762,11,34,220,323,191,374,565,160,71,195,224,317,1061
2456,Zane Johnson,2008,2012,Total,Total,108,2757,336,826,116,254,220,572,168,204,32,226,258,143,55,10,157,220,1060
2457,Jeremy Lamb,2011,2012,Connecticut,Big East,75,2406,399,828,282,492,117,336,145,180,82,267,349,124,77,46,120,121,1060
2458,Trevor Lyons,2015,2018,Air Force,MWC,117,3432,341,843,243,577,98,266,280,409,54,354,408,309,162,3,176,222,1060
2459,Cameron Moore,2009,2012,Alabama-Birmingham,CUSA,115,2704,425,858,396,761,29,97,181,299,195,552,747,80,52,137,138,185,1060
2460,Earl Pettis,2008,2012,Total,Total,127,2872,398,911,275,563,123,348,141,175,89,317,406,222,140,21,207,241,1060
2461,Nik Stauskas,2013,2014,Michigan,Big Ten,75,2471,323,692,151,302,172,390,242,291,35,186,221,170,42,20,111,73,1060
2462,Kevin Ferguson,2013,2016,Army,Patriot,121,2802,433,691,433,691,0,0,193,297,274,452,726,139,42,204,196,328,1059
2463,Max Heidegger,2017,2019,UC-Santa Barbara,Big West,79,2226,324,879,183,443,141,436,270,348,32,163,195,172,38,3,115,135,1059
2464,Jalen Henry,2015,2018,Southern Illinois-Edwardsville,OVC,113,2206,356,829,302,667,54,162,293,419,142,369,511,61,43,81,190,300,1059
2465,Tashan Newsome,2009,2013,Total,Total,97,2383,363,908,299,661,64,247,269,370,116,327,443,179,72,11,176,217,1059
2466,Bud Thomas,2011,2014,Mercer,A-Sun,143,3748,397,857,236,380,161,477,104,176,127,438,565,275,135,60,170,247,1059
2467,Brian White,2014,2017,Citadel,Southern,127,2467,380,731,327,577,53,154,246,304,145,349,494,47,55,50,127,240,1059
2468,Kenny Hasbrouck,2008,2009,Siena,MAAC,69,2152,391,922,278,614,113,308,163,236,58,176,234,175,146,12,141,142,1058
2469,Tim Huskisson,2012,2015,Northern Colorado,Big Sky,120,2576,378,731,298,520,80,211,222,335,178,257,435,165,99,55,186,307,1058
2470,Prentiss Nixon,2016,2018,Colorado State,MWC,94,2508,334,896,182,439,152,457,238,294,21,220,241,162,74,8,145,231,1058
2471,Felix Von Hofe,2014,2017,Eastern Washington,Big Sky,128,2963,345,842,83,185,262,657,106,143,37,251,288,88,50,41,77,202,1058
2472,Andrien White,2016,2018,Charlotte,CUSA,87,2237,337,806,168,360,169,446,215,287,66,283,349,96,137,23,137,237,1058
2473,Robert Champion,2014,2017,Holy Cross,Patriot,121,2629,368,870,215,416,153,454,168,255,59,297,356,111,109,23,149,247,1057
2474,Nick Jacobs,2012,2016,Total,Total,129,2691,454,895,454,894,0,1,149,229,197,360,557,22,48,104,149,246,1057
2475,Kam Williams,2015,2018,Ohio State,Big Ten,133,2980,392,890,220,463,172,427,101,115,36,192,228,102,82,16,76,141,1057
2476,Kevin Young,2009,2013,Total,Total,139,3264,418,869,376,705,42,164,179,299,301,461,762,119,149,99,203,333,1057
2477,Tim Bond,2015,2018,Eastern Michigan,MAC,123,3583,403,914,320,653,83,261,167,234,110,380,490,373,237,107,226,288,1056
2478,Markel Crawford,2015,2018,Total,Total,127,3364,380,869,280,530,100,339,196,268,90,356,446,229,144,21,146,259,1056
2479,Jio Fontan,2009,2013,Total,Total,89,2960,350,943,261,671,89,272,267,408,38,152,190,415,82,8,266,242,1056
2480,Alex Long,2016,2019,Norfolk State,MEAC,134,3058,427,878,426,867,1,11,201,344,208,439,647,99,89,130,248,383,1056
2481,Jalen Riley,2014,2015,East Tennessee State,Total,64,1533,290,769,160,400,130,369,346,416,33,121,154,141,80,8,135,171,1056
2482,Xavier Bishop,2017,2019,Missouri-Kansas City,WAC,98,2599,348,861,221,483,127,378,232,303,35,196,231,295,75,1,210,220,1055
2483,Miles Bridges,2017,2018,Michigan State,Big Ten,62,1962,386,821,259,482,127,339,156,201,84,385,469,150,40,69,133,105,1055
2484,Tyler Dorsey,2016,2017,Oregon,Pac-12,75,2252,342,752,187,379,155,373,216,295,81,209,290,138,59,11,128,133,1055
2485,Eric Evans,2009,2012,Duquesne,A-10,119,3008,343,893,245,533,98,360,271,387,51,197,248,309,121,2,196,226,1055
2486,Emani Gant,2014,2016,Texas State,Sun Belt,90,2448,415,823,414,820,1,3,224,341,213,372,585,128,78,52,180,239,1055
2487,Admon Gilder,2016,2018,Texas A&M,SEC,98,2787,360,819,220,445,140,374,195,252,67,263,330,246,131,19,161,191,1055
2488,Angelo Johnson,2008,2012,Total,Total,133,4039,346,904,220,557,126,347,237,323,39,327,366,389,111,15,211,281,1055
2489,Paul Jorgensen,2015,2019,Total,Total,141,2785,378,962,208,500,170,462,129,175,55,275,330,253,90,7,128,181,1055
2490,Ben Lammers,2015,2018,Georgia Tech,ACC,124,3107,431,850,428,838,3,12,190,271,244,530,774,150,98,254,131,222,1055
2491,Dwayne Lautier-Ogunleye,2016,2019,Bradley,MVC,130,3536,304,753,208,477,96,276,351,524,110,453,563,308,85,18,260,307,1055
2492,Jarvis Williams,2014,2015,Murray State,OVC,69,2190,383,635,383,634,0,1,289,436,263,368,631,54,52,95,115,184,1055
2493,Joevan Catron,2008,2011,Oregon,Pac-10,97,2557,354,785,325,682,29,103,317,454,234,383,617,186,97,38,209,259,1054
2494,Steven Idlet,2009,2012,Tulsa,CUSA,132,2746,364,704,362,700,2,4,324,453,212,450,662,102,70,118,178,356,1054
2495,Dan Mavraides,2008,2011,Princeton,Ivy,97,2779,330,830,165,399,165,431,229,288,68,300,368,149,105,10,174,249,1054
2496,Duke Mondy,2010,2014,Total,Total,121,3167,363,949,234,529,129,420,199,275,119,324,443,358,283,30,240,314,1054
2497,Will Neighbour,2012,2014,Little Rock,Sun Belt,86,2458,354,788,265,548,89,240,257,340,160,392,552,97,98,85,214,200,1054
2498,Darien Nelson-Henry,2013,2016,Pennsylvania,Ivy,108,2443,414,745,412,739,2,6,224,346,199,409,608,110,48,100,237,263,1054
2499,Josh Owens,2008,2012,Stanford,Total,120,2665,436,761,436,761,0,0,182,293,219,345,564,100,103,85,158,272,1054
2500,Antwon Portley,2016,2019,Total,Total,97,2951,346,938,157,387,189,551,173,228,22,264,286,221,73,9,174,162,1054
2501,Adrian Powell,2010,2013,North Carolina A&T,MEAC,115,2910,382,897,264,554,118,343,172,263,119,381,500,161,158,45,219,204,1054
2502,Frankie Ferrari,2015,2019,San Francisco,WCC,111,2723,358,877,186,430,172,447,165,202,27,245,272,410,110,0,166,199,1053
2503,Lamar Peters,2017,2019,Mississippi State,SEC,98,2701,358,930,164,369,194,561,143,210,41,170,211,429,142,15,259,244,1053
2504,Lew Stallworth,2015,2019,Total,Total,108,2484,376,799,294,554,82,245,219,300,46,279,325,397,82,9,226,207,1053
2505,Jabari Brown,2012,2014,Total,Total,62,2164,307,696,170,341,137,355,301,385,30,214,244,103,40,6,136,111,1052
2506,Deonte Burton,2014,2017,Total,Total,101,2053,404,845,336,677,68,168,176,265,112,287,399,108,129,82,150,242,1052
2507,Charles Carmouche,2009,2013,Total,Total,122,3163,334,831,206,476,128,355,256,396,86,350,436,266,172,32,215,318,1052
2508,Scottie James,2016,2019,Total,Total,103,2123,396,650,364,545,32,105,228,313,228,488,716,87,29,64,129,193,1052
2509,Cory Johnson,2008,2011,Total,Total,93,2079,390,741,350,611,40,130,232,334,135,236,371,107,56,36,173,227,1052
2510,Erik Murphy,2010,2013,Florida,SEC,136,2488,397,773,254,444,143,329,115,152,160,347,507,95,58,85,139,297,1052
2511,Josh Sharkey,2017,2019,Samford,Southern,99,2708,322,746,277,577,45,169,363,490,45,214,259,541,203,4,358,241,1052
2512,Travis Wear,2010,2014,Total,Total,128,2845,425,843,405,793,20,50,182,228,206,316,522,85,77,94,115,297,1052
2513,Nisre Zouzoua,2016,2019,Total,Total,82,2167,350,879,195,437,155,442,197,251,51,196,247,104,73,23,109,183,1052
2514,Kris Acox,2014,2017,Furman,Southern,118,3027,448,731,448,730,0,1,155,297,306,484,790,85,100,64,175,285,1051
2515,Ian Chiles,2011,2014,Morgan State,MEAC,110,2197,430,788,430,788,0,0,191,297,184,312,496,78,34,195,128,222,1051
2516,Luke Fischer,2014,2017,Total,Total,102,2533,429,693,429,692,0,1,193,307,233,301,534,96,47,164,145,302,1051
2517,Devoe Joseph,2009,2012,Total,Total,104,2634,372,872,209,460,163,412,144,196,60,222,282,274,98,9,188,130,1051
2518,Lorne Merthie,2009,2012,Campbell,Total,106,2965,333,839,107,283,226,556,159,211,42,231,273,232,155,6,157,217,1051
2519,Greg Smith,2010,2013,Colorado State,MWC,121,2578,356,839,299,676,57,163,282,391,156,375,531,133,55,50,212,274,1051
2520,Wes Washpun,2012,2016,Total,Total,119,3092,350,759,297,594,53,165,298,428,38,328,366,422,114,72,248,247,1051
2521,Jaylin Airington,2015,2017,Cal State Bakersfield,WAC,97,2857,338,812,253,565,85,247,289,369,133,270,403,192,77,22,152,276,1050
2522,Chris Bond,2011,2014,Ball State,MAC,118,3105,392,785,371,706,21,79,245,365,228,384,612,143,148,48,205,238,1050
2523,Justin Dehm,2008,2011,Furman,Southern,122,3244,344,857,130,284,214,573,148,177,23,202,225,266,88,3,205,160,1050
2524,Trey Kellum,2013,2017,Total,Total,115,2698,400,803,400,801,0,2,250,385,279,379,658,70,77,51,207,379,1050
2525,Corey Maynard,2011,2014,Bryant,NEC,110,3406,370,854,232,437,138,417,172,224,100,375,475,379,116,9,211,234,1050
2526,Brian Qvale,2008,2011,Montana,Big Sky,117,2720,415,704,415,703,0,1,220,345,236,489,725,75,49,247,150,304,1050
2527,Ladarius Tabb,2015,2016,Alabama A&M,SWAC,57,1926,391,878,300,566,91,312,177,284,149,269,418,41,76,12,99,153,1050
2528,Fred Thomas,2013,2016,Mississippi State,SEC,125,3229,340,931,174,380,166,551,204,274,45,358,403,143,120,78,153,209,1050
2529,Reggie Arceneaux,2012,2015,Wright State,Horizon,132,3556,369,975,196,503,173,472,138,181,34,216,250,296,110,2,244,158,1049
2530,Willie Clayton,2013,2017,Total,Total,129,3088,424,715,424,715,0,0,201,462,416,502,918,63,77,69,243,388,1049
2531,David Cohn,2014,2018,Total,Total,124,3402,332,723,216,425,116,298,269,321,37,272,309,519,117,4,198,175,1049
2532,Gerald Colds,2008,2011,Drexel,CAA,122,3371,352,1081,229,640,123,441,222,394,66,207,273,262,92,22,221,211,1049
2533,Jae Crowder,2011,2012,Marquette,Big East,72,2174,375,762,272,468,103,294,196,287,153,392,545,131,136,67,74,178,1049
2534,Bryon Allen,2011,2014,George Mason,Total,127,3082,380,871,312,655,68,216,220,283,79,269,348,380,112,10,239,206,1048
2535,Luke Apfeld,2011,2014,Vermont,AEC,126,2461,358,734,316,607,42,127,290,372,175,278,453,53,63,50,140,328,1048
2536,Chaise Daniels,2015,2018,Quinnipiac,MAAC,114,2537,417,867,417,864,0,3,214,344,186,348,534,84,40,150,214,344,1048
2537,Tim Douglas,2011,2015,Total,Total,120,3084,352,892,245,571,107,321,237,297,36,205,241,354,101,3,273,215,1048
2538,Anthony Jackson,2011,2014,Stony Brook,AEC,125,2578,357,876,187,413,170,463,164,185,53,180,233,177,71,6,200,176,1048
2539,B.J. Jenkins,2008,2011,Total,Total,100,2861,340,801,174,342,166,459,202,240,55,289,344,318,157,11,204,212,1048
2540,Cody Joyce,2013,2016,Total,Total,119,2756,400,778,400,777,0,1,248,392,154,323,477,71,48,46,164,278,1048
2541,Scott Martin,2008,2013,Total,Total,116,3389,369,906,248,539,121,367,189,283,112,462,574,183,89,50,164,265,1048
2542,Johnny Moran,2009,2012,Northern Iowa,MVC,135,4025,359,951,158,350,201,601,129,177,92,365,457,234,152,8,165,216,1048
2543,Luke Sikma,2008,2011,Portland,WCC,127,3051,412,773,400,733,12,40,212,297,310,677,987,253,121,88,245,338,1048
2544,Paulius Zalys,2016,2019,Lafayette,Patriot,120,2806,405,855,329,608,76,247,162,235,131,406,537,230,58,33,293,280,1048
2545,Eli Chuha,2016,2019,New Mexico State,WAC,118,2272,395,674,384,621,11,53,246,377,256,448,704,124,49,34,160,211,1047
2546,Tekele Cotton,2012,2015,Wichita State,MVC,141,3403,375,853,267,534,108,319,189,292,144,336,480,276,156,30,151,245,1047
2547,Robert Hubbs,2014,2017,Tennessee,SEC,106,2826,409,937,354,740,55,197,174,222,132,243,375,127,54,16,102,168,1047
2548,Alshwan Hymes,2010,2013,Canisius,MAAC,114,2716,370,985,150,330,220,655,87,115,72,192,264,156,80,7,226,213,1047
2549,David Nwaba,2014,2016,Cal Poly,Big West,88,2291,373,788,369,764,4,24,297,457,164,302,466,180,96,49,141,174,1047
2550,Bobby Portis,2014,2015,Arkansas,SEC,70,1994,411,782,388,719,23,63,202,274,219,332,551,92,74,104,97,137,1047
2551,James Bell,2011,2014,Villanova,Big East,122,2866,344,836,154,314,190,522,168,213,136,357,493,143,111,47,170,309,1046
2552,Wayne Blackshear,2012,2015,Louisville,Total,126,2723,342,838,186,384,156,454,206,278,83,325,408,95,106,51,89,287,1046
2553,Tyler Brown,2012,2013,Illinois State,MVC,66,1999,334,748,175,369,159,379,219,274,53,217,270,165,80,11,180,114,1046
2554,DeMarre Carroll,2008,2009,Missouri,Big 12,70,1873,408,743,389,682,19,61,211,338,183,303,486,124,95,46,104,169,1046
2555,Rakeem Christmas,2012,2015,Syracuse,Total,142,3126,409,731,409,730,0,1,228,335,280,466,746,86,77,247,162,375,1046
2556,Javorn Farrell,2010,2014,Total,Total,121,2937,368,956,313,756,55,200,255,354,146,321,467,287,134,37,238,346,1046
2557,Lorenzo Cugini,2013,2016,High Point,Big South,127,3137,390,838,217,418,173,420,92,117,118,355,473,140,42,16,112,196,1045
2558,Kyle Davis,2011,2017,Total,Total,107,2505,393,727,382,695,11,32,248,381,221,474,695,128,57,128,185,226,1045
2559,Xavier Munford,2013,2014,Rhode Island,A-10,61,2166,352,884,222,496,130,388,211,297,28,182,210,134,66,23,165,133,1045
2560,Femi Olujobi,2015,2019,Total,Total,123,2363,372,680,340,574,32,106,269,377,158,357,515,87,35,38,175,223,1045
2561,Lavelle Scottie,2017,2019,Air Force,MWC,96,2304,408,870,328,630,80,240,149,223,110,309,419,115,58,33,192,183,1045
2562,Ed Waite,2010,2013,Monmouth,NEC,124,2668,397,857,381,786,16,71,235,382,238,420,658,150,143,32,257,365,1045
2563,Gilbert Brown,2008,2011,Pittsburgh,Big East,126,2931,358,771,264,497,94,274,234,314,148,289,437,233,67,33,165,253,1044
2564,Ty Charles,2015,2018,Stephen F. Austin,Southland,119,2925,375,847,288,575,87,272,207,283,189,388,577,233,131,26,195,340,1044
2565,Kadeem Jack,2012,2015,Rutgers,Total,111,2581,409,898,392,847,17,51,209,330,221,364,585,62,70,100,181,260,1044
2566,Tony Meier,2009,2012,Milwaukee,Horizon,119,2717,341,776,152,284,189,492,173,226,146,340,486,115,41,45,168,306,1044
2567,Brockeith Pane,2008,2012,Total,Total,101,2564,351,852,290,631,61,221,281,359,49,226,275,299,85,11,221,194,1044
2568,Larry Sanders,2008,2010,Virginia Commonwealth,CAA,101,2376,415,798,411,782,4,16,210,364,254,522,776,51,59,277,155,317,1044
2569,Keaton Wallace,2018,2019,Texas-San Antonio,CUSA,67,2082,354,890,159,350,195,540,141,173,48,220,268,169,70,34,128,142,1044
2570,Eddie Williams,2008,2011,Stephen F. Austin,Southland,124,3437,405,884,336,657,69,227,165,282,119,353,472,316,144,18,182,248,1044
2571,Isaiah Williams,2014,2016,Iona,MAAC,84,2664,376,783,161,242,215,541,77,103,150,329,479,161,95,75,94,234,1044
2572,Amir Bell,2015,2018,Princeton,Ivy,118,3367,366,800,267,519,99,281,212,323,57,333,390,313,105,53,172,346,1043
2573,Yorel Hawkins,2008,2011,Fairfield,MAAC,110,2923,381,877,354,775,27,102,254,335,206,353,559,131,111,33,154,267,1043
2574,Gerald Henderson,2008,2009,Duke,ACC,71,1989,369,802,308,617,61,185,244,339,95,248,343,147,85,59,148,133,1043
2575,Kodi Justice,2015,2018,Arizona State,Pac-12,115,3076,354,826,137,286,217,540,118,165,39,231,270,249,117,32,172,268,1043
2576,Patrick Konan,2010,2014,Total,Total,108,2795,365,877,248,535,117,342,196,308,176,388,564,94,67,30,212,269,1043
2577,Anthony Lawrence Jr.,2016,2019,Miami (FL),ACC,130,3299,360,790,218,414,142,376,181,256,130,479,609,258,144,80,193,260,1043
2578,Kellon Thomas,2013,2017,Total,Total,139,3176,321,862,218,546,103,316,298,382,34,208,242,277,93,4,174,294,1043
2579,Isaiah Blackmon,2016,2019,Saint Francis (PA),NEC,85,2286,364,796,228,476,136,320,178,245,126,237,363,100,90,20,119,188,1042
2580,Erik Kangas,2008,2009,Oakland,Summit,61,2024,343,793,121,257,222,536,134,153,35,111,146,90,61,7,106,79,1042
2581,Dane Miller,2010,2013,Rutgers,Big East,127,3553,400,898,355,729,45,169,197,326,261,480,741,313,129,162,273,274,1042
2582,Daniel Amigo,2015,2018,Denver,Summit,88,1827,419,803,392,741,27,62,176,281,129,323,452,109,26,51,209,283,1041
2583,Dee Brown,2009,2012,Bowling Green State,MAC,121,2773,375,874,272,595,103,279,188,249,45,199,256,193,86,6,164,97,1041
2584,Orane Chin,2008,2012,Total,Total,123,2986,371,812,292,587,79,225,220,322,168,362,530,170,63,72,214,269,1041
2585,Walt Gibler,2009,2012,Loyola (IL),Horizon,112,2391,323,695,294,599,29,96,366,468,187,324,511,69,62,40,155,261,1041
2586,Tomasz Gielo,2012,2016,Total,Total,122,3109,370,878,237,510,133,368,168,214,135,413,548,143,56,52,176,254,1041
2587,Isaiah Jackson,2015,2019,Total,Total,133,2966,321,827,201,486,120,341,279,363,129,377,506,199,112,23,176,231,1041
2588,Antwon Lillard,2016,2019,Bowling Green State,MAC,121,2693,345,766,254,482,91,284,260,374,127,343,470,156,105,40,189,287,1041
2589,Andrew Ryan,2011,2015,Campbell,Total,129,3333,361,834,162,322,199,512,120,164,104,344,448,227,92,22,134,252,1041
2590,Kyle Bullinger,2009,2012,Weber State,Big Sky,117,3080,347,830,196,419,151,411,195,278,114,463,577,153,63,12,161,311,1040
2591,Sean O'Brien,2015,2018,Colgate,Patriot,127,3371,346,811,167,333,179,478,169,199,61,240,301,335,113,3,136,258,1040
2592,Luke Petrasek,2014,2017,Columbia,Ivy,115,2580,372,796,251,463,121,333,175,231,112,366,478,150,62,94,162,249,1040
2593,Carl Richard,2009,2012,Indiana State,MVC,125,3611,381,966,296,713,85,253,193,250,219,497,716,111,92,42,226,283,1040
2594,Esa Ahmad,2016,2019,West Virginia,Big 12,112,2644,356,765,314,623,42,142,285,429,193,294,487,192,99,65,220,233,1039
2595,Reggie Johnson,2010,2013,Miami (FL),ACC,117,2524,370,723,365,702,5,21,294,416,302,540,842,104,62,113,186,313,1039
2596,Kevin Sims,2008,2010,Tulane,CUSA,85,2891,299,762,171,425,128,337,313,391,34,174,208,310,90,4,197,182,1039
2597,Manny Adako,2008,2010,Northeastern,CAA,94,2673,448,810,446,803,2,7,140,183,123,286,409,63,54,51,146,219,1038
2598,Cole Aldrich,2008,2010,Kansas,Big 12,111,2330,391,681,391,681,0,0,256,351,250,610,860,72,59,253,133,230,1038
2599,Eric Hayes,2008,2010,Maryland,ACC,99,3077,354,783,180,355,174,428,156,181,44,238,282,381,104,20,186,146,1038
2600,Matthew Butler,2014,2018,Total,Total,109,2703,374,929,188,413,186,516,103,134,21,184,205,233,54,3,228,171,1037
2601,Josh Fortune,2013,2017,Total,Total,137,3413,351,924,174,398,177,526,158,207,86,341,427,247,95,34,233,244,1037
2602,Michael Humphrey,2015,2018,Stanford,Pac-12,125,2685,415,870,375,749,40,121,167,248,224,492,716,89,93,112,163,391,1037
2603,Jett Raines,2013,2016,Pepperdine,WCC,117,2739,398,781,379,705,19,76,222,303,175,308,483,44,56,47,100,245,1037
2604,Joe Reed,2013,2016,Purdue-Fort Wayne,Summit,132,3241,379,700,345,587,34,113,245,383,235,368,603,150,86,52,136,265,1037
2605,Jean Cajou,2008,2011,Mount St. Mary's,NEC,114,3017,325,844,202,460,123,384,263,321,67,285,352,181,101,23,173,218,1036
2606,Will Clyburn,2011,2013,Total,Total,65,2144,329,737,226,450,103,287,275,360,122,350,472,104,66,20,167,121,1036
2607,Reggie Lynch,2014,2018,Total,Total,116,2606,393,717,393,717,0,0,250,391,273,398,671,52,69,369,181,403,1036
2608,Wesley Matthews,2008,2009,Marquette,Big East,70,2200,314,685,251,504,63,181,345,424,104,252,356,145,77,28,139,152,1036
2609,Kyle McAlarney,2008,2009,Notre Dame,Big East,69,2507,344,820,112,282,232,538,116,136,14,148,162,239,49,4,134,86,1036
2610,Robin Smeulders,2008,2010,Portland,WCC,95,2490,379,784,371,740,8,44,270,364,195,387,582,90,50,47,160,245,1036
2611,George Blagojevic,2016,2019,Hartford,AEC,126,3004,409,849,366,681,43,168,174,292,184,394,578,167,99,59,221,264,1035
2612,Joshua Filmore,2014,2018,Southeastern Louisiana,Southland,115,3435,360,915,143,306,217,609,98,171,28,242,270,278,81,3,140,168,1035
2613,Aric Holman,2016,2019,Mississippi State,SEC,124,2621,384,753,288,502,96,251,171,249,218,473,691,97,70,198,169,249,1035
2614,Je'lon Hornbeak,2013,2017,Total,Total,129,2859,317,786,149,349,168,437,233,305,82,312,394,249,152,36,194,350,1035
2615,K.J. McDaniels,2012,2014,Clemson,ACC,94,2287,362,804,281,545,81,259,230,300,170,280,450,85,83,178,140,168,1035
2616,Wink Adams,2008,2009,Nevada-Las Vegas,MWC,66,2079,333,832,228,502,105,330,263,343,41,226,267,194,95,2,127,111,1034
2617,Marlon Beck,2014,2017,Binghamton,AEC,123,3583,331,946,123,306,208,640,164,251,40,261,301,276,139,4,187,219,1034
2618,Semaj Christon,2013,2014,Xavier,Total,64,2227,363,785,337,708,26,77,282,421,20,157,177,281,90,11,198,152,1034
2619,Rodney Elliott,2014,2017,Maryland-Baltimore County,AEC,86,2303,316,726,198,385,118,341,284,385,56,202,258,251,77,3,217,253,1034
2620,Joseph Harris,2008,2010,Coastal Carolina,Big South,74,2346,419,763,416,754,3,9,193,310,251,500,751,133,127,81,170,186,1034
2621,Justin Kier,2017,2019,George Mason,A-10,99,3155,364,798,306,619,58,179,248,323,47,469,516,199,114,19,235,201,1034
2622,Jason McManamen,2013,2017,Wyoming,MWC,124,3036,322,799,112,235,210,564,180,250,33,240,273,179,51,4,104,245,1034
2623,Andre Spight,2016,2018,Total,Total,65,1811,353,838,189,404,164,434,164,209,27,145,172,173,57,10,132,115,1034
2624,Gene Teague,2010,2014,Total,Total,110,2593,388,658,388,658,0,0,258,452,254,445,699,101,42,55,240,319,1034
2625,Ryan Woolridge,2017,2019,North Texas,CUSA,89,2972,403,826,356,684,47,142,181,334,93,383,476,433,151,29,281,164,1034
2626,Dan Geriot,2008,2011,Richmond,A-10,103,2647,392,882,318,681,74,201,175,260,109,345,454,227,50,15,197,239,1033
2627,Charles Odum,2011,2012,Portland State,Big Sky,62,1868,332,630,264,442,68,188,301,381,58,168,226,167,58,10,171,134,1033
2628,Josh Okogie,2017,2018,Georgia Tech,ACC,61,2014,327,748,261,575,66,173,313,403,109,242,351,120,90,50,138,164,1033
2629,Isaiah Reese,2017,2019,Canisius,MAAC,87,2447,380,879,241,453,139,426,134,169,58,375,433,340,152,20,198,191,1033
2630,Dominic Robb,2016,2019,Niagara,MAAC,130,2814,416,789,409,768,7,21,194,293,195,401,596,66,31,223,126,318,1033
2631,Zach Smith,2015,2018,Texas Tech,Big 12,117,3353,393,768,366,678,27,90,220,354,210,487,697,168,77,158,180,227,1033
2632,Matt Sullivan,2010,2013,Brown,Ivy,117,3262,333,842,168,387,165,455,202,270,43,294,337,206,97,9,157,238,1033
2633,Blake Allen,2011,2013,Youngstown State,Horizon,95,2979,362,897,130,304,232,593,76,115,60,278,338,273,71,10,127,162,1032
2634,Damani Applewhite,2017,2019,South Carolina State,MEAC,94,2478,378,736,373,714,5,22,271,391,161,381,542,68,36,21,106,163,1032
2635,Senario Hillman,2008,2011,Alabama,SEC,132,2933,409,999,341,738,68,261,146,208,95,205,300,234,176,28,243,341,1032
2636,Tiwian Kendley,2017,2018,Morgan State,MEAC,44,1436,312,755,232,483,80,272,328,427,68,138,206,75,73,17,174,123,1032
2637,Max Mahoney,2017,2019,Boston University,Patriot,84,1759,435,708,435,708,0,0,162,278,151,277,428,101,55,52,141,231,1032
2638,Javarez Willis,2011,2015,Total,Total,124,2997,359,883,166,355,193,528,121,148,24,227,251,287,79,0,255,176,1032
2639,Paris Collins,2016,2018,Jackson State,SWAC,84,2567,381,1053,249,591,132,462,137,233,143,349,492,193,187,50,157,209,1031
2640,Nike Sibande,2018,2019,Miami (OH),MAC,66,2077,336,831,183,381,153,450,206,289,56,252,308,80,66,18,136,124,1031
2641,Adam Sollazzo,2009,2012,East Tennessee State,A-Sun,135,3184,337,740,320,672,17,68,340,520,90,358,448,409,148,26,304,226,1031
2642,Dylan Cox,2013,2016,Army,Patriot,123,3135,381,716,344,603,37,113,231,361,184,380,564,479,98,47,266,269,1030
2643,A.J. Davis,2014,2018,Total,Total,117,3213,317,802,242,553,75,249,321,450,151,521,672,235,89,42,232,256,1030
2644,Khwan Fore,2015,2019,Total,Total,132,3434,393,822,344,668,49,154,195,314,95,287,382,252,139,20,165,289,1030
2645,Eli Holman,2008,2012,Total,Total,95,2431,411,679,411,679,0,0,208,322,289,485,774,70,67,166,164,282,1030
2646,Michael Murray,2011,2014,Coppin State,MEAC,112,2982,389,957,328,689,61,268,191,301,224,407,631,96,100,42,169,229,1030
2647,Nicholas Paulos,2012,2015,North Carolina-Greensboro,Southern,125,3147,352,835,90,169,262,666,64,77,68,318,386,112,73,38,127,238,1030
2648,Eugene Phelps,2009,2012,Long Beach State,Big West,131,3120,398,805,395,777,3,28,231,431,268,408,676,120,63,81,213,300,1030
2649,Scott Saunders,2008,2012,Total,Total,131,2023,360,701,360,701,0,0,310,452,180,376,556,35,42,93,170,298,1030
2650,Damon Sherman-Newsome,2013,2015,Colgate,Patriot,96,2601,357,807,217,427,140,380,176,232,47,244,291,147,49,18,154,135,1030
2651,Zach Stahl,2013,2016,Northeastern,CAA,128,3125,397,787,387,748,10,39,226,327,189,419,608,198,85,46,253,318,1030
2652,Sterling Taplin,2016,2019,Tulsa,AAC,123,2918,339,818,228,503,111,315,241,327,25,305,330,406,92,8,248,235,1030
2653,Kevin Van Wijk,2011,2013,Valparaiso,Horizon,99,1963,357,587,357,580,0,7,316,460,150,276,426,55,62,55,185,264,1030
2654,Jarekious Bradley,2014,2015,Southeast Missouri State,OVC,58,1771,364,781,243,439,121,342,180,219,91,254,345,87,64,48,107,158,1029
2655,Damian Hollis,2008,2010,George Washington,A-10,84,2111,352,791,260,536,92,255,233,280,126,356,482,113,61,66,189,250,1029
2656,Demontrae Jefferson,2017,2018,Texas Southern,SWAC,55,1914,335,833,211,488,124,345,235,304,31,110,141,211,66,0,171,116,1029
2657,Greg Plater,2008,2011,Long Beach State,Big West,126,2813,336,875,107,240,229,635,128,173,44,203,247,166,85,12,158,136,1029
2658,Jackson Rowe,2017,2019,Cal State Fullerton,Big West,91,2754,382,687,326,529,56,158,209,290,158,506,664,163,64,88,207,216,1029
2659,Alex Ruoff,2008,2009,West Virginia,Big East,70,2355,334,737,148,262,186,475,175,216,61,185,246,215,112,23,131,157,1029
2660,Jeremy Simmons,2008,2011,College of Charleston,Southern,114,2851,415,701,414,695,1,6,198,309,268,413,681,107,67,139,141,242,1029
2661,Hank Thorns,2008,2012,Total,Total,130,3506,348,975,206,542,142,433,191,264,73,250,323,562,138,4,291,247,1029
2662,Tremont Waters,2018,2019,Louisiana State,SEC,66,2159,340,804,212,428,128,376,221,274,20,183,203,390,161,7,210,138,1029
2663,Jacoby Armstrong,2014,2018,New Hampshire,AEC,117,2724,383,834,362,745,21,89,241,358,182,355,537,106,36,35,181,399,1028
2664,Jamal Barney,2009,2011,Loyola (MD),MAAC,71,1847,379,923,321,714,58,209,212,291,103,229,332,90,75,27,193,173,1028
2665,Steve Glowiak,2012,2015,Sacred Heart,NEC,122,2868,346,923,114,251,232,672,104,140,81,238,319,126,103,5,100,166,1028
2666,Bennett Koch,2015,2018,Northern Iowa,MVC,124,2127,358,661,358,660,0,1,312,424,136,306,442,45,44,63,189,272,1028
2667,J.J. O'Brien,2011,2015,Total,MWC,127,3686,415,882,396,805,19,77,179,298,278,344,622,204,116,37,189,232,1028
2668,Chris Porter-Bunton,2016,2019,Austin Peay,OVC,131,2782,355,749,262,515,93,234,225,328,118,360,478,182,123,23,185,391,1028
2669,Adrien Coleman,2010,2013,Total,Total,75,2279,392,768,373,695,19,73,224,424,170,232,402,151,97,27,187,163,1027
2670,Jay Couisnard,2008,2011,Total,Total,89,2510,342,790,267,572,75,218,268,403,106,241,347,148,89,34,203,287,1027
2671,Khris Lane,2014,2018,Total,Total,100,2355,416,780,354,604,62,176,133,202,156,389,545,78,54,53,153,232,1027
2672,Reggie Moore,2010,2012,Washington State,Total,96,3148,290,769,205,519,85,250,362,472,41,215,256,419,98,8,243,170,1027
2673,Will Spradling,2011,2014,Kansas State,Big 12,134,3698,309,810,127,286,182,524,227,281,58,255,313,331,128,12,162,319,1027
2674,Brandan Stith,2014,2018,Total,CUSA,125,3097,402,765,402,763,0,2,223,397,377,579,956,105,99,196,149,306,1027
2675,Mike Venezia,2008,2012,Colgate,Patriot,108,3289,341,918,145,387,196,531,149,186,49,190,239,120,46,10,154,157,1027
2676,Thomas Robinson,2010,2012,Kansas,Big 12,105,1960,395,753,388,739,7,14,229,378,221,542,763,101,63,74,173,217,1026
2677,Chris Chiozza,2015,2018,Florida,SEC,139,3494,344,879,214,481,130,398,207,277,56,386,442,571,191,7,223,288,1025
2678,Gary Harris,2013,2014,Michigan State,Big Ten,69,2141,345,784,199,396,146,388,189,240,67,159,226,140,108,21,111,141,1025
2679,Donovan Morris,2008,2009,Long Beach State,Big West,56,1893,322,734,210,418,112,316,269,319,37,204,241,123,48,12,156,65,1025
2680,Tim Williams,2008,2011,Total,Total,89,2358,378,888,301,647,77,241,192,300,140,291,431,137,74,26,161,184,1025
2681,Kentrell Barkley,2016,2018,East Carolina,AAC,87,2679,335,764,251,509,84,255,270,401,156,457,613,230,101,41,180,158,1024
2682,T.J. Bray,2011,2014,Princeton,Ivy,118,3293,338,696,203,348,135,348,213,283,57,372,429,374,150,12,174,210,1024
2683,Reese Holliday,2011,2015,Total,Total,119,3134,314,711,226,467,88,244,308,428,194,455,649,153,63,12,212,241,1024
2684,Vinnie McGhee,2008,2012,Total,Total,120,2946,350,991,146,384,204,607,120,160,42,150,192,358,116,1,227,190,1024
2685,Matt Mullery,2008,2010,Brown,Ivy,84,2385,383,676,364,613,19,63,239,354,113,332,445,174,61,144,182,194,1024
2686,Ryan Richardson,2015,2018,Weber State,Big Sky,117,2870,343,819,108,223,235,596,103,133,21,227,248,183,88,28,157,224,1024
2687,Tyler Scanlon,2017,2019,Boston University,Patriot,95,2846,369,825,211,408,158,417,128,167,77,360,437,235,121,14,158,145,1024
2688,P'Allen Stinnett,2008,2010,Creighton,MVC,87,2215,350,796,248,467,102,329,222,295,85,195,280,171,120,16,198,202,1024
2689,Elton Frazier,2008,2011,Canisius,MAAC,124,2885,405,918,362,742,43,176,170,262,272,314,586,88,79,108,181,323,1023
2690,Chad Gray,2008,2011,Total,Total,87,1926,408,808,373,692,35,116,172,274,174,230,404,74,56,71,139,175,1023
2691,Will Hudson,2008,2011,Oakland,Summit,137,3026,390,611,390,604,0,7,243,363,345,340,685,77,89,88,154,307,1023
2692,Preston Knowles,2008,2011,Louisville,Big East,133,2549,366,931,168,392,198,539,93,121,106,226,332,233,152,17,148,242,1023
2693,Zach Norvell Jr.,2018,2019,Gonzaga,WCC,74,2134,343,771,169,302,174,469,163,195,68,234,302,200,89,6,111,146,1023
2694,Elijah Thomas,2016,2019,Total,Total,101,2232,407,694,407,692,0,2,209,352,200,469,669,96,67,189,195,331,1023
2695,Kris Wilkes,2018,2019,UCLA,Pac-12,66,2029,363,833,238,469,125,364,172,259,82,238,320,112,45,32,107,154,1023
2696,La'Shard Anderson,2009,2011,Boise State,WAC,99,2885,343,865,265,599,78,266,258,341,60,196,256,367,196,33,249,264,1022
2697,Jaylen Bland,2012,2016,Total,Total,76,2297,325,836,111,289,214,547,158,199,41,246,287,110,91,18,135,131,1022
2698,Marc Brown,2012,2015,Illinois-Chicago,Horizon,128,3427,300,842,201,531,99,311,323,415,139,251,390,158,88,11,188,263,1022
2699,BaeBae Daniels,2013,2016,North Florida,A-Sun,128,2601,375,780,281,505,94,275,178,251,216,329,545,111,69,177,126,301,1022
2700,Jeffrey Forbes,2010,2013,Eastern Washington,Big Sky,121,3650,342,859,171,394,171,465,167,193,79,234,313,225,119,6,159,219,1022
2701,Anthony Hill,2008,2011,Milwaukee,Horizon,120,2158,360,733,350,695,10,38,292,436,190,323,513,99,48,57,181,275,1022
2702,Isacc Miles,2009,2011,Murray State,OVC,99,2835,333,744,214,404,119,340,237,327,61,204,265,374,114,11,234,219,1022
2703,Delon Wright,2014,2015,Utah,Pac-12,68,2367,339,634,301,507,38,127,306,376,76,321,397,352,155,77,152,110,1022
2704,Demetrius Ward,2009,2012,Western Michigan,MAC,130,2931,320,881,182,455,138,426,243,335,137,301,438,229,112,6,204,249,1021
2705,Martavius Adams,2008,2012,Total,Total,124,2876,397,851,359,718,38,133,188,307,210,521,731,74,47,41,226,306,1020
2706,Joseph Edwards,2012,2015,Purdue-Fort Wayne,Summit,126,3051,386,771,294,533,92,238,156,264,99,225,324,218,90,25,198,188,1020
2707,Kendall Gray,2012,2015,Delaware State,MEAC,110,3224,377,696,377,693,0,3,266,415,261,560,821,77,43,305,182,316,1020
2708,Anthony Johnson,2014,2018,Northern Colorado,Big Sky,116,2009,334,779,178,367,156,412,196,238,85,218,303,61,51,13,122,189,1020
2709,Sam Mills,2011,2014,La Salle,A-10,129,4132,366,897,170,417,196,480,92,130,87,242,329,276,120,17,169,237,1020
2710,Trey Montgomery,2008,2010,Samford,Total,93,2975,350,703,262,445,88,258,232,337,60,319,379,237,135,8,230,164,1020
2711,Marshall Moses,2008,2011,Oklahoma State,Big 12,121,2550,413,757,409,745,4,12,190,279,244,478,722,71,44,48,177,343,1020
2712,Roosevelt Smart,2018,2019,North Texas,CUSA,64,2045,318,848,134,310,184,538,200,231,29,222,251,64,42,14,116,149,1020
2713,Jason Bohannon,2008,2010,Wisconsin,Big Ten,102,3254,316,748,131,263,185,485,202,238,52,253,305,176,59,21,108,139,1019
2714,Maxie Esho,2012,2015,Massachusetts,A-10,134,2734,383,764,373,727,10,37,243,383,220,434,654,68,112,117,196,328,1019
2715,Amric Fields,2011,2015,Texas Christian,Total,116,2496,385,810,306,569,79,241,170,283,114,281,395,89,55,75,134,233,1019
2716,Cam Gregory,2015,2018,Loyola (MD),Patriot,124,3074,398,684,397,676,1,8,222,385,300,576,876,83,75,69,162,325,1019
2717,Cazmon Hayes,2014,2017,Delaware,CAA,124,3055,341,919,204,445,137,474,200,301,77,317,394,132,76,37,130,199,1019
2718,Josh Huestis,2011,2014,Stanford,Total,135,3376,392,870,326,663,66,207,169,277,292,542,834,113,67,190,125,230,1019
2719,Mac Koshwal,2008,2010,DePaul,Big East,81,2629,409,784,407,776,2,8,199,355,300,450,750,124,114,51,206,218,1019
2720,Marcel Mosley,2011,2015,Arkansas-Pine Bluff,SWAC,107,2664,320,804,186,436,134,368,245,314,81,176,257,221,157,2,259,190,1019
2721,Raphiael Putney,2011,2014,Massachusetts,A-10,131,2785,385,862,264,482,121,380,128,172,142,486,628,155,96,154,210,325,1019
2722,J.T. Sulton,2010,2013,Middle Tennessee,Sun Belt,133,2808,375,758,367,728,8,30,261,363,233,368,601,57,88,65,204,346,1019
2723,Marquan Botley,2014,2016,Florida Atlantic,CUSA,92,2552,319,868,153,412,166,456,214,270,35,170,205,272,60,3,131,138,1018
2724,JoJo Cooper,2015,2018,Wagner,NEC,124,3624,320,870,237,582,83,288,295,428,106,385,491,517,143,8,319,266,1018
2725,Shy Ely,2008,2009,Evansville,MVC,61,2060,351,788,315,679,36,109,280,363,61,272,333,104,45,16,146,132,1018
2726,Thomas Funk,2017,2019,Army,Patriot,94,2920,359,888,251,574,108,314,192,273,40,273,313,516,76,8,246,178,1018
2727,Anthony Johnson,2008,2010,Fairfield,MAAC,84,2473,404,797,404,793,0,4,210,361,303,397,700,59,93,166,144,235,1018
2728,Doron Lamb,2011,2012,Kentucky,SEC,78,2327,336,693,192,390,144,303,202,249,34,149,183,122,41,8,94,157,1018
2729,Matt O'Leary,2013,2017,Total,Total,125,2916,380,809,262,463,118,346,140,219,120,428,548,238,93,51,190,251,1018
2730,Brian Oliver,2010,2014,Total,Total,116,2687,350,927,124,310,226,617,92,114,97,276,373,120,67,32,152,266,1018
2731,Shavar Richardson,2009,2012,Florida Atlantic,Sun Belt,120,2548,351,931,194,468,157,463,159,194,41,212,253,136,49,9,134,191,1018
2732,Garfield Blair,2008,2009,Stetson,A-Sun,61,1957,349,763,296,614,53,149,266,361,110,300,410,122,65,30,203,148,1017
2733,Jack Cooley,2010,2013,Notre Dame,Big East,123,2435,394,656,393,654,1,2,228,344,346,446,792,66,54,116,110,250,1017
2734,Frank Davis,2008,2010,Tennessee Tech,OVC,94,2638,325,775,94,219,231,556,136,171,47,139,186,178,123,3,142,159,1017
2735,TyShwan Edmondson,2009,2012,Total,Total,91,2333,373,909,235,525,138,384,133,181,92,186,278,142,125,23,169,178,1017
2736,Brandon Venturini,2012,2015,Navy,Patriot,114,2787,374,1008,167,396,207,612,62,97,19,282,301,230,122,7,188,203,1017
2737,Andre Fox,2016,2018,High Point,Big South,91,2231,325,773,215,477,110,296,256,327,73,263,336,125,78,34,166,166,1016
2738,C.J. Jackson,2017,2019,Ohio State,Big Ten,100,2693,337,825,185,406,152,419,190,251,47,300,347,342,102,13,191,187,1016
2739,Robert Jarvis,2008,2009,Oral Roberts,Summit,61,1974,328,827,159,368,169,459,191,234,18,135,153,124,60,4,140,116,1016
2740,Lamont Middleton,2013,2014,North Carolina A&T,MEAC,69,2267,274,783,194,508,80,275,388,518,96,208,304,149,68,14,198,157,1016
2741,Ralph Sampson,2009,2012,Minnesota,Big Ten,125,3092,394,812,388,775,6,37,222,303,196,434,630,189,52,203,168,300,1016
2742,Nic Simpson,2009,2012,North Carolina A&T,MEAC,109,2395,304,831,125,294,179,537,229,293,53,156,209,113,83,6,146,163,1016
2743,D'Marques Tyson,2015,2018,Portland,WCC,120,2327,337,794,82,189,255,605,87,106,40,227,267,71,44,11,96,194,1016
2744,Christian Webster,2010,2013,Harvard,Ivy,117,3129,314,797,138,318,176,479,212,254,77,234,311,161,92,23,200,167,1016
2745,Payton Banks,2015,2018,Total,Total,122,2850,337,919,152,373,185,546,156,209,72,280,352,104,82,19,140,236,1015
2746,Wes Clark,2014,2018,Total,Total,107,2825,348,870,215,506,133,364,186,247,47,273,320,354,119,17,210,279,1015
2747,Cade Davis,2008,2011,Oklahoma,Big 12,125,2947,329,814,148,283,181,531,176,232,71,307,378,133,99,29,119,233,1015
2748,Delante Jones,2016,2019,Total,Total,86,2696,345,845,226,504,119,341,206,289,77,211,288,136,53,23,226,224,1015
2749,Daniel Ochefu,2013,2016,Villanova,Big East,141,3060,404,673,404,669,0,4,207,333,293,636,929,185,109,182,220,330,1015
2750,Chandler Rhoads,2010,2013,New Hampshire,AEC,114,3495,322,955,227,604,95,351,276,485,59,330,389,308,109,15,237,230,1015
2751,Andre Dawkins,2010,2014,Duke,ACC,142,2468,330,763,99,195,231,568,123,160,32,194,226,66,61,13,88,200,1014
2752,Colton Iverson,2009,2013,Total,Total,133,2760,379,694,379,694,0,0,256,454,277,487,764,120,59,118,208,297,1014
2753,Tyler Newbold,2008,2011,Utah State,WAC,139,3935,335,748,141,271,194,477,150,187,108,417,525,364,67,27,126,204,1014
2754,Kenneth Ogbe,2014,2018,Total,Total,123,2412,317,696,156,312,161,384,219,312,43,212,255,111,54,15,144,210,1014
2755,Lenzelle Smith,2011,2014,Ohio State,Big Ten,131,3104,349,795,218,423,131,372,185,266,139,412,551,194,87,13,136,210,1014
2756,Kentavious Caldwell-Pope,2012,2013,Georgia,SEC,64,2114,338,814,189,375,149,439,188,250,82,310,392,96,123,28,100,139,1013
2757,Austin Chatman,2012,2015,Creighton,Total,139,3739,323,832,202,498,121,334,246,313,55,311,366,493,76,4,244,249,1013
2758,Holden Greiner,2010,2013,Lehigh,Patriot,124,2753,369,781,264,490,105,291,170,226,130,423,553,118,104,80,145,194,1013
2759,JaJuan Johnson,2014,2017,Marquette,Big East,115,2519,379,834,297,581,82,253,173,221,63,271,334,222,153,35,179,147,1013
2760,Drew Kelly,2011,2014,Morehead State,OVC,123,2785,339,758,275,545,64,213,271,365,196,326,522,103,81,29,179,407,1013
2761,Malcolm Miller,2012,2015,Holy Cross,Patriot,112,2917,332,746,227,462,105,284,244,319,83,449,532,164,93,143,175,276,1013
2762,Kasey Shepherd,2013,2016,Louisiana,Sun Belt,123,2190,331,789,169,348,162,441,189,222,47,212,259,192,148,11,177,166,1013
2763,Eric Stuteville,2014,2017,Sacramento State,Big Sky,125,2595,403,717,402,713,1,4,206,368,227,331,558,34,22,149,150,315,1013
2764,Robert Carter,2013,2016,Total,Total,90,2383,391,792,333,597,58,195,172,252,164,487,651,123,69,102,170,220,1012
2765,Donta Hall,2016,2019,Alabama,SEC,135,2809,399,603,398,602,1,1,213,351,280,570,850,63,73,227,127,287,1012
2766,Jordan Hamilton,2010,2011,Texas,Big 12,70,1835,366,852,218,459,148,393,132,186,106,296,402,126,58,35,124,107,1012
2767,Cornelius Hester,2008,2011,Alabama A&M,SWAC,85,2370,373,1017,230,545,143,472,123,159,88,203,291,126,92,12,137,130,1012
2768,Chris Martin,2009,2012,Wagner,NEC,117,2620,323,850,128,323,195,527,171,230,31,186,217,189,112,4,201,260,1012
2769,Terrell Miller Jr.,2017,2018,Murray State,OVC,65,1955,362,741,225,398,137,343,151,200,112,432,544,96,52,23,138,188,1012
2770,Andre Roberson,2011,2013,Colorado,Total,105,2970,382,741,332,598,50,143,198,340,309,736,1045,119,164,150,183,274,1012
2771,Jake Robinson,2008,2010,Western Carolina,Southern,96,2134,320,791,106,222,214,569,158,203,105,171,276,107,41,19,104,194,1012
2772,Terrell Lewis,2015,2019,Eastern Illinois,OVC,102,3508,316,820,107,307,209,513,170,229,53,157,210,506,111,1,213,191,1011
2773,Jarelle Reischel,2012,2016,Total,Total,129,2337,325,701,253,500,72,201,289,414,106,334,440,158,104,23,230,249,1011
2774,Jordan Swing,2010,2014,Total,Total,114,2724,339,811,203,403,136,408,197,251,91,339,430,207,84,28,165,209,1011
2775,Jake Toolson,2015,2019,Total,Total,104,2425,352,688,229,391,123,297,184,216,63,301,364,198,53,15,149,118,1011
2776,Alex Kirk,2011,2014,New Mexico,MWC,101,2552,386,791,351,652,35,139,203,297,191,494,685,64,36,168,132,229,1010
2777,Steve Moundou-Missi,2012,2015,Harvard,Ivy,123,2749,372,732,366,714,6,18,260,361,200,467,667,67,95,128,151,280,1010
2778,Joe Burton,2010,2013,Oregon State,Total,130,3117,416,823,412,811,4,12,173,291,234,495,729,315,131,35,290,282,1009
2779,Jordan Crawford,2008,2010,Total,Total,65,1905,367,806,258,522,109,284,166,217,68,199,267,170,75,13,143,106,1009
2780,Rapheal Davis,2013,2016,Purdue,Big Ten,131,3224,333,766,263,547,70,219,273,376,148,371,519,231,75,37,176,261,1009
2781,James Haarsma,2009,2013,Total,Total,118,2863,358,735,317,619,41,116,252,357,251,374,625,78,82,27,164,329,1009
2782,Akeem Johnson,2010,2013,St. Francis (NY),NEC,113,2560,377,717,377,717,0,0,255,403,226,306,532,81,64,73,161,205,1009
2783,Tawaski King,2011,2014,Western Carolina,Southern,134,3285,393,816,393,815,0,1,223,359,291,389,680,73,87,39,207,351,1009
2784,Marcus Walker,2008,2009,Colorado State,MWC,59,1937,369,864,259,517,110,347,161,207,33,129,162,142,64,4,133,139,1009
2785,Charlie Westbrook,2011,2012,South Dakota,Total,58,1762,370,784,313,619,57,165,212,292,54,199,253,98,82,42,140,136,1009
2786,DeVon Barnett,2014,2018,Sacred Heart,NEC,107,2546,433,804,433,798,0,6,142,247,177,328,505,86,71,54,160,286,1008
2787,Travis Betran,2013,2014,Austin Peay,OVC,61,2069,325,789,166,373,159,416,199,231,18,94,112,152,62,12,155,83,1008
2788,Darrell Davis,2015,2018,Dayton,A-10,130,3036,321,815,130,308,191,507,175,219,29,292,321,188,60,8,174,232,1008
2789,Jeff Dowtin,2017,2019,Rhode Island,A-10,99,3035,375,824,285,575,90,249,168,241,62,202,264,380,94,38,127,160,1008
2790,Ledrick Eackles,2010,2014,Total,Total,107,2131,301,834,186,474,115,360,291,398,85,244,329,159,112,13,181,215,1008
2791,Matt Kingsley,2008,2009,Stephen F. Austin,Southland,64,1836,384,706,384,704,0,2,240,338,127,301,428,48,34,70,113,161,1008
2792,Tyler Kohl,2018,2019,Central Connecticut State,NEC,58,2005,335,820,251,548,84,272,254,310,104,338,442,251,80,5,214,124,1008
2793,Deyshonee Much,2014,2018,Total,Total,111,2579,345,829,136,308,209,521,109,142,71,268,339,185,116,19,143,183,1008
2794,Xavier Sneed,2017,2019,Kansas State,Big 12,105,2813,337,818,180,361,157,457,177,249,115,344,459,151,137,29,117,240,1008
2795,Jason Burnell,2016,2019,Total,Total,90,2154,362,738,294,526,68,212,215,272,181,375,556,169,71,69,127,209,1007
2796,Drew Gordon,2009,2012,Total,Total,101,2323,407,752,405,748,2,4,191,277,258,551,809,71,74,96,173,241,1007
2797,Charles Matthews,2016,2019,Total,Total,111,2674,381,821,317,613,64,208,181,314,136,321,457,160,81,48,160,183,1007
2798,Daniel Miller,2011,2014,Georgia Tech,ACC,126,3627,423,803,423,802,0,1,161,257,262,559,821,183,125,286,186,257,1007
2799,Ashton Mitchell,2008,2010,Sam Houston State,Southland,94,2614,315,727,211,422,104,305,273,363,47,224,271,500,161,17,276,242,1007
2800,Curtis Phillips,2015,2018,Total,Total,95,2473,324,831,193,445,131,386,228,320,93,327,420,144,118,40,191,216,1007
2801,Rodrick Sikes,2018,2019,South Alabama,Sun Belt,66,1999,312,763,144,294,168,469,215,287,19,145,164,48,62,11,95,111,1007
2802,Brock Stull,2016,2019,Total,Total,128,2879,354,858,208,475,146,383,153,198,74,399,473,237,60,9,175,153,1007
2803,Dustin Ware,2009,2012,Georgia,SEC,128,3823,306,808,112,272,194,536,201,250,29,249,278,400,119,3,186,193,1007
2804,Charlie Brown,2017,2019,Saint Joseph's,A-10,63,2199,334,820,200,459,134,361,204,244,99,253,352,81,58,46,95,150,1006
2805,Justin Burrell,2008,2011,St. John's (NY),Big East,123,3014,373,827,360,784,13,43,247,365,187,422,609,90,53,73,236,355,1006
2806,Bryan Davis,2008,2010,Texas A&M,Big 12,104,2595,358,690,357,688,1,2,289,479,244,433,677,133,102,141,225,310,1006
2807,Hugh Greenwood,2012,2015,New Mexico,MWC,130,3843,342,885,155,338,187,547,135,198,108,512,620,372,149,61,166,294,1006
2808,Terry Henderson,2013,2017,Total,Total,91,2355,328,755,161,321,167,434,183,231,89,165,254,107,60,40,109,149,1006
2809,Twymond Howard,2013,2016,Total,Total,80,2378,359,786,316,662,43,124,245,339,106,367,473,143,55,34,140,168,1006
2810,Jonathan Kasibabu,2016,2019,Fairfield,MAAC,127,2711,376,648,349,563,27,85,227,343,261,479,740,147,75,141,227,439,1006
2811,Parker Kelly,2012,2015,Eastern Washington,Big Sky,126,3466,309,744,99,229,210,515,178,213,48,250,298,119,57,25,90,278,1006
2812,Freddie Riley,2010,2013,Massachusetts,A-10,125,2627,365,980,134,292,231,688,45,91,35,170,205,100,68,11,118,125,1006
2813,Tommy Hamilton,2014,2018,Total,Total,129,2798,355,791,257,553,98,238,197,286,151,436,587,110,54,61,225,263,1005
2814,Kyndahl Hill,2014,2017,Weber State,Big Sky,130,3224,343,663,318,580,25,83,294,388,222,511,733,110,65,126,169,375,1005
2815,Matt Lewis,2018,2019,James Madison,CAA,65,2217,304,798,190,453,114,345,283,351,55,202,257,171,61,17,127,128,1005
2816,Jordan Lyons,2017,2019,Furman,Southern,100,2237,338,874,127,257,211,617,118,156,24,150,174,136,74,3,152,96,1005
2817,J.J. Moore,2011,2014,Total,Total,127,2380,337,784,223,424,114,360,217,281,113,222,335,74,73,18,103,188,1005
2818,Anton Wilson,2013,2016,Detroit Mercy,Horizon,126,2755,325,748,120,249,205,499,150,174,67,253,320,183,95,33,140,250,1005
2819,Chris Czerapowicz,2011,2014,Davidson,Southern,121,2732,371,891,199,385,172,506,90,126,119,395,514,70,39,34,89,277,1004
2820,Quincy Diggs,2010,2014,Total,Total,131,2830,338,781,226,465,112,316,215,315,87,323,410,222,143,13,246,213,1003
2821,Terell Gomez,2018,2019,Cal State Northridge,Big West,64,2304,335,753,153,333,182,420,151,177,24,118,142,205,55,0,122,95,1003
2822,Cordarius Johnson,2011,2014,Louisiana Tech,Total,136,2750,347,919,182,386,165,533,144,226,127,304,431,107,119,23,164,199,1003
2823,Marcel White,2014,2017,Jacksonville,A-Sun,105,2441,320,759,161,357,159,402,204,297,84,267,351,75,62,38,106,199,1003
2824,Isaiah Wright,2015,2019,Total,Total,127,3135,321,735,194,383,127,352,234,310,24,326,350,426,96,12,246,247,1003
2825,Nico Carvacho,2017,2019,Colorado State,MWC,100,2729,395,710,388,689,7,21,205,371,334,613,947,182,58,60,174,294,1002
2826,Al Fisher,2008,2009,Kent State,MAC,69,2199,336,831,252,566,84,265,246,293,46,203,249,261,100,11,258,155,1002
2827,Domantas Sabonis,2015,2016,Gonzaga,WCC,74,1971,384,608,379,594,5,14,229,314,192,502,694,97,39,43,151,219,1002
2828,Jake Wright,2015,2019,Total,Total,123,3037,326,823,62,152,264,671,86,98,15,171,186,66,44,4,71,134,1002
2829,Sean Lloyd,2016,2019,Southern Illinois,MVC,110,3044,342,768,253,530,89,238,228,321,97,303,400,145,112,32,174,229,1001
2830,Carlos Medlock,2008,2010,Eastern Michigan,MAC,63,2130,273,704,135,294,138,410,317,391,40,174,214,248,84,3,219,172,1001
2831,Zach Nelson,2014,2018,Utah Valley,WAC,119,2859,386,775,310,513,76,262,153,229,152,438,590,246,65,80,217,254,1001
2832,Sam Thompson,2012,2015,Ohio State,Big Ten,146,3344,378,801,305,570,73,231,172,260,88,314,402,155,101,111,123,221,1001
2833,Bjorn Broman,2016,2019,Winthrop,Big South,125,3637,288,761,64,143,224,618,200,248,47,224,271,297,105,12,127,227,1000
2834,Ryan Daly,2017,2018,Delaware,CAA,60,2121,367,858,259,527,108,331,158,241,107,304,411,133,60,11,74,126,1000
2835,Seth Dugan,2016,2019,Western Michigan,MAC,119,2574,403,755,401,738,2,17,192,324,282,432,714,111,35,81,178,270,1000
2836,Josh Kozinski,2014,2018,Central Michigan,MAC,142,3244,323,915,17,38,306,877,48,63,43,251,294,65,88,15,27,250,1000
2837,Keon Moore,2014,2015,Winthrop,Big South,61,1855,321,729,156,332,165,397,193,229,46,233,279,84,78,14,101,118,1000
2838,Trayvon Palmer,2015,2017,Chicago State,WAC,92,2792,360,805,294,598,66,207,214,299,239,440,679,112,112,68,216,274,1000
2839,Rodriguez Sherman,2008,2011,Kent State,MAC,105,2790,355,854,273,597,82,257,208,300,109,248,357,250,138,13,210,231,1000
2840,Jeff Teague,2008,2009,Wake Forest,ACC,61,1883,315,682,238,499,77,183,293,361,31,153,184,184,113,35,180,138,1000
2841,Troy Cotton,2008,2010,Green Bay,Horizon,98,2659,331,793,113,255,218,538,119,145,59,170,229,99,60,2,94,207,999
2842,Jarell Flora,2012,2015,Seattle,Total,117,2650,363,864,189,401,174,463,99,134,92,248,340,104,87,20,155,135,999
2843,Darius Gardner,2011,2015,Total,Total,127,3862,338,761,236,500,102,261,221,298,76,267,343,448,197,18,297,263,999
2844,Derrick Henry,2012,2016,Total,Total,111,2234,308,797,216,474,92,323,291,391,59,204,263,104,70,3,129,133,999
2845,Julius Mays,2009,2013,Total,Total,121,3091,299,765,150,372,149,393,252,299,48,206,254,268,89,9,176,228,999
2846,Anthony Odunsi,2012,2016,Total,Total,94,2136,273,590,249,514,24,76,429,536,44,230,274,208,77,4,234,153,999
2847,Jamie Skeen,2008,2011,Total,Total,96,2359,341,686,276,504,65,182,252,372,198,332,530,101,60,66,119,147,999
2848,Ramone Snowden,2014,2018,Total,Total,128,3668,310,730,189,398,121,332,258,406,181,459,640,252,132,46,228,381,999
2849,Deng Adel,2016,2018,Louisville,ACC,89,2386,350,799,249,509,101,290,197,254,55,314,369,178,47,24,148,133,998
2850,D.J. Cunningham,2010,2014,North Carolina-Asheville,Big South,112,2650,394,815,393,811,1,4,209,317,274,545,819,97,85,278,221,326,998
2851,Michael Frazier,2013,2015,Florida,SEC,101,2593,318,718,91,192,227,526,135,158,61,296,357,114,94,10,122,159,998
2852,Jonathan Gilling,2012,2015,Arizona State,Pac-12,132,3579,323,784,65,146,258,638,94,138,57,414,471,272,76,28,184,287,998
2853,Trey McKinney-Jones,2009,2013,Total,Total,130,3323,343,772,219,430,124,342,188,254,70,375,445,202,84,7,171,288,998
2854,Drew Windler,2011,2014,Total,Total,97,2152,333,691,159,294,174,397,158,215,84,236,320,120,54,66,160,267,998
2855,Terry Winn,2015,2019,Total,Total,92,2280,366,793,363,773,3,20,263,403,125,399,524,98,57,39,162,229,998
2856,Kevin Butler,2009,2013,Total,Total,129,3096,348,784,276,567,72,217,229,337,240,354,594,126,145,27,165,302,997
2857,Taylor Darby,2009,2012,Pepperdine,WCC,125,3224,368,828,368,828,0,0,261,446,325,413,738,74,52,52,152,303,997
2858,Melvin Frazier,2016,2018,Tulane,AAC,94,2601,359,746,278,486,81,260,198,303,115,298,413,156,152,45,187,189,997
2859,Travon Baker,2013,2016,Northern Illinois,MAC,126,3306,293,866,148,397,145,469,265,362,53,243,296,356,184,9,257,278,996
2860,Ron Burks,2009,2012,Virginia Military Institute,Big South,118,3214,330,836,209,448,121,388,215,305,122,406,528,382,170,30,277,271,996
2861,Marcel Davis,2013,2016,Total,Total,118,3223,342,809,264,575,78,234,234,345,62,320,382,453,106,9,252,235,996
2862,Taveion Hollingsworth,2018,2019,Western Kentucky,CUSA,72,2563,345,773,251,500,94,273,212,271,66,213,279,147,80,13,139,123,996
2863,Kenny Kadji,2009,2013,Total,Total,110,2395,370,773,295,571,75,202,181,290,152,361,513,57,40,124,146,215,996
2864,Miles Reynolds,2015,2019,Total,Total,121,2609,273,674,234,533,39,141,411,538,41,227,268,230,99,7,181,242,996
2865,Kavon Stewart,2014,2017,Robert Morris,NEC,127,3458,291,815,254,672,37,143,376,584,65,253,318,503,200,4,364,271,995
2866,Temidayo Yussuf,2015,2019,Long Beach State,Big West,125,2200,360,749,360,748,0,1,275,459,242,366,608,130,44,46,216,343,995
2867,Reggie Chamberlain,2009,2012,Total,Total,94,2371,327,739,147,317,180,422,160,188,38,140,178,184,72,7,132,184,994
2868,Zylan Cheatham,2016,2019,Total,Total,103,2618,331,627,315,573,16,54,316,460,204,546,750,187,83,71,235,263,994
2869,Donte McGill,2016,2017,Florida International,CUSA,58,1918,371,804,310,642,61,162,191,221,97,142,239,69,61,6,124,113,994
2870,Caleb Swanigan,2016,2017,Purdue,Big Ten,69,2014,352,703,293,546,59,157,231,304,150,568,718,168,27,36,208,172,994
2871,James Dews,2008,2010,Miami (FL),ACC,99,2741,362,850,208,419,154,431,115,142,58,223,281,156,86,18,99,216,993
2872,B.J. Holmes,2008,2011,Texas A&M,Big 12,130,2803,273,704,89,239,184,465,263,330,55,211,266,228,109,5,144,210,993
2873,Spencer Johnson,2008,2011,Missouri-Kansas City,Summit,121,2951,352,792,240,468,112,324,177,273,247,463,710,63,80,29,120,317,993
2874,Jalen Lindsey,2015,2018,Providence,Big East,131,3559,321,785,104,200,217,585,134,185,138,313,451,80,90,36,76,223,993
2875,Christian Mekowulu,2015,2019,Total,Total,118,2744,323,681,318,664,5,17,342,503,231,461,692,62,68,117,202,352,993
2876,William Mosley,2009,2012,Northwestern State,Southland,124,3392,393,635,393,634,0,1,207,515,410,704,1114,112,146,455,136,345,993
2877,A.J. Price,2008,2009,Connecticut,Big East,68,2172,330,783,196,438,134,345,199,271,45,194,239,356,67,3,172,97,993
2878,Jerome Tillman,2008,2009,Ohio,MAC,64,2073,335,654,284,508,51,146,272,364,153,347,500,74,69,31,143,172,993
2879,Wesley Witherspoon,2009,2012,Memphis,CUSA,121,2545,316,676,242,485,74,191,287,397,129,315,444,130,143,64,173,321,993
2880,Michael Bramos,2008,2009,Miami (OH),MAC,58,2029,323,775,187,397,136,378,210,251,33,200,233,84,65,75,97,102,992
2881,Brandon Brown,2008,2011,Lipscomb,A-Sun,113,2740,369,719,332,579,37,140,217,352,215,396,611,108,88,49,171,263,992
2882,Gordon Hayward,2009,2010,Butler,Horizon,69,2284,298,634,182,320,116,314,280,340,118,394,512,125,88,60,138,142,992
2883,Frank Howard,2016,2019,Syracuse,ACC,131,3069,342,940,204,509,138,431,170,249,57,227,284,435,166,23,270,255,992
2884,Aaron Johnson,2008,2011,Alabama-Birmingham,CUSA,133,3975,299,696,231,475,68,221,326,434,36,245,281,664,170,2,355,354,992
2885,Reggie Spencer,2012,2015,Northeastern,CAA,125,3192,375,744,374,742,1,2,241,361,238,410,648,128,63,77,186,341,992
2886,Josh Thornton,2008,2010,Towson,CAA,85,2209,345,866,121,292,224,574,78,115,40,132,172,105,67,7,132,105,992
2887,Myke Henry,2012,2016,Total,Total,120,2344,384,808,308,580,76,228,147,209,176,289,465,76,81,36,178,270,991
2888,Anthony Mosley,2015,2018,Delaware,CAA,121,3178,325,699,306,642,19,57,322,454,70,326,396,279,127,34,229,271,991
2889,Clancy Rugg,2011,2014,Vermont,AEC,124,2395,290,565,265,477,25,88,386,497,168,336,504,64,53,62,140,163,991
2890,Duda Sanadze,2014,2016,San Diego,WCC,91,2125,335,872,221,486,114,386,207,274,67,240,307,85,60,20,156,196,991
2891,Sylvester Seay,2009,2010,Fresno State,WAC,67,1989,345,768,259,507,86,261,215,305,124,272,396,87,69,94,151,184,991
2892,Tyrone Kent,2008,2009,Toledo,MAC,62,2120,326,850,207,459,119,391,219,300,78,202,280,158,95,33,247,154,990
2893,Kawhi Leonard,2010,2011,San Diego State,MWC,70,2236,377,840,336,676,41,164,195,262,230,486,716,156,98,45,153,174,990
2894,Donte Thomas,2015,2018,Bradley,MVC,127,2691,370,769,334,620,36,149,214,312,211,507,718,101,86,74,190,331,990
2895,Reggie Bullock,2011,2013,North Carolina,ACC,100,2457,358,815,170,329,188,486,85,118,156,339,495,169,87,21,94,121,989
2896,Adonis Filer,2013,2017,Total,Total,128,2709,315,837,220,519,95,318,264,348,82,278,360,219,106,4,203,243,989
2897,Kenny Hayes,2008,2010,Miami (OH),MAC,73,2409,333,752,228,480,105,272,218,274,33,185,218,188,50,15,164,146,989
2898,Greg Mays,2012,2015,Green Bay,Horizon,122,2608,387,735,370,672,17,63,198,308,144,382,526,69,44,108,158,233,989
2899,Ben Millaud-Meunier,2013,2016,Saint Francis (PA),NEC,112,2243,289,737,77,189,212,548,199,237,33,194,227,117,59,5,130,117,989
2900,Xavier Pollard,2012,2016,Total,Total,102,2452,373,829,326,639,47,190,196,307,77,285,362,302,115,13,221,247,989
2901,Ryan White,2008,2011,Texas State,Southland,117,2691,273,753,185,467,88,286,355,448,70,251,321,414,154,5,335,279,989
2902,Jacorey Williams,2013,2017,Total,Total,132,2208,412,856,405,819,7,37,158,248,134,351,485,127,75,48,139,199,989
2903,Jay Bowie,2011,2014,Marist,MAAC,114,2962,341,762,198,418,143,344,163,201,142,383,525,116,92,30,155,276,988
2904,Daniel Broughton,2011,2014,Arkansas-Pine Bluff,SWAC,111,2543,379,884,346,795,33,89,197,315,158,393,551,78,75,62,224,387,988
2905,Andrew Fleming,2017,2019,Maine,AEC,87,2663,385,853,350,731,35,122,183,291,160,382,542,159,69,65,217,250,988
2906,Nino Johnson,2012,2015,Southeast Missouri State,OVC,119,2755,369,661,367,652,2,9,248,434,221,509,730,117,100,182,207,298,988
2907,Luke Meyer,2015,2018,Central Michigan,MAC,133,2676,369,677,280,437,89,240,161,199,185,384,569,63,49,131,90,319,988
2908,Anthony Collins,2012,2016,Total,Total,138,4374,346,813,287,657,59,156,236,298,34,249,283,724,194,22,344,306,987
2909,Tyler Lamb,2011,2015,Total,Total,121,2803,338,878,209,499,129,379,182,241,69,283,352,210,129,37,211,225,987
2910,Ty Lawson,2008,2009,North Carolina,ACC,67,1858,322,614,241,423,81,191,262,323,38,153,191,395,126,6,136,115,987
2911,Jerome Seagears,2012,2016,Total,Total,125,3235,335,850,192,456,143,394,174,225,88,227,315,385,104,12,203,272,987
2912,Seth VanDeest,2010,2014,Drake,MVC,125,2802,346,651,342,635,4,16,291,418,174,401,575,138,46,114,148,337,987
2913,Skyler Flatten,2015,2019,South Dakota State,Summit,127,2905,349,726,166,298,183,428,105,146,43,274,317,148,78,36,87,132,986
2914,Zaynah Robinson,2015,2019,Total,Total,135,3311,341,876,201,473,140,403,164,215,18,271,289,369,144,7,143,202,986
2915,Tanner Smith,2009,2012,Clemson,ACC,127,3166,333,777,222,437,111,340,209,288,96,363,459,320,159,34,227,258,986
2916,Dar Tucker,2008,2009,DePaul,Big East,61,1723,346,849,238,489,108,360,186,274,106,206,312,78,73,18,128,125,986
2917,Anthony Vereen,2008,2009,Texas-Arlington,Southland,63,1641,322,560,304,504,18,56,324,426,104,248,352,121,44,7,128,187,986
2918,Brenton Williams,2012,2014,South Carolina,SEC,88,2005,297,700,128,290,169,410,223,252,28,111,139,101,74,6,97,115,986
2919,Jerry Evans,2011,2014,Nevada,Total,126,3259,344,805,235,491,109,314,188,251,216,407,623,100,92,53,149,293,985
2920,Amere May,2012,2015,Delaware State,MEAC,85,1984,346,853,223,534,123,319,170,227,61,158,219,119,62,18,152,90,985
2921,Rod Odom,2011,2014,Vanderbilt,SEC,134,3165,322,833,139,341,183,492,158,239,158,314,472,96,56,56,143,290,985
2922,Clemmye Owens,2014,2017,Total,Total,93,2603,354,888,186,408,168,480,109,147,55,143,198,142,93,8,129,173,985
2923,Kannon Burrage,2012,2013,Texas-San Antonio,Total,64,1909,319,796,218,512,101,284,245,316,84,180,264,86,61,3,132,121,984
2924,Jeantal Cylla,2016,2019,Total,Total,96,2460,336,833,236,512,100,321,212,270,101,262,363,47,48,42,119,229,984
2925,Jordan Eglseder,2008,2010,Northern Iowa,MVC,95,1842,406,748,392,696,14,52,158,218,200,407,607,63,25,112,122,173,984
2926,DeAndre Hall,2009,2010,Texas Southern,SWAC,65,2016,393,824,372,757,21,67,177,291,100,210,310,143,97,18,189,176,984
2927,Tymell Murphy,2013,2014,Florida International,Total,63,2040,394,680,369,596,25,84,171,258,142,306,448,132,115,83,172,180,984
2928,Tylor Ongwae,2014,2015,Louisiana-Monroe,Sun Belt,65,2210,349,844,297,641,52,203,234,292,141,266,407,149,67,30,144,160,984
2929,Deondre Parks,2015,2016,South Dakota State,Summit,68,2182,331,779,211,439,120,340,202,257,42,252,294,117,48,10,118,159,984
2930,Travin Thibodeaux,2015,2018,New Orleans,Southland,117,2810,376,716,360,670,16,46,216,342,190,487,677,223,132,87,231,354,984
2931,Hameed Ali,2012,2016,Texas A&M-Corpus Christi,Southland,128,3322,341,963,231,618,110,345,191,251,47,214,261,363,193,23,181,279,983
2932,Wayne Martin,2014,2017,Total,Total,91,2246,389,744,379,699,10,45,195,313,236,464,700,44,64,104,201,242,983
2933,Malik Morgan,2013,2017,Total,Total,117,2964,345,853,216,459,129,394,164,248,145,366,511,278,134,45,215,285,983
2934,Vander Blue,2011,2013,Marquette,Big East,106,2727,352,820,300,632,52,188,226,321,109,262,371,212,109,15,208,184,982
2935,Tory Jackson,2008,2010,Notre Dame,Big East,104,3615,356,879,266,614,90,265,180,301,122,299,421,555,152,17,257,236,982
2936,Alize Johnson,2017,2018,Missouri State,MVC,66,2025,341,746,260,497,81,249,219,306,214,521,735,157,35,20,150,152,982
2937,Denton Koon,2012,2016,Total,Total,112,2956,367,777,288,554,79,223,169,244,158,312,470,132,57,37,171,198,982
2938,Steven Roundtree,2011,2013,Oral Roberts,Total,92,2411,370,684,369,673,1,11,241,367,238,312,550,142,90,40,207,284,982
2939,Kethan Savage,2013,2017,Total,Total,113,2488,322,736,274,565,48,171,290,404,80,299,379,191,106,40,178,220,982
2940,Dylan Talley,2010,2013,Total,Total,84,2528,344,890,227,545,117,345,177,240,69,268,337,180,72,26,182,175,982
2941,Darren Collison,2008,2009,UCLA,Pac-10,68,2247,336,679,242,474,94,205,215,243,33,137,170,290,118,8,161,97,981
2942,Terrance Hill,2009,2012,Morehead State,OVC,118,2625,322,839,149,364,173,475,164,201,43,183,226,141,100,5,177,196,981
2943,Dazon Ingram,2016,2019,Alabama,SEC,108,2830,305,647,248,487,57,160,314,462,101,413,514,310,85,27,252,289,981
2944,Steve McNees,2008,2011,Akron,MAC,141,3505,303,856,82,218,221,638,154,224,54,216,270,318,86,15,178,267,981
2945,Khris Middleton,2010,2012,Texas A&M,Big 12,87,2263,340,789,248,502,92,287,209,272,131,265,396,175,87,17,173,187,981
2946,Richard Ross,2012,2015,Old Dominion,Total,128,3250,424,772,418,753,6,19,127,242,285,440,725,110,98,214,170,283,981
2947,Larry Wright,2008,2011,Total,Total,98,2305,322,795,170,376,152,419,185,219,39,203,242,171,66,19,143,210,981
2948,Jeff Adrien,2008,2009,Connecticut,Big East,69,2360,363,721,361,716,2,5,252,415,201,459,660,102,35,83,154,136,980
2949,Bakari Copeland,2014,2017,Total,Total,83,1948,313,689,249,508,64,181,290,381,65,307,372,106,33,13,148,182,980
2950,Matej Kavas,2017,2019,Seattle,WAC,84,2137,334,725,157,329,177,396,135,176,63,295,358,72,25,17,110,184,980
2951,Anthony Mathis,2016,2019,New Mexico,MWC,101,1948,295,666,73,151,222,515,168,191,31,135,166,117,62,9,102,196,980
2952,Justin Pierce,2017,2019,William & Mary,CAA,88,2251,360,751,262,467,98,284,162,237,132,444,576,205,72,39,140,159,980
2953,Corey Allmond,2009,2010,Sam Houston State,Southland,63,1944,338,773,143,289,195,484,108,140,28,127,155,156,71,0,101,93,979
2954,Brandon Ashley,2013,2015,Arizona,Pac-12,95,2383,352,678,326,610,26,68,249,344,164,346,510,71,55,59,146,272,979
2955,DeJuan Blair,2008,2009,Pittsburgh,Big East,72,1918,394,694,394,694,0,0,191,311,339,430,769,77,116,75,115,204,979
2956,Aaron Harrison,2014,2015,Kentucky,SEC,79,2307,320,781,199,420,121,361,218,277,40,178,218,129,86,18,100,146,979
2957,Brett Harvey,2008,2010,Loyola (MD),MAAC,90,2581,264,726,127,337,137,389,314,356,55,197,252,245,63,6,144,186,979
2958,Kyle Kuric,2009,2012,Louisville,Big East,118,2808,348,757,179,309,169,448,114,150,130,249,379,102,96,30,82,182,979
2959,Mike Lewis II,2017,2019,Duquesne,A-10,76,2220,301,761,137,307,164,454,213,259,24,132,156,81,61,4,110,142,979
2960,Ferg Myrick,2010,2013,New Hampshire,AEC,95,2213,329,868,234,584,95,284,226,344,122,277,399,78,71,51,208,210,979
2961,Jordan Capps,2014,2018,Total,Total,100,1926,388,720,361,643,27,77,175,349,157,318,475,57,33,69,149,231,978
2962,Majok Deng,2015,2016,Louisiana-Monroe,Sun Belt,69,2292,337,729,237,453,100,276,204,257,135,362,497,103,44,102,122,162,978
2963,Mike Felt,2010,2014,North Dakota State,Summit,132,2294,315,779,71,172,244,607,104,124,32,153,185,72,45,7,76,196,978
2964,Jourdan Grant,2015,2018,Maryland-Baltimore County,AEC,129,3348,328,772,258,552,70,220,252,420,57,369,426,349,125,21,273,294,978
2965,Bryquis Perine,2008,2011,Green Bay,Horizon,127,2905,342,883,264,634,78,249,216,287,36,184,220,312,105,8,200,175,978
2966,Josh Williams,2016,2019,Total,Total,104,2539,318,815,92,222,226,593,116,155,56,198,254,163,65,9,170,165,978
2967,Manny Arop,2010,2014,Total,Total,124,2674,355,805,253,500,102,305,165,227,138,377,515,104,65,37,164,217,977
2968,Torrion Brummitt,2013,2016,Western Carolina,Southern,115,2243,362,760,352,694,10,66,243,389,170,393,563,103,78,72,206,362,977
2969,Phil Cofer,2015,2019,Florida State,ACC,133,2870,358,780,269,537,89,243,172,260,146,341,487,59,39,36,139,177,977
2970,Jordan Cornish,2015,2019,Total,Total,127,3106,324,912,169,452,155,460,174,267,34,319,353,306,53,18,254,199,977
2971,Ian Miller,2011,2014,Florida State,ACC,107,2349,324,802,178,394,146,408,183,227,37,175,212,193,89,3,193,184,977
2972,Maurice Ndour,2014,2015,Ohio,MAC,66,2131,346,695,301,579,45,116,240,317,126,376,502,106,55,123,178,178,977
2973,Armel Potter,2016,2019,Total,Total,89,2479,350,832,265,568,85,264,192,305,34,185,219,253,66,7,139,136,977
2974,Mfon Udofia,2010,2013,Georgia Tech,ACC,128,3251,329,875,212,508,117,367,202,322,95,247,342,283,101,5,240,286,977
2975,Harold Washington,2012,2013,Canisius,MAAC,64,2138,334,756,248,537,86,219,223,289,61,154,215,160,62,3,192,119,977
2976,Shane Whitfield,2014,2018,Total,Total,133,3333,308,641,306,626,2,15,359,509,99,376,475,225,66,13,228,340,977
2977,Oshae Brissett,2018,2019,Syracuse,ACC,71,2532,309,832,224,555,85,277,273,371,157,425,582,95,76,56,138,154,976
2978,Remond Brown,2014,2017,Grambling,SWAC,96,2833,373,868,310,661,63,207,167,261,100,262,362,155,131,29,202,203,976
2979,Kwan Cheatham,2014,2017,Akron,MAC,127,2825,336,885,161,387,175,498,129,180,143,490,633,180,43,113,175,287,976
2980,Nico Clareth,2016,2018,Siena,MAAC,71,1856,352,852,211,425,141,427,131,184,65,175,240,132,90,36,171,201,976
2981,Dante Cunningham,2008,2009,Villanova,Big East,73,2249,386,726,386,724,0,2,204,294,199,311,510,84,93,78,162,210,976
2982,James Hulbin,2009,2013,Northwestern State,Southland,133,2152,346,774,271,552,75,222,209,331,183,377,560,61,70,65,131,238,976
2983,Damon Jones,2008,2010,Northwestern State,Southland,92,1907,354,846,202,437,152,409,116,150,115,111,226,49,43,13,119,90,976
2984,Trey Porter,2015,2019,Total,Total,127,2224,345,621,343,611,2,10,284,440,206,379,585,49,44,151,124,324,976
2985,Kyle Boswell,2011,2014,UC-Santa Barbara,Big West,111,2633,297,679,81,174,216,505,165,223,16,149,165,181,55,0,118,167,975
2986,Darius Conley,2010,2013,Saint Peter's,MAAC,122,2888,383,829,383,827,0,2,209,354,269,393,662,76,78,114,216,343,975
2987,Denver Holmes,2009,2012,Evansville,MVC,119,2889,333,744,235,488,98,256,211,260,17,183,200,269,61,13,207,293,975
2988,Reggie McAdams,2013,2016,Akron,MAC,131,2514,314,735,66,125,248,610,99,139,101,214,315,76,70,38,49,175,975
2989,Mario Moody,2012,2016,Total,Total,114,2289,369,758,331,641,38,117,199,292,244,408,652,64,92,176,166,297,975
2990,Nick Norton,2015,2019,Total,Total,114,3223,303,743,102,200,201,543,168,196,29,278,307,536,156,3,193,172,975
2991,Chris Singleton,2009,2011,Florida State,ACC,95,2761,336,802,232,487,104,315,199,336,189,397,586,140,180,136,227,290,975
2992,Edgar Sosa,2008,2010,Louisville,Big East,106,2413,330,789,178,366,152,423,163,240,38,139,177,303,74,7,208,217,975
2993,Darius Thompson,2014,2018,Total,Total,145,3309,344,746,240,438,104,308,183,257,48,282,330,394,149,45,165,211,975
2994,Aaron Valdes,2014,2016,Hawaii,Big West,94,2137,349,728,271,497,78,231,199,304,129,274,403,122,100,36,113,174,975
2995,Mike Washington,2008,2010,Arkansas,SEC,94,2104,356,703,338,620,18,83,245,392,226,383,609,67,58,100,148,272,975
2996,Bryce Aiken,2017,2019,Harvard,Ivy,58,1703,292,720,166,355,126,365,264,310,21,119,140,162,46,0,165,111,974
2997,Paul George,2009,2010,Fresno State,WAC,63,2138,320,716,198,408,122,308,212,264,118,304,422,151,123,58,173,176,974
2998,Ty Jerome,2017,2019,Virginia,ACC,103,2699,349,803,189,394,160,409,116,146,28,275,303,370,126,3,143,198,974
2999,Jonah Mathews,2017,2019,Southern California,Pac-12,102,2731,351,829,173,366,178,463,94,141,55,194,249,145,91,17,95,176,974
3000,Cedrick Williams,2012,2015,North Carolina-Wilmington,CAA,125,3319,376,793,367,756,9,37,213,316,331,437,768,89,95,173,139,347,974
3001,Jeremiah Bell,2017,2019,Total,Total,102,2620,342,852,194,426,148,426,141,206,29,231,260,181,74,8,126,191,973
3002,Mac Hopson,2009,2010,Idaho,WAC,63,2059,318,712,233,499,85,213,252,355,61,255,316,349,87,8,191,147,973
3003,Maurice Howard,2017,2019,Alcorn State,SWAC,95,2688,326,833,114,282,212,551,109,134,45,207,252,233,88,5,214,165,973
3004,Adam Kemp,2011,2014,Marist,MAAC,109,3055,356,718,356,718,0,0,261,432,302,523,825,61,61,225,185,335,973
3005,Rob Loe,2011,2014,Saint Louis,A-10,133,2822,342,809,209,401,133,408,156,224,153,367,520,153,76,88,174,321,973
3006,Tre' McLean,2015,2017,Chattanooga,Southern,97,2761,337,759,235,460,102,299,197,257,122,358,480,188,129,39,158,200,973
3007,Jordan Morgan,2011,2014,Michigan,Big Ten,142,2988,419,664,419,664,0,0,135,239,282,436,718,64,74,47,171,336,973
3008,Jontae Sherrod,2008,2011,East Carolina,CUSA,111,2357,303,753,172,387,131,366,236,310,55,204,259,160,92,4,215,251,973
3009,Devante Wallace,2012,2015,High Point,Big South,116,2599,334,779,150,345,184,434,121,158,131,339,470,137,81,61,120,202,973
3010,Evan Washington,2008,2011,Air Force,MWC,124,3969,340,745,295,619,45,126,248,411,100,445,545,327,108,47,252,218,973
3011,Ryan Olander,2009,2012,Fairfield,MAAC,136,3114,371,798,323,640,48,158,182,291,219,392,611,124,75,206,189,327,972
3012,Brandon Rozzell,2008,2011,Virginia Commonwealth,CAA,126,2523,335,814,142,304,193,510,109,142,31,200,231,124,137,10,104,175,972
3013,Kobe Webster,2018,2019,Western Illinois,Summit,59,1989,360,838,225,493,135,345,117,158,24,229,253,194,54,4,113,104,972
3014,Terrence Williams,2012,2015,Charlotte,Total,125,2930,326,857,271,662,55,195,265,372,103,389,492,228,92,21,244,296,972
3015,Tommy Brenton,2009,2013,Stony Brook,AEC,127,3798,315,631,295,554,20,77,321,506,351,763,1114,402,220,47,223,280,971
3016,Dwayne Collins,2008,2010,Miami (FL),ACC,94,2167,357,623,357,623,0,0,257,460,268,404,672,89,66,75,176,187,971
3017,Ronnie Drinnon,2013,2016,Saint Francis (PA),NEC,115,3005,388,795,365,718,23,77,172,296,309,495,804,131,95,44,144,290,971
3018,Muhammad El-Amin,2009,2010,Stony Brook,AEC,60,1710,339,812,236,529,103,283,190,235,67,137,204,93,51,7,135,120,971
3019,Dajuan Graf,2013,2017,Total,Total,135,3338,347,751,294,589,53,162,224,301,49,292,341,417,122,4,230,241,971
3020,Robbie Harman,2008,2010,Central Michigan,MAC,92,2699,319,786,101,237,218,549,115,155,30,149,179,220,137,7,187,257,971
3021,Kajon Mack,2013,2018,Total,Total,129,2848,330,778,239,491,91,287,220,293,107,332,439,261,110,38,168,227,971
3022,Youssou Ndoye,2012,2015,St. Bonaventure,A-10,123,2765,335,660,335,659,0,1,301,447,221,484,705,58,64,209,233,332,971
3023,Jordan Roper,2013,2016,Clemson,ACC,127,2974,337,897,196,488,141,409,156,207,46,179,225,238,111,9,143,147,971
3024,Tyson Ward,2017,2019,North Dakota State,Summit,96,2405,351,748,265,492,86,256,183,246,111,382,493,191,73,18,187,200,971
3025,Jamie Adams,2013,2014,Florida A&M,MEAC,62,1886,293,795,160,394,133,401,251,321,25,120,145,211,104,2,207,155,970
3026,Darrion Griffin,2008,2009,Jackson State,SWAC,67,1924,314,638,269,506,45,132,297,419,118,198,316,174,68,9,160,145,970
3027,Travis Holmes,2008,2009,Virginia Military Institute,Big South,56,1648,320,707,243,436,77,271,253,324,91,245,336,197,150,34,160,138,970
3028,Hayden Humes,2011,2014,Total,Total,123,3608,338,774,206,427,132,347,162,216,180,424,604,131,58,33,161,321,970
3029,Devareaux Manley,2012,2015,Kent State,MAC,117,2341,300,753,63,155,237,598,133,170,28,171,199,55,46,11,74,167,970
3030,Jordan Ratinho,2017,2019,San Francisco,WCC,102,2903,341,783,138,279,203,504,85,142,65,241,306,115,74,24,82,223,970
3031,Blake Reynolds,2016,2019,Yale,Ivy,113,2547,378,781,266,457,112,324,102,142,137,346,483,209,75,23,153,204,970
3032,Marcus Romain,2016,2017,Mississippi Valley State,SWAC,52,1539,320,711,261,553,59,158,271,376,58,215,273,125,55,17,208,130,970
3033,Jesse Steele,2009,2013,Total,Total,88,2697,324,883,164,433,160,450,162,195,32,138,170,291,113,0,189,154,970
3034,Amin Stevens,2010,2012,Florida A&M,MEAC,84,2103,377,776,340,634,37,142,179,277,216,356,572,88,84,59,181,151,970
3035,Mike Smith,2017,2019,Columbia,Ivy,62,2021,331,833,234,536,97,297,210,252,24,122,146,259,78,1,125,105,969
3036,Josh Taylor,2008,2010,Eastern Kentucky,OVC,94,2277,350,747,180,313,170,434,99,141,98,211,309,117,58,38,123,255,969
3037,Wyatt Walker,2016,2019,Total,Total,104,2375,365,629,361,614,4,15,235,323,233,459,692,107,57,89,160,290,969
3038,Dominic Waters,2009,2010,Portland State,Big Sky,65,1877,317,670,187,371,130,299,205,236,25,129,154,248,45,3,179,140,969
3039,Jordan Bachynski,2011,2014,Arizona State,Total,122,2670,354,632,354,632,0,0,260,424,200,454,654,33,24,314,158,264,968
3040,Stevie Browning,2016,2017,Marshall,CUSA,67,2160,369,810,253,497,116,313,114,145,70,219,289,230,73,19,139,130,968
3041,Darryl Palmer,2013,2016,South Carolina State,MEAC,124,3307,391,901,364,776,27,125,159,264,238,545,783,122,74,203,145,323,968
3042,Nick Stallings,2008,2009,Centenary (LA),Summit,62,,343,804,251,568,92,236,190,271,,,340,141,94,27,175,,968
3043,Jeremy Atkinson,2012,2013,North Carolina-Asheville,Big South,66,2107,334,660,291,528,43,132,256,330,146,305,451,156,90,10,137,139,967
3044,Dontae Cannon,2010,2013,McNeese State,Southland,117,2804,346,842,280,626,66,216,209,271,65,234,299,228,101,7,186,181,967
3045,Zach Kocur,2014,2017,Air Force,MWC,122,2754,328,748,141,274,187,474,124,180,70,344,414,212,84,2,166,246,967
3046,Kevin Mays,2013,2016,Total,Total,84,2311,367,770,358,737,9,33,224,328,272,375,647,92,97,15,151,241,967
3047,Kyle Kuzma,2015,2017,Utah,Pac-12,96,2013,372,735,321,566,51,169,171,270,155,377,532,141,31,35,151,151,966
3048,Matt Mouzy,2008,2011,Little Rock,Sun Belt,114,2436,336,818,109,228,227,590,67,80,17,183,200,107,67,10,123,137,966
3049,Brian Neller,2010,2013,Maryland-Baltimore County,AEC,120,2709,332,961,71,157,261,804,41,61,19,157,176,84,83,4,95,129,966
3050,Alex Poythress,2013,2016,Kentucky,SEC,112,2480,356,646,327,550,29,96,225,328,201,396,597,51,44,76,149,302,966
3051,Davon Bell,2015,2019,Presbyterian,Big South,129,3370,315,761,263,573,52,188,283,372,48,309,357,538,142,12,229,248,965
3052,Ryan Bowie,2015,2016,Texas-San Antonio,CUSA,62,2120,328,742,185,371,143,371,166,221,110,276,386,107,62,17,114,156,965
3053,Jamee Crockett,2012,2015,DePaul,Big East,110,2483,343,834,221,456,122,378,157,224,99,195,294,125,106,40,133,254,965
3054,Matt Howard,2014,2017,Pennsylvania,Ivy,101,2548,352,740,260,459,92,281,169,263,127,339,466,107,92,29,128,199,965
3055,Du'Vaughn Maxwell,2011,2014,Total,Total,87,2481,379,741,374,717,5,24,202,384,216,374,590,87,95,204,165,271,965
3056,Nick Rakocevic,2017,2019,Southern California,Pac-12,105,2288,383,667,383,663,0,4,199,308,266,399,665,77,63,89,118,301,965
3057,Travis Releford,2009,2013,Kansas,Big 12,137,2985,346,645,264,426,82,219,191,275,145,247,392,190,114,20,133,207,965
3058,Omar Strong,2012,2013,Texas Southern,SWAC,64,2114,299,774,77,183,222,591,145,170,34,149,183,118,59,2,136,137,965
3059,Tyler Wilkerson,2008,2010,Marshall,CUSA,85,1993,355,668,335,599,20,69,235,322,200,352,552,62,46,79,131,236,965
3060,Roderick Flemings,2009,2010,Hawaii,WAC,58,2067,339,754,299,608,40,146,246,354,138,210,348,119,56,23,135,128,964
3061,Josh Fox,2013,2016,Total,Big West,88,2390,375,724,370,703,5,21,209,332,156,353,509,129,52,32,160,190,964
3062,Omari Grier,2012,2016,Total,Total,118,2533,302,796,137,330,165,466,195,237,42,170,212,94,48,4,106,146,964
3063,James Kinney,2010,2013,Total,Total,64,1863,348,854,197,438,151,416,117,152,40,178,218,150,89,10,158,119,964
3064,Loudon Love,2018,2019,Wright State,Horizon,69,1890,395,769,395,768,0,1,174,298,226,395,621,71,47,66,165,188,964
3065,LaDarius White,2012,2015,Mississippi,SEC,125,2581,336,844,214,487,122,357,170,243,51,301,352,175,82,22,174,174,964
3066,Sampson Carter,2010,2014,Massachusetts,A-10,135,2946,316,765,257,541,59,224,272,370,157,411,568,104,89,59,179,278,963
3067,Ge'Lawn Guyn,2012,2016,Total,Total,136,2488,333,831,189,437,144,394,153,213,45,220,265,135,90,38,141,225,963
3068,Joel Naburgs,2010,2013,Stetson,A-Sun,118,3138,297,783,117,263,180,520,189,247,67,379,446,289,81,17,221,182,963
3069,Kellen Thornton,2009,2013,Total,Total,122,2239,384,736,347,617,37,119,158,238,201,341,542,64,64,45,145,246,963
3070,Brandon Anderson,2017,2019,Brown,Ivy,84,2176,285,729,209,474,76,255,316,392,34,145,179,220,112,4,217,176,962
3071,Alex Barnett,2008,2009,Dartmouth,Ivy,55,1842,364,819,288,626,76,193,158,193,81,271,352,113,69,66,113,105,962
3072,Brian Dawkins,2014,2018,Elon,Total,113,2212,391,776,302,529,89,247,91,156,102,339,441,80,39,23,116,247,962
3073,Ronald Delph,2016,2018,Florida Atlantic,CUSA,86,2213,418,793,418,791,0,2,126,191,205,431,636,44,25,168,128,263,962
3074,Chris Evans,2010,2013,Total,Total,93,2035,337,684,279,481,58,203,230,321,157,314,471,104,116,66,148,172,962
3075,Danrad Knowles,2014,2017,Houston,AAC,126,2751,353,771,301,602,52,169,204,326,230,318,548,72,47,137,142,310,962
3076,Darryl Roberts,2008,2011,Akron,MAC,133,3085,301,707,151,333,150,374,210,237,59,208,267,185,71,8,140,144,962
3077,Nasir Robinson,2009,2012,Pittsburgh,Big East,133,2917,407,764,400,735,7,29,141,297,250,380,630,187,59,27,198,288,962
3078,Nikola Vucevic,2009,2011,Southern California,Pac-10,87,2409,367,721,330,599,37,122,191,256,213,481,694,97,45,95,129,212,962
3079,Ryan Evans,2010,2013,Wisconsin,Big Ten,138,2943,376,923,363,853,13,70,196,335,178,501,679,165,70,83,161,226,961
3080,Steven Haney,2014,2018,Total,Total,109,2464,319,830,108,263,211,567,112,144,31,213,244,102,56,3,91,170,961
3081,Kaleo Kina,2008,2009,Navy,Patriot,60,1901,334,845,255,568,79,277,214,287,52,238,290,218,95,7,205,160,961
3082,Deishuan Booker,2018,2019,Long Beach State,Big West,65,2020,275,583,206,396,69,187,341,380,31,196,227,292,90,11,224,154,960
3083,Travis Bureau,2008,2011,Louisiana,Sun Belt,105,2759,336,751,201,363,135,388,153,238,139,304,443,115,79,67,147,187,960
3084,Aubrey Dawkins,2015,2019,Total,Total,99,2289,341,718,185,348,156,370,122,149,78,240,318,75,60,22,94,167,960
3085,Alonzo Gee,2008,2009,Alabama,SEC,65,2021,345,801,282,611,63,190,207,317,185,270,455,85,80,34,136,138,960
3086,Lonnie Jackson,2012,2016,Total,Total,128,3203,293,751,64,153,229,598,145,186,55,238,293,214,95,15,167,261,960
3087,Darius James,2008,2011,Old Dominion,CAA,138,3789,338,921,200,504,138,417,146,211,61,251,312,454,102,4,246,191,960
3088,Silas Melson,2015,2018,Gonzaga,WCC,143,3143,331,800,178,377,153,423,145,185,47,278,325,181,102,20,103,263,960
3089,Marc Hill,2009,2012,North Carolina A&T,MEAC,129,2819,319,885,187,502,132,383,189,260,23,190,213,330,91,1,229,111,959
3090,Zay Jackson,2012,2016,Total,Total,91,2583,343,837,241,506,102,331,171,239,45,277,322,349,107,20,268,208,959
3091,Louie Krogman,2011,2012,South Dakota,Total,61,2051,341,785,183,359,158,426,119,169,27,177,204,183,69,5,93,93,959
3092,Takal Molson,2018,2019,Canisius,MAAC,65,2011,313,727,213,400,100,327,233,322,117,221,338,149,80,23,151,167,959
3093,Phil Pressey,2011,2013,Missouri,Total,99,2943,321,812,207,483,114,329,203,268,64,231,295,580,196,5,270,195,959
3094,Derrio Green,2010,2012,Charlotte,A-10,86,2419,293,854,127,300,166,554,206,259,24,187,211,230,113,9,177,130,958
3095,Troy Jackson,2008,2009,Alcorn State,SWAC,53,1902,312,733,240,485,72,248,262,348,55,156,211,134,116,20,139,108,958
3096,Lamarr Kimble,2016,2019,Saint Joseph's,A-10,84,2394,318,830,207,485,111,345,211,287,43,191,234,265,59,9,173,134,958
3097,Dinma Odiakosa,2008,2010,Illinois State,MVC,102,2645,376,625,376,625,0,0,206,396,299,435,734,80,60,66,162,279,958
3098,Brandon Peel,2013,2016,Central Connecticut State,NEC,118,3126,390,815,386,800,4,15,174,247,306,575,881,126,81,170,184,277,958
3099,B.J. Young,2012,2013,Arkansas,SEC,63,1673,357,752,282,521,75,231,169,240,61,148,209,178,58,16,138,116,958
3100,Antwoine Anderson,2015,2018,Total,Total,121,3283,322,784,226,479,96,305,217,312,50,200,250,310,143,25,253,316,957
3101,Ya Ya Anderson,2013,2015,Radford,Big South,96,2623,329,779,141,273,188,506,111,167,59,173,232,174,69,7,98,132,957
3102,Chip Armelin,2011,2015,Total,Total,133,2356,372,815,263,482,109,333,104,181,94,213,307,124,85,13,128,143,957
3103,Kelsey Barlow,2010,2014,Total,Total,124,2788,326,787,268,587,58,200,247,366,123,299,422,273,105,31,206,313,957
3104,Aaron Brennan,2015,2018,IUPUI,Total,122,2568,368,785,308,627,60,158,161,210,138,312,450,134,80,47,158,294,957
3105,Jehyve Floyd,2016,2019,Holy Cross,Patriot,124,2596,417,636,417,633,0,3,123,258,126,345,471,203,85,193,186,317,957
3106,Jeff Foote,2008,2010,Cornell,Ivy,87,2305,367,640,367,640,0,0,223,370,180,454,634,182,38,157,177,224,957
3107,Jeff Jones,2008,2012,Total,Total,120,2400,309,759,165,369,144,390,195,256,38,188,226,83,66,17,102,141,957
3108,Derick Nelson,2008,2010,Oakland,Summit,68,2079,330,750,271,586,59,164,238,384,195,253,448,85,78,4,152,149,957
3109,Xavian Stapleton,2015,2019,Total,Total,117,2158,340,793,199,372,141,421,136,187,106,237,343,53,94,55,108,287,957
3110,Erik Thomas,2016,2017,New Orleans,Southland,61,1705,347,602,343,583,4,19,259,345,172,277,449,117,73,24,134,127,957
3111,Nicholas West,2013,2016,Alabama A&M,SWAC,107,2342,307,733,238,501,69,232,274,381,177,388,565,92,42,79,198,252,957
3112,John Fraley,2009,2012,Austin Peay,OVC,112,2833,355,612,355,612,0,0,246,406,309,456,765,68,52,130,167,276,956
3113,Asante Gist,2017,2019,Total,Total,70,2129,305,796,167,403,138,393,208,281,25,150,175,211,51,1,170,179,956
3114,Samuel Idowu,2016,2019,Saint Peter's,MAAC,124,2119,372,740,295,511,77,229,135,186,153,343,496,49,41,123,131,287,956
3115,Will Pratt,2010,2011,Northwestern State,Southland,61,1388,332,663,290,530,42,133,250,391,77,185,262,67,72,14,174,215,956
3116,Demetrius Troy,2016,2019,North Carolina-Greensboro,Southern,132,3134,341,872,170,411,171,461,103,140,52,263,315,449,161,7,244,185,956
3117,Carrick Felix,2011,2013,Arizona State,Total,94,2626,341,748,242,444,99,304,174,247,125,325,450,125,96,74,162,224,955
3118,Roberto Gallinat,2018,2019,Pacific,WCC,64,1898,278,637,169,326,109,311,290,352,43,145,188,55,35,12,97,162,955
3119,Jay Hook,2012,2015,Tulane,Total,117,2477,290,724,102,244,188,480,187,229,88,306,394,62,70,4,121,188,955
3120,Matt Milon,2016,2019,Total,Total,91,2332,319,689,114,208,205,481,112,136,30,192,222,89,43,9,108,118,955
3121,Josh Shipp,2008,2009,UCLA,Pac-10,72,2231,339,726,214,383,125,343,152,193,40,184,224,134,95,28,127,129,955
3122,Terrico White,2009,2010,Mississippi,SEC,66,2032,349,814,226,460,123,354,134,197,80,185,265,124,56,15,100,117,955
3123,Ben Bentil,2015,2016,Providence,Big East,69,1928,321,705,260,517,61,188,251,330,173,261,434,61,39,48,107,186,954
3124,Charles Corbin,2008,2011,Winthrop,Big South,115,2612,380,877,368,827,12,50,182,283,253,395,648,81,80,33,175,302,954
3125,Zam Fredrick,2008,2009,South Carolina,SEC,63,2125,341,855,212,500,129,355,143,212,49,125,174,158,56,8,155,142,954
3126,Kevin Giltner,2009,2012,Wofford,Southern,131,2914,314,766,127,276,187,490,139,187,45,212,257,130,65,21,143,222,954
3127,Milton Jennings,2010,2013,Clemson,ACC,123,2633,349,843,263,553,86,290,170,250,176,429,605,121,88,77,214,291,954
3128,Harry Marshall,2008,2010,Indiana State,MVC,78,2523,307,706,239,482,68,224,272,349,68,199,267,249,79,3,187,181,954
3129,Josh Parker,2008,2012,Total,Total,133,2338,300,780,135,310,165,470,189,252,58,178,236,229,79,7,202,142,954
3130,Devonta Pollard,2013,2016,Total,Total,100,2572,340,755,337,736,3,19,271,377,185,311,496,113,93,57,164,214,954
3131,Graham Woodward,2014,2018,Total,Total,127,2797,322,811,142,350,180,461,130,190,26,162,188,221,63,2,194,221,954
3132,Zack Bryant,2018,2019,Alabama-Birmingham,CUSA,67,2192,343,771,264,524,79,247,188,263,31,193,224,235,99,20,150,163,953
3133,Brandyn Curry,2010,2014,Harvard,Ivy,113,3266,316,735,199,413,117,322,204,280,45,276,321,488,156,63,228,230,953
3134,DeAndre Daniels,2012,2014,Connecticut,Total,99,2356,359,791,276,553,83,238,152,202,114,343,457,52,62,117,128,201,953
3135,Daniel Gafford,2018,2019,Arkansas,SEC,67,1709,377,594,377,594,0,0,199,354,168,326,494,47,48,139,113,202,953
3136,Trevor Gaskins,2008,2012,Total,Total,134,2599,322,822,160,374,162,448,147,203,99,239,338,222,97,5,192,269,953
3137,Reco McCarter,2012,2015,Total,Total,102,2461,335,744,258,457,77,287,206,320,151,260,411,183,120,57,239,189,953
3138,Ken Rancifer,2010,2013,San Diego,WCC,122,2636,346,794,226,466,120,328,141,218,118,233,351,101,50,43,180,208,953
3139,Ryan Rhoomes,2013,2016,Fordham,A-10,123,3178,389,631,389,631,0,0,175,308,393,543,936,94,55,146,138,334,953
3140,K.C. Rivers,2008,2009,Clemson,ACC,66,2027,361,814,212,439,149,375,82,122,147,260,407,113,119,30,82,108,953
3141,Scottie Wilbekin,2011,2014,Florida,SEC,143,3462,320,769,182,402,138,367,175,246,55,239,294,419,167,5,182,214,953
3142,Tyler Flack,2013,2017,South Dakota,Summit,101,2173,370,711,336,603,34,108,178,238,156,363,519,65,55,144,128,268,952
3143,Trae Goldston,2008,2010,Georgia State,CAA,94,2471,336,862,156,376,180,486,100,121,29,122,151,123,54,7,133,160,952
3144,Toddrick Gotcher,2012,2016,Texas Tech,Big 12,136,3220,293,732,155,355,138,377,228,310,101,266,367,219,94,34,120,243,952
3145,William Powell,2014,2017,Seattle,WAC,124,3178,327,654,327,647,0,7,298,471,242,442,684,257,90,29,286,312,952
3146,Tony Snell,2011,2013,New Mexico,MWC,104,2583,311,738,146,304,165,434,165,201,41,210,251,213,53,36,154,122,952
3147,Jonathan Thompson,2010,2013,Rider,MAAC,128,3473,309,664,202,392,107,272,227,315,76,305,381,372,138,52,209,219,952
3148,Raeford Worsham,2013,2016,Total,Total,90,2340,342,716,322,625,20,91,248,414,201,324,525,131,116,50,155,197,952
3149,Michael Culpo,2009,2012,Long Island University,NEC,119,2886,326,803,112,277,214,526,85,117,106,229,335,100,68,6,111,149,951
3150,Justin Gant,2012,2015,Indiana State,MVC,126,2797,354,794,286,607,68,187,175,254,149,297,446,88,44,96,149,242,951
3151,Paul Harris,2008,2009,Syracuse,Big East,72,2394,315,655,294,577,21,78,300,405,188,396,584,197,97,54,195,161,951
3152,Daishon Knight,2014,2015,Illinois State,MVC,69,2013,320,793,227,506,93,287,218,267,44,228,272,159,78,5,140,93,951
3153,Phil Martin,2011,2012,UC-Riverside,Big West,60,2005,353,792,288,608,65,184,180,218,80,237,317,70,34,23,146,134,951
3154,Morgan Means,2017,2019,Seattle,WAC,96,2788,313,789,197,448,116,341,209,264,56,287,343,251,95,5,216,264,951
3155,Jodie Meeks,2008,2009,Kentucky,SEC,47,1492,290,656,157,318,133,338,238,268,27,124,151,79,54,6,108,88,951
3156,Kwame Morgan,2009,2011,Hampton,MEAC,92,2208,310,840,151,392,159,448,172,241,104,212,316,79,87,6,104,132,951
3157,Wil Peters,2009,2012,Tennessee State,OVC,125,3572,298,754,170,416,128,338,227,287,81,229,310,386,109,15,252,261,951
3158,Nick Russell,2010,2014,Total,Total,115,2811,339,852,262,613,77,239,196,251,34,276,310,293,98,22,253,206,951
3159,Junior Salters,2008,2010,Wofford,Southern,92,2546,316,837,109,278,207,559,112,152,45,219,264,149,92,11,154,167,951
3160,Evan Smotrycz,2011,2015,Total,Total,127,2737,322,790,165,371,157,419,150,200,144,400,544,140,82,36,155,339,951
3161,JT Terrell,2011,2014,Total,Total,87,2220,317,858,171,421,146,437,171,226,46,156,202,99,56,11,166,179,951
3162,Marcellus Barksdale,2012,2016,IUPUI,Summit,134,3544,308,758,269,597,39,161,295,408,138,455,593,275,160,66,228,284,950
3163,Mike Crawford,2014,2017,Saint Louis,A-10,121,2680,327,790,219,456,108,334,188,252,49,250,299,144,62,11,136,197,950
3164,Evan Leonard,2017,2019,UC-Irvine,Big West,98,2135,306,715,163,342,143,373,195,236,34,208,242,143,108,10,123,225,950
3165,Patrick Mills,2008,2009,Saint Mary's (CA),WCC,58,1894,324,780,196,393,128,387,174,216,26,103,129,212,114,9,166,93,950
3166,Nigel Pruitt,2013,2016,Kennesaw State,A-Sun,116,2448,306,794,156,349,150,445,188,252,103,248,351,106,107,38,166,258,950
3167,Anton Beard,2015,2018,Arkansas,SEC,129,2950,319,835,199,475,120,360,191,271,93,192,285,268,129,5,132,295,949
3168,Andre Cornelius,2009,2012,George Mason,CAA,121,2902,321,779,155,344,166,435,141,196,53,216,269,176,94,6,194,261,949
3169,Ryan Kelly,2010,2013,Duke,ACC,126,2437,314,682,212,413,102,269,219,272,141,324,465,117,73,133,104,237,949
3170,Lamonte Turner,2017,2019,Tennessee,SEC,95,2414,302,767,142,312,160,455,185,227,37,231,268,269,78,11,140,207,949
3171,Antonio Blakeney,2016,2017,Louisiana State,SEC,64,2034,331,746,226,443,105,303,181,246,58,205,263,85,43,8,89,97,948
3172,Brandon Childress,2017,2019,Wake Forest,ACC,94,2624,280,746,140,365,140,381,248,310,32,236,268,305,104,3,192,190,948
3173,Josh Freelove,2010,2014,Total,Total,89,2243,364,818,232,455,132,363,88,117,53,144,197,79,35,21,110,118,948
3174,Brandon Parrish,2014,2017,Texas Christian,Big 12,136,3284,335,831,185,422,150,409,128,212,98,268,366,109,69,41,138,254,948
3175,J.T. Adenrele,2012,2017,UC-Davis,Big West,126,2533,373,707,371,703,2,4,199,311,204,369,573,80,77,111,202,386,947
3176,Carl Blair,2010,2013,Total,Total,125,3311,283,742,213,485,70,257,311,412,82,343,425,495,130,8,371,295,947
3177,Alex Hicks,2017,2019,Troy,Sun Belt,100,2313,365,698,325,570,40,128,177,261,195,481,676,72,60,87,162,229,947
3178,Derrick Thomas,2010,2013,Drexel,CAA,124,3763,341,942,231,574,110,368,155,217,95,215,310,248,98,19,180,237,947
3179,Sammy Zeglinski,2008,2012,Virginia,ACC,121,3214,327,887,127,319,200,568,93,138,40,330,370,314,156,18,217,242,947
3180,John Davis,2015,2018,Furman,Southern,132,3234,326,789,194,424,132,365,162,225,39,255,294,282,128,2,163,197,946
3181,Jonathan Mitchell,2008,2011,Total,Total,99,2423,348,801,229,477,119,324,131,161,121,314,435,95,64,36,118,134,946
3182,Austin Ruder,2014,2018,Total,Total,120,3114,309,860,73,211,236,649,92,112,17,203,220,140,57,4,82,164,946
3183,Terry Tarpey,2013,2016,William & Mary,CAA,124,3141,335,676,287,505,48,171,228,306,153,654,807,270,171,119,179,226,946
3184,Luke Knapke,2017,2019,Toledo,MAC,101,2319,360,641,289,467,71,174,154,209,164,409,573,145,31,136,156,285,945
3185,Jeremy Price,2008,2011,Georgia,SEC,126,2559,369,728,367,723,2,5,205,292,184,335,519,96,66,57,228,308,945
3186,Roschon Prince,2014,2018,Total,Total,127,2514,319,664,319,653,0,11,307,448,212,382,594,98,75,36,146,306,945
3187,Mike Tobey,2013,2016,Virginia,ACC,138,2247,398,749,392,730,6,19,143,203,226,332,558,51,31,101,106,257,945
3188,Lamont West,2016,2019,West Virginia,Big 12,110,2130,301,762,147,303,154,459,189,245,123,229,352,67,47,27,101,210,945
3189,Josh Alexander,2008,2009,Stephen F. Austin,Southland,62,2073,299,723,133,282,166,441,180,236,129,222,351,64,81,26,97,146,944
3190,Jordan Bitzer,2008,2010,Central Michigan,MAC,80,2482,298,743,147,334,151,409,197,231,46,310,356,152,135,34,129,215,944
3191,N'Gai Evans,2008,2011,Wright State,Horizon,111,2947,314,725,241,503,73,222,243,322,60,237,297,251,105,12,199,221,944
3192,Danny Green,2008,2009,North Carolina,ACC,77,1909,345,734,212,400,133,334,121,140,137,234,371,181,115,97,137,175,944
3193,Leo Lyons,2008,2009,Missouri,Big 12,68,1545,338,635,332,609,6,26,262,370,143,258,401,126,60,47,139,164,944
3194,Doneal Mack,2008,2010,Memphis,CUSA,110,2380,328,813,136,274,192,539,96,149,57,150,207,121,66,42,78,185,944
3195,Jared Savage,2016,2019,Total,Total,99,2841,306,779,117,267,189,512,143,174,70,329,399,107,93,27,97,214,944
3196,Dantiel Daniels,2012,2016,Total,Total,121,2898,355,587,355,587,0,0,233,460,297,340,637,78,66,111,132,286,943
3197,Nate Frye,2014,2017,New Orleans,Southland,108,2492,283,686,209,494,74,192,303,390,105,173,278,273,128,14,213,244,943
3198,Charles Jackson,2016,2019,Arkansas-Pine Bluff,SWAC,129,2953,302,797,109,247,193,550,146,206,69,257,326,205,101,29,231,299,943
3199,Austin Richie,2012,2015,Western Michigan,MAC,130,3605,270,696,110,270,160,426,243,341,29,192,221,279,92,10,173,270,943
3200,Cameron Ridley,2013,2016,Texas,Big 12,115,2458,346,634,346,634,0,0,251,462,293,427,720,37,48,220,179,279,943
3201,Dexter Werner,2014,2017,North Dakota State,Summit,106,2168,351,648,351,646,0,2,241,364,240,394,634,91,90,98,104,225,943
3202,Chris Babb,2009,2013,Total,Total,130,3448,302,802,82,189,220,613,118,161,89,298,387,215,102,24,102,148,942
3203,Armoni Brooks,2017,2019,Houston,AAC,100,2179,327,788,98,211,229,577,59,83,80,345,425,57,65,25,61,133,942
3204,Jordan Geist,2017,2019,Missouri,SEC,97,2647,294,701,174,350,120,351,234,316,55,315,370,255,83,0,164,171,942
3205,Damon Heuir,2010,2013,Southern Utah,Total,115,2591,308,810,203,492,105,318,221,311,75,218,293,260,57,14,226,229,942
3206,Elijah Johnson,2010,2013,Kansas,Big 12,135,3045,341,804,194,374,147,430,113,156,41,271,312,399,114,14,233,258,942
3207,Kurk Lee,2017,2019,Drexel,CAA,71,2379,337,839,213,515,124,324,144,202,48,203,251,280,94,2,175,172,942
3208,Greg Monroe,2009,2010,Georgetown,Big East,65,2122,345,635,336,602,9,33,243,359,136,395,531,207,99,97,189,164,942
3209,Angel Rivera,2015,2018,Stetson,A-Sun,127,3420,287,670,183,370,104,300,264,366,58,294,352,582,110,5,199,286,942
3210,Samardo Samuels,2009,2010,Louisville,Big East,70,1897,339,618,339,617,0,1,264,383,200,212,412,74,42,86,161,198,942
3211,Jordan Bowden,2017,2019,Tennessee,SEC,101,2663,301,730,164,355,137,375,202,255,77,260,337,176,97,27,96,222,941
3212,Aaron Broussard,2011,2012,Seattle,Ind,58,1745,351,746,295,572,56,174,183,259,158,257,415,66,91,8,121,136,941
3213,Leon Buchanan,2008,2009,Morehead State,OVC,66,2150,307,586,303,578,4,8,323,398,179,230,409,59,52,23,135,162,941
3214,Jarvis Garrett,2015,2018,Rhode Island,A-10,125,3210,314,801,199,475,115,326,198,285,69,251,320,398,110,7,192,224,941
3215,Chauncey Hardy,2008,2010,Sacred Heart,NEC,84,2414,338,752,203,417,135,335,130,159,55,142,197,258,118,15,202,235,941
3216,Andrew Keister,2008,2011,Holy Cross,Patriot,106,2465,374,715,367,682,7,33,186,302,278,468,746,98,42,61,177,261,941
3217,Michael Perez,2011,2015,Total,Total,121,3164,320,846,193,466,127,380,174,244,31,279,310,237,73,17,190,206,941
3218,Antonio Woods,2015,2019,Pennsylvania,Ivy,105,3279,336,847,214,464,122,383,147,249,59,294,353,313,77,12,175,205,941
3219,G.W. Boon,2008,2011,Bucknell,Patriot,126,2545,311,813,151,362,160,451,158,206,130,269,399,88,51,33,151,231,940
3220,Dane Brumagin,2008,2009,Missouri-Kansas City,Summit,58,1702,311,684,180,362,131,322,187,223,94,149,243,66,76,5,99,149,940
3221,C.J. Aiken,2011,2013,Saint Joseph's,A-10,98,2958,346,692,279,456,67,236,180,249,116,373,489,89,43,319,108,171,939
3222,Desmond Cambridge,2018,2019,Brown,Ivy,57,1669,322,835,178,393,144,442,151,196,40,197,237,61,59,79,91,148,939
3223,James Powell,2008,2010,UC-Santa Barbara,Big West,91,2233,308,783,125,318,183,465,140,168,24,195,219,158,85,3,159,184,939
3224,Antwan Scott,2013,2016,Total,Total,63,1879,298,693,154,337,144,356,199,254,32,224,256,168,53,3,152,148,939
3225,Lamonte Ulmer,2008,2010,Rhode Island,A-10,103,2596,366,711,355,667,11,44,196,273,247,353,600,104,107,82,112,139,939
3226,Chris Harrison-Docks,2014,2017,Total,Total,100,2648,294,791,96,240,198,551,152,187,17,153,170,188,54,0,168,157,938
3227,Cedrick Lang,2012,2015,Texas-El Paso,CUSA,130,3037,333,573,333,572,0,1,272,453,252,473,725,118,51,53,164,396,938
3228,Mitchell Patton,2011,2014,IUPUI,Summit,117,2150,376,744,371,723,5,21,181,260,149,245,394,55,40,88,112,246,938
3229,Mitch Rolls,2010,2013,Colgate,Patriot,120,3441,314,851,143,396,171,455,139,178,34,213,247,365,79,9,285,272,938
3230,Theron Wilson,2008,2009,Bradley,MVC,73,2204,296,637,253,511,43,126,303,430,158,334,492,115,116,34,161,189,938
3231,Jeff Withey,2010,2013,Kansas,Big 12,117,2319,327,576,326,575,1,1,283,390,185,443,628,69,59,311,138,208,938
3232,Derick Beltran,2012,2013,Southern,SWAC,64,2114,302,760,183,399,119,361,214,269,35,218,253,100,70,28,124,126,937
3233,Kyre' Hamer,2014,2017,Campbell,Big South,111,2933,325,649,250,444,75,205,212,291,62,311,373,217,128,26,222,241,937
3234,Rashaan Holloway,2016,2019,Massachusetts,A-10,108,1741,387,610,387,609,0,1,163,307,210,325,535,51,40,107,182,305,937
3235,Steve McWhorter,2011,2015,Total,Total,132,3581,328,778,234,495,94,283,187,271,75,311,386,376,146,35,208,349,937
3236,Gyno Pomare,2008,2009,San Diego,WCC,67,1876,357,655,357,654,0,1,223,307,166,283,449,54,58,84,96,155,937
3237,Antonio Barton,2011,2014,Total,Total,132,2966,317,743,166,353,151,390,151,226,43,238,281,218,85,18,145,198,936
3238,Gabe DeVoe,2015,2018,Clemson,ACC,118,2762,328,829,159,340,169,489,111,153,69,293,362,188,95,26,154,194,936
3239,Stu Douglass,2009,2012,Michigan,Big Ten,136,3900,331,871,126,268,205,603,69,99,42,269,311,290,111,17,155,197,936
3240,Darren Moore,2009,2011,UC-Irvine,Big West,70,2132,291,622,204,386,87,236,267,358,104,248,352,125,100,20,132,214,936
3241,Prince Okoroh,2012,2017,Howard,MEAC,97,2745,332,853,307,755,25,98,247,378,157,267,424,89,115,53,214,263,936
3242,Jordan Allen,2013,2016,Total,Total,123,3018,360,666,359,660,1,6,214,425,241,290,531,171,117,44,193,415,935
3243,Daniel Coursey,2011,2014,Mercer,A-Sun,126,2277,390,686,390,686,0,0,155,231,195,332,527,40,39,207,129,316,935
3244,Andrew Eudy,2016,2019,Campbell,Big South,130,3054,371,730,305,560,66,170,127,162,202,438,640,282,86,199,181,342,935
3245,Tony Johnson,2010,2013,Lafayette,Patriot,106,2859,333,631,278,486,55,145,214,274,47,307,354,374,159,19,181,183,935
3246,Mikko Koivisto,2008,2010,North Carolina-Greensboro,Southern,88,2404,291,747,85,193,206,554,147,168,31,145,176,153,54,4,117,189,935
3247,Devin Robinson,2015,2017,Florida,SEC,105,2413,334,742,234,444,100,298,167,234,151,362,513,63,66,63,99,225,935
3248,Kory Brown,2013,2016,North Dakota State,Summit,125,3344,349,687,317,581,32,106,204,293,156,419,575,244,136,84,203,364,934
3249,Daniel Emerson,2009,2010,Mercer,A-Sun,64,2208,308,605,274,515,34,90,284,396,246,482,728,117,39,10,191,144,934
3250,Festus Ezeli,2009,2012,Vanderbilt,SEC,121,2168,330,587,330,587,0,0,274,469,215,328,543,18,41,205,195,314,934
3251,Griffin Kinney,2015,2018,Appalachian State,Sun Belt,122,2460,342,668,337,650,5,18,245,366,168,424,592,123,52,30,241,341,934
3252,Tyler Livingston,2014,2017,Massachusetts-Lowell,AEC,113,2635,350,815,171,324,179,491,55,73,103,268,371,107,48,30,111,284,934
3253,Richie Gordon,2008,2011,Western Carolina,Southern,126,2448,379,706,379,705,0,1,175,281,247,313,560,114,128,120,191,435,933
3254,Francois Lewis,2016,2019,Total,Total,81,1958,331,702,201,357,130,345,141,215,87,270,357,84,52,16,101,230,933
3255,Stephan Martin,2008,2011,McNeese State,Southland,121,2182,320,782,197,419,123,363,170,213,63,144,207,163,106,11,210,200,933
3256,Mathias Ward,2010,2013,Montana,Big Sky,118,2213,346,660,313,584,33,76,208,263,117,205,322,50,32,25,114,244,933
3257,Andrew Beinert,2008,2011,Holy Cross,Patriot,121,3309,307,756,134,331,173,425,145,218,59,209,268,335,104,5,276,257,932
3258,Freddie Jackson,2012,2015,North Carolina-Wilmington,CAA,123,3168,352,833,272,567,80,266,148,232,115,339,454,206,116,51,207,169,932
3259,D.J. Mason,2013,2016,Campbell,Big South,98,2091,371,755,326,624,45,131,145,254,173,306,479,148,58,66,136,221,932
3260,Jacolby Mobley,2016,2017,Tennessee-Martin,OVC,63,1880,304,729,144,281,160,448,164,206,40,128,168,114,55,8,109,129,932
3261,Michael Morrison,2009,2012,George Mason,CAA,128,2792,379,668,379,667,0,1,174,377,238,420,658,147,64,174,139,328,932
3262,George Odufuwa,2009,2011,North Texas,Sun Belt,97,2749,343,631,343,630,0,1,246,390,250,646,896,137,72,70,203,298,932
3263,Jerry Smith,2008,2010,Louisville,Big East,104,2569,307,688,152,263,155,425,163,227,87,219,306,176,145,20,140,207,932
3264,Marc Sonnen,2010,2013,Northern Iowa,MVC,139,3351,309,748,108,268,201,480,113,144,84,212,296,157,92,12,107,305,932
3265,PJ Washington,2018,2019,Kentucky,SEC,72,2036,325,624,287,525,38,99,244,386,148,328,476,120,58,74,140,186,932
3266,Jeff Beverly,2014,2018,Total,Total,95,2040,334,803,284,624,50,179,213,288,165,214,379,61,36,16,159,235,931
3267,Edward Daniel,2010,2013,Murray State,OVC,128,2602,311,560,308,551,3,9,306,508,290,429,719,81,101,156,181,310,931
3268,Justin Forrest,2018,2019,Appalachian State,Sun Belt,63,1794,297,768,167,373,130,395,207,296,26,168,194,141,79,2,177,143,931
3269,Howard Little,2008,2011,Valparaiso,Horizon,133,2998,352,741,275,497,77,244,150,256,210,285,495,177,145,12,151,296,931
3270,Arkadiy Mkrtychyan,2015,2018,Idaho,Big Sky,120,2347,336,647,329,616,7,31,252,385,159,337,496,94,52,16,155,313,931
3271,Lucas Nutt,2010,2014,Southeast Missouri State,OVC,135,3576,259,634,142,322,117,312,296,356,36,222,258,604,94,6,272,270,931
3272,Jakob Poeltl,2015,2016,Utah,Pac-12,70,1885,356,541,356,540,0,1,219,362,194,363,557,93,33,119,129,165,931
3273,Nik Popovic,2017,2019,Boston College,ACC,92,2140,378,740,357,655,21,85,154,224,189,329,518,88,32,59,155,240,931
3274,Billy Wampler,2016,2019,Total,Total,95,1948,308,758,143,309,165,449,150,189,43,177,220,76,41,10,79,164,931
3275,Jeff Ayres,2008,2009,Arizona State,Pac-10,69,2106,351,558,351,556,0,2,228,290,161,344,505,60,32,86,110,198,930
3276,Myles Davis,2014,2017,Xavier,Big East,107,2601,273,722,105,260,168,462,216,262,33,233,266,245,80,6,135,188,930
3277,Andre Hatchett,2011,2014,Idaho State,Big Sky,111,2866,321,777,296,676,25,101,263,451,122,340,462,173,82,23,162,183,930
3278,Sylven Landesberg,2009,2010,Virginia,ACC,55,1825,316,719,277,608,39,111,259,323,84,217,301,155,49,11,138,106,930
3279,Ryan Litke,2008,2010,Sacred Heart,NEC,91,2135,324,802,116,258,208,544,74,106,47,232,279,139,90,29,179,223,930
3280,Sam Logwood,2015,2018,New Mexico,MWC,116,2749,333,740,285,606,48,134,216,303,129,317,446,162,69,21,178,241,930
3281,James Miller,2014,2017,Howard,MEAC,83,2082,333,734,261,500,72,234,192,278,70,171,241,101,93,27,189,197,930
3282,Jesse Morgan,2011,2015,Total,Total,90,2304,322,878,152,393,170,485,116,154,83,174,257,153,114,18,128,169,930
3283,Cole Murray,2014,2017,Northern Kentucky,Total,121,2615,316,720,57,90,259,630,39,52,25,271,296,88,39,32,71,212,930
3284,Preston Parks,2017,2019,Total,Total,65,1867,312,811,176,417,136,394,170,202,51,171,222,239,105,8,166,129,930
3285,Mike Scott,2008,2011,Total,Total,90,2583,276,697,167,398,109,299,269,332,54,254,308,362,116,15,260,246,930
3286,TJ Shorts II,2018,2019,UC-Davis,Big West,62,2003,324,637,302,565,22,72,260,354,30,230,260,272,109,14,169,142,930
3287,Kyle Smyth,2009,2013,Total,Total,129,3191,308,740,98,188,210,552,104,138,63,242,305,194,128,20,89,266,930
3288,Jamal Boykin,2008,2010,University of California,Pac-10,93,2249,386,705,376,681,10,24,147,189,198,344,542,100,54,29,104,178,929
3289,Randy Davis,2009,2012,Ball State,MAC,117,3073,240,637,104,238,136,399,313,380,52,285,337,446,116,15,222,257,929
3290,Koby McEwen,2017,2018,Utah State,MWC,62,1959,287,672,162,331,125,341,230,317,28,294,322,193,47,12,174,168,929
3291,JD Notae,2018,2019,Jacksonville,A-Sun,60,1811,336,803,225,488,111,315,146,204,57,271,328,163,101,28,178,136,929
3292,Pat Andree,2017,2019,Lehigh,Patriot,86,2213,318,716,129,262,189,454,103,136,64,396,460,87,38,26,83,164,928
3293,Drew Charles,2013,2017,Texas-Arlington,Total,126,2664,299,765,123,300,176,465,154,204,93,215,308,173,98,5,142,294,928
3294,Ruben Guillandeaux,2008,2011,La Salle,A-10,90,2382,318,797,181,434,137,363,155,210,23,181,204,239,57,7,146,156,928
3295,Stephen Hall,2009,2012,Jacksonville State,OVC,102,2508,359,785,345,730,14,55,196,292,199,301,500,86,58,45,167,265,928
3296,Kevin Hill,2013,2016,New Orleans,Total,110,2176,330,687,330,687,0,0,268,363,250,423,673,61,57,80,200,239,928
3297,George Kiernan,2016,2019,Navy,Patriot,92,1974,302,756,156,338,146,418,178,214,97,304,401,76,43,26,132,240,928
3298,Zach Plackemeier,2008,2011,Purdue-Fort Wayne,Summit,122,3613,298,755,127,319,171,436,161,197,52,287,339,362,99,20,216,245,928
3299,Tristan Spurlock,2010,2014,Total,Total,105,2638,305,759,183,388,122,371,196,267,154,332,486,111,91,79,118,167,928
3300,C.J. Webster,2008,2010,San Jose State,WAC,86,2365,371,728,371,726,0,2,186,293,174,350,524,168,43,43,150,265,928
3301,Josh Brown,2014,2018,Temple,AAC,139,3858,329,818,246,591,83,227,186,246,73,401,474,390,132,52,172,263,927
3302,Justin Dobbins,2008,2010,Eastern Michigan,MAC,87,2288,362,656,362,656,0,0,203,338,196,244,440,88,48,68,171,251,927
3303,Jonathan Moore,2009,2011,Gardner-Webb,Big South,85,2240,304,728,186,394,118,334,201,286,104,214,318,91,71,11,147,192,927
3304,Georgie Pacheco-Ortiz,2017,2019,Liberty,Total,108,3139,291,674,161,365,130,309,215,249,33,227,260,265,87,10,129,130,927
3305,Gary Payton,2015,2016,Oregon State,Pac-12,63,2221,367,756,318,594,49,162,144,221,141,341,482,259,175,53,133,169,927
3306,Darryl Shazier,2008,2011,Bucknell,Patriot,126,3889,313,822,192,461,121,361,180,250,41,321,362,498,140,16,220,236,927
3307,Tyler Strange,2012,2015,Gardner-Webb,Big South,132,3921,319,825,147,326,172,499,117,180,41,285,326,651,207,6,269,237,927
3308,Aaron Jackson,2008,2009,Duquesne,A-10,64,2042,335,606,276,440,59,166,197,249,108,199,307,299,99,6,156,125,926
3309,Quincy Taylor,2011,2015,Total,Total,124,3348,324,794,164,397,160,397,118,171,49,207,256,295,123,7,259,230,926
3310,Jackson Trapp,2013,2016,Florida Atlantic,Total,119,3323,313,804,140,325,173,479,127,167,54,280,334,168,79,55,161,205,926
3311,Ray Willis,2009,2013,Total,Total,92,2264,287,691,225,492,62,199,290,359,85,286,371,140,83,43,186,156,926
3312,Bobby Brown,2013,2016,Alabama State,SWAC,117,2601,337,888,219,504,118,384,133,205,161,414,575,92,54,61,139,157,925
3313,Jon Ekey,2011,2014,Total,Total,134,3359,336,777,165,309,171,468,82,108,174,427,601,131,101,122,89,280,925
3314,Anthony Lee,2012,2015,Total,Total,113,2438,372,717,371,712,1,5,180,286,211,458,669,40,42,95,119,304,925
3315,Devin Martin,2015,2016,Maryland-Eastern Shore,MEAC,60,1883,310,732,184,398,126,334,179,230,77,192,269,105,66,17,136,133,925
3316,Shay Shine,2011,2012,High Point,Big South,62,1920,311,702,194,410,117,292,186,239,77,221,298,175,77,21,141,162,925
3317,Alexander Starling,2009,2011,Bethune-Cookman,MEAC,99,2998,332,698,321,647,11,51,250,369,248,433,681,79,139,84,180,314,925
3318,Averyl Ugba,2017,2018,Total,Total,64,1921,343,622,327,577,16,45,223,331,236,329,565,56,51,58,134,167,925
3319,Paul Graham,2008,2009,Florida Atlantic,Sun Belt,56,1640,307,742,219,485,88,257,222,286,35,137,172,97,35,7,130,107,924
3320,Rod Hall,2012,2015,Clemson,ACC,129,3697,311,731,264,590,47,141,255,361,52,229,281,393,86,13,224,178,924
3321,Glenn Powell,2010,2013,Jacksonville,A-Sun,124,2751,377,728,377,728,0,0,170,294,269,425,694,42,101,129,201,343,924
3322,Royce Woolridge,2011,2015,Total,Total,111,2753,305,724,231,491,74,233,240,347,28,215,243,251,85,13,200,203,924
3323,Jihad Ali,2008,2012,Georgia State,CAA,126,2809,361,914,254,610,107,304,94,144,116,376,492,129,117,59,137,203,923
3324,Isaiah Armwood,2010,2014,Total,Total,124,2859,331,670,326,645,5,25,256,387,218,499,717,118,76,154,181,276,923
3325,Darius Graham,2013,2017,UC-Davis,Big West,139,3834,299,758,174,419,125,339,200,281,47,226,273,418,72,5,315,255,923
3326,Trinity Hall,2011,2014,Missouri-Kansas City,Total,108,2675,324,785,269,568,55,217,220,341,137,321,458,75,73,77,196,283,923
3327,Pat Moore,2011,2015,Colgate,Patriot,125,2771,313,753,125,290,188,463,109,142,46,210,256,144,42,5,148,197,923
3328,Markieff Morris,2009,2011,Kansas,Big 12,109,2105,341,617,303,523,38,94,203,311,217,445,662,126,60,103,172,298,923
3329,Devin Oliver,2011,2014,Dayton,A-10,133,2971,328,723,261,512,67,211,200,283,230,526,756,188,102,22,179,274,923
3330,Eli Pepper,2016,2019,Lipscomb,A-Sun,133,3022,334,673,271,480,63,193,192,319,229,783,1012,221,68,83,229,366,923
3331,Anthony Breeze,2008,2012,Total,Total,98,2192,336,642,335,641,1,1,249,416,180,306,486,53,58,62,147,224,922
3332,Kareem Canty,2014,2016,Total,Total,54,1932,313,816,179,411,134,405,162,221,30,106,136,291,40,3,183,94,922
3333,Kenny Kaminski,2014,2017,Total,Total,94,2232,304,745,102,249,202,496,112,138,52,208,260,79,51,24,75,189,922
3334,Greg Mortimer,2014,2017,South Carolina State,MEAC,113,2582,315,779,245,555,70,224,222,305,85,182,267,210,63,16,192,155,922
3335,Earl Potts,2015,2017,Fairleigh Dickinson,NEC,82,2243,333,727,210,381,123,346,133,186,83,300,383,76,78,22,79,262,922
3336,Kirk Van Slyke,2010,2014,Total,Total,117,2043,325,708,233,455,92,253,180,222,130,249,379,59,34,74,112,260,922
3337,Storm Warren,2009,2012,Louisiana State,SEC,123,2320,377,771,377,768,0,3,168,264,250,359,609,49,114,121,125,294,922
3338,Jamar Akoh,2015,2019,Total,Total,108,2502,335,656,331,636,4,20,247,399,208,403,611,118,83,43,174,271,921
3339,Leron Black,2015,2018,Illinois,Big Ten,102,2003,371,744,338,661,33,83,146,195,162,367,529,47,37,19,126,305,921
3340,Jordan Bone,2017,2019,Tennessee,SEC,95,2479,339,799,248,541,91,258,152,186,33,196,229,405,64,6,149,118,921
3341,Tyson Carter,2017,2019,Mississippi State,SEC,103,2362,327,775,165,319,162,456,105,128,15,175,190,119,91,6,82,127,921
3342,Kyvon Davenport,2018,2019,Memphis,AAC,70,1935,324,644,248,430,76,214,197,305,156,304,460,63,45,70,111,217,921
3343,Keyshawn Evans,2016,2019,Illinois State,MVC,108,2652,296,778,97,253,199,525,130,180,23,172,195,246,57,3,167,175,921
3344,Cody Larson,2010,2015,Total,Total,94,2073,337,667,333,651,4,16,243,342,146,352,498,129,41,75,148,227,921
3345,Galen Robinson Jr.,2016,2019,Houston,AAC,136,3773,342,797,279,587,63,210,174,263,50,330,380,578,157,13,233,238,921
3346,Micheal Warren,2016,2018,Cal State Northridge,Big West,86,2439,299,660,203,413,96,247,227,283,65,309,374,166,105,28,142,259,921
3347,Adonis Burbage,2012,2016,Total,Total,120,2897,318,808,123,284,195,524,89,124,92,228,320,100,72,13,141,213,920
3348,Ruben Guerrero,2015,2019,Total,Total,123,3114,385,684,385,684,0,0,150,246,301,438,739,60,50,190,176,282,920
3349,Malcolm Miller,2013,2014,Southern,SWAC,65,1766,326,685,156,281,170,404,98,134,86,275,361,68,71,59,74,124,920
3350,J.R. Blount,2008,2009,Loyola (IL),Horizon,63,2161,323,838,285,666,38,172,235,344,84,178,262,186,77,2,174,170,919
3351,Marcus Derrickson,2016,2018,Georgetown,Big East,89,2284,294,640,177,345,117,295,214,250,148,353,501,122,46,56,151,254,919
3352,Idris Hilliard,2008,2011,Saint Joseph's,A-10,128,3073,356,700,344,656,12,44,195,279,185,341,526,131,61,31,155,293,919
3353,Chris Lewis,2017,2019,Harvard,Ivy,88,2036,386,629,386,628,0,1,147,214,150,303,453,89,62,135,152,235,919
3354,Riley Norris,2015,2019,Alabama,SEC,136,3255,305,779,153,340,152,439,157,229,173,394,567,94,89,23,127,286,919
3355,Domonic Tilford,2008,2009,South Alabama,Sun Belt,64,2037,302,747,158,374,144,373,171,199,21,147,168,158,61,1,128,79,919
3356,Sulskis Vytas,2008,2010,Youngstown State,Horizon,90,2261,290,701,164,351,126,350,213,303,60,177,368,169,78,38,147,171,919
3357,Jordan Aaron,2013,2014,Milwaukee,Horizon,63,2161,288,773,153,381,135,392,207,247,28,183,211,205,74,4,188,163,918
3358,Angus Brandt,2010,2014,Oregon State,Total,125,2420,344,703,280,544,64,159,166,239,127,247,374,126,52,55,154,310,918
3359,Iba Camara,2015,2018,New Hampshire,AEC,122,2595,357,698,357,697,0,1,204,351,271,745,1016,92,51,50,210,334,918
3360,Demondre Chapman,2011,2014,Prairie View,SWAC,121,2323,352,704,352,702,0,2,214,466,241,270,511,39,61,69,153,263,918
3361,Nicchaeus Doaks,2008,2009,Chattanooga,Southern,66,1881,326,596,291,486,35,110,231,358,158,363,521,94,50,71,158,156,918
3362,Max Hazzard,2017,2019,UC-Irvine,Big West,106,2286,315,802,145,337,170,465,118,161,36,164,200,188,60,2,137,153,918
3363,Blake Jenkins,2011,2014,Belmont,Total,134,2381,337,602,306,503,31,99,213,336,188,302,490,110,52,73,156,315,918
3364,Devin Mitchell,2015,2019,Total,Total,109,2179,312,728,94,203,218,525,76,114,23,149,172,129,51,14,95,182,918
3365,Jamal Williams,2015,2018,Sam Houston State,Southland,137,2893,342,704,310,614,32,90,202,296,174,372,546,283,107,25,204,207,918
3366,Eric Carlson,2009,2012,North Dakota State,Summit,110,2270,329,707,328,704,1,3,258,383,181,281,462,150,61,12,173,216,917
3367,Gerard Coleman,2011,2014,Total,Total,95,2325,349,799,327,702,22,97,197,322,110,191,301,134,80,15,164,132,917
3368,Joe De Ciman,2013,2016,Colorado State,MWC,123,2987,301,749,151,347,150,402,165,226,77,301,378,157,57,47,119,294,917
3369,David Huertas,2008,2009,Mississippi,SEC,65,1862,294,733,142,308,152,425,177,221,79,188,267,135,62,11,125,151,917
3370,Marlon Hunter,2016,2019,Total,Total,100,2243,382,795,346,686,36,109,117,160,135,176,311,80,92,7,101,148,917
3371,Shawn Prudhomme,2016,2017,Southern,SWAC,68,1790,339,750,217,421,122,329,117,153,81,231,312,62,62,54,97,164,917
3372,Michael Ertel,2018,2019,Louisiana-Monroe,Sun Belt,67,2237,328,751,194,420,134,331,126,157,26,178,204,174,47,6,81,113,916
3373,Bryan Friday,2008,2010,Samford,Total,92,2455,334,676,282,508,52,168,196,297,100,218,318,151,53,15,189,161,916
3374,Chris Harriel,2010,2014,Total,Total,117,2614,307,859,198,476,109,383,193,305,125,254,379,141,109,37,164,236,916
3375,Brandon Pye,2013,2016,Texas A&M-Corpus Christi,Southland,126,3049,324,792,144,343,180,449,88,112,28,124,152,103,82,0,83,151,916
3376,Jake Allsmiller,2015,2018,Georgia Southern,Sun Belt,128,3108,292,787,27,67,265,720,66,79,32,181,213,109,61,26,91,300,915
3377,Earl Clark,2008,2009,Louisville,Big East,72,2266,348,749,302,588,46,161,173,266,179,428,607,167,72,110,199,133,915
3378,JaKarr Sampson,2013,2014,St. John's (NY),Big East,66,1997,383,816,382,803,1,13,148,244,140,280,420,74,57,68,118,183,915
3379,Rashad Smith,2012,2016,Tulsa,Total,118,2486,361,711,344,644,17,67,176,310,167,332,499,95,63,72,137,227,915
3380,Kenny Williams,2016,2019,North Carolina,ACC,128,2967,329,750,186,332,143,418,114,154,117,255,372,277,98,37,129,184,915
3381,Blake Bozeman,2012,2015,Morgan State,MEAC,123,3717,296,939,113,338,183,601,139,195,60,206,266,246,73,5,202,249,914
3382,Cody Demps,2013,2016,Sacramento State,Big Sky,114,3055,317,695,279,552,38,143,242,344,111,334,445,286,88,26,200,270,914
3383,Alante Fenner,2014,2018,Savannah State,MEAC,92,2042,313,775,235,512,78,263,210,290,83,233,316,140,107,6,177,155,914
3384,Nick Hornsby,2014,2017,Sacramento State,Big Sky,123,2997,340,743,310,650,30,93,204,299,210,513,723,180,133,58,195,340,914
3385,Rahlir Jefferson,2010,2013,Temple,A-10,133,3588,353,724,353,721,0,3,208,348,300,382,682,266,158,108,187,326,914
3386,Nate Kratch,2014,2017,Santa Clara,WCC,129,3111,364,725,294,542,70,183,116,204,220,477,697,84,64,79,119,377,914
3387,Tim Marshall,2013,2016,Virginia Military Institute,Total,123,2072,306,875,91,194,215,681,87,132,61,175,236,101,80,3,106,232,914
3388,David Minaya,2008,2012,Total,Total,122,2547,342,891,277,652,65,239,165,219,61,252,313,107,65,5,131,251,914
3389,Brett Royster,2008,2011,Florida Atlantic,Sun Belt,125,3211,335,631,335,631,0,0,244,393,237,447,684,45,63,301,159,348,914
3390,Tyler Russell,2012,2015,Houston Baptist,Total,101,2322,342,844,287,664,55,180,175,222,63,193,256,162,78,9,188,195,914
3391,Landry Shamet,2016,2018,Wichita State,Total,71,2029,296,617,137,253,159,364,163,201,39,174,213,288,54,14,108,146,914
3392,Hans Brase,2013,2018,Total,Total,114,2645,300,704,195,398,105,306,208,280,155,453,608,173,52,55,173,269,913
3393,Charles Cooper,2016,2017,Green Bay,Horizon,67,1776,298,669,283,587,15,82,302,447,97,261,358,107,73,15,147,127,913
3394,Christian Cunningham,2016,2019,Jacksonville State,OVC,124,3077,385,620,385,620,0,0,143,255,326,537,863,86,75,215,150,329,913
3395,Troy Daniels,2010,2013,Virginia Commonwealth,Total,125,2109,297,764,46,114,251,650,68,87,63,205,268,48,81,7,73,167,913
3396,Chris De La Rosa,2008,2012,Total,Total,94,2426,323,791,269,614,54,177,213,296,38,180,218,395,84,0,189,139,913
3397,Alasdair Fraser,2011,2013,Maine,AEC,87,2366,393,758,380,714,13,44,114,191,191,372,563,80,44,104,163,246,913
3398,Tab Hamilton,2012,2015,Appalachian State,Total,94,2593,329,865,183,430,146,435,109,150,61,131,192,94,88,11,116,185,913
3399,Malcolm Lee,2009,2011,UCLA,Pac-10,94,2514,312,707,241,452,71,255,218,304,79,207,286,184,72,20,161,191,913
3400,Jordan Mickey,2014,2015,Louisiana State,SEC,65,2197,363,701,362,687,1,14,186,278,176,399,575,76,50,218,179,155,913
3401,Nick Minnerath,2011,2013,Detroit Mercy,Horizon,71,2003,326,662,253,463,73,199,188,231,126,248,374,65,50,27,115,190,913
3402,Chima Moneke,2017,2018,UC-Davis,Big West,57,1612,326,624,317,600,9,24,252,374,137,405,542,51,53,74,150,154,913
3403,Jon Octeus,2013,2015,Total,Total,101,2739,282,667,232,508,50,159,299,398,100,308,408,207,77,15,126,254,913
3404,David Robertson,2014,2017,North Carolina-Asheville,Big South,111,2871,296,756,125,284,171,472,150,210,50,158,208,219,86,4,142,211,913
3405,Diamon Simpson,2008,2009,Saint Mary's (CA),WCC,67,2130,313,598,294,543,19,55,268,449,210,474,684,56,100,115,128,138,913
3406,Charles Abouo,2009,2012,Brigham Young,Total,141,2527,302,697,216,453,86,244,222,306,177,392,569,164,96,32,151,264,912
3407,Troy Barnies,2008,2011,Maine,AEC,110,2722,360,706,338,637,22,69,170,239,170,419,589,106,79,32,184,188,912
3408,Frank Booker,2014,2018,Total,Total,127,2304,281,724,83,164,198,560,152,199,58,201,259,90,79,20,97,212,912
3409,Broderick Gilchrest,2008,2011,Total,Total,88,2311,318,760,220,451,98,309,178,263,30,138,168,168,102,4,187,171,912
3410,Kammeon Holsey,2011,2014,Georgia Tech,ACC,125,2473,373,677,373,677,0,0,166,282,247,295,542,95,53,37,207,303,912
3411,Wes Johnson,2008,2010,Total,Total,62,1954,321,700,223,436,98,264,172,222,111,295,406,117,82,75,138,132,912
3412,Matt Jones,2014,2017,Duke,ACC,143,3411,318,798,148,339,170,459,106,155,118,192,310,195,147,17,113,268,912
3413,Akil Mitchell,2011,2014,Virginia,ACC,133,3164,361,695,360,684,1,11,189,331,227,571,798,147,113,51,155,266,912
3414,Jalyn Patterson,2015,2019,Total,Total,123,3016,312,830,143,309,169,521,119,162,54,268,322,332,151,14,184,161,912
3415,Glenn Robinson,2013,2014,Michigan,Big Ten,76,2506,349,665,293,486,56,179,158,220,137,238,375,87,74,21,78,99,912
3416,Jarryn Skeete,2013,2016,Buffalo,MAC,122,3320,292,858,107,309,185,549,143,192,71,330,401,247,103,13,170,237,912
3417,Bandja Sy,2010,2013,New Mexico State,WAC,119,2711,330,786,239,483,91,303,161,236,153,348,501,122,65,54,194,200,912
3418,Nick Winbush,2008,2011,Miami (OH),MAC,120,2526,324,773,172,354,152,419,112,151,112,345,457,66,49,74,98,252,912
3419,Ryan Bathie,2008,2009,Nicholls State,Southland,62,1837,320,722,183,333,137,389,134,184,78,201,279,136,64,24,148,168,911
3420,Reginald Buckner,2010,2013,Mississippi,SEC,132,3212,353,616,351,612,2,4,203,425,331,549,880,83,92,326,169,438,911
3421,Reveal Chukwujekwu,2014,2017,Houston Baptist,Southland,117,2697,319,705,297,626,22,79,251,337,213,418,631,165,70,21,208,207,911
3422,Till Gloger,2013,2016,Maine,AEC,117,2256,376,699,376,696,0,3,159,222,134,273,407,37,48,22,137,179,911
3423,Malcolm Hawkins,2010,2014,Total,Total,97,2112,280,712,182,434,98,278,253,355,78,226,304,118,77,24,191,245,911
3424,Vince Hunter,2014,2015,Texas-El Paso,CUSA,67,1816,330,611,326,599,4,12,247,409,165,362,527,98,68,59,159,209,911
3425,Carlik Jones,2018,2019,Radford,Big South,67,2153,327,744,269,537,58,207,199,261,38,264,302,294,92,10,145,112,911
3426,Elijah Mitrou-Long,2016,2019,Total,Total,102,2571,314,832,221,567,93,265,190,272,30,313,343,279,119,9,199,179,911
3427,Deontae North,2015,2018,Total,Total,78,1706,304,697,206,398,98,299,205,288,81,162,243,115,91,18,121,176,911
3428,Seth Tarver,2008,2010,Oregon State,Pac-10,99,2932,343,725,291,551,52,174,173,264,151,333,484,190,156,10,153,154,911
3429,Jon Avery,2008,2010,IUPUI,Summit,98,2404,387,603,386,598,1,5,135,239,187,294,481,95,86,73,121,145,910
3430,Kris Clyburn,2017,2019,Nevada-Las Vegas,MWC,96,2504,317,777,203,430,114,347,162,236,139,300,439,124,70,21,135,146,910
3431,Mason Ramsey,2015,2018,Tennessee Tech,OVC,122,2497,350,704,321,587,29,117,181,259,177,233,410,107,92,32,132,368,910
3432,Jimmy Whitt,2016,2019,Total,Total,95,2699,377,813,361,748,16,65,140,223,123,294,417,267,123,35,129,213,910
3433,Jordan Wilson,2014,2016,Northern Colorado,Big Sky,93,2541,318,734,174,363,144,371,130,165,35,159,194,234,78,2,117,182,910
3434,McKinley Wright IV,2018,2019,Colorado,Pac-12,67,2175,327,694,261,498,66,196,190,241,80,242,322,341,70,21,203,107,910
3435,Lawrence Gilbert,2009,2011,Louisiana-Monroe,Sun Belt,85,2427,295,738,171,386,124,352,195,234,126,294,420,87,58,24,166,243,909
3436,Josh Ibarra,2015,2018,Houston Baptist,Southland,89,1922,386,639,386,639,0,0,137,236,230,404,634,89,30,129,136,270,909
3437,Teyvion Kirk,2018,2019,Ohio,MAC,62,1938,334,780,308,693,26,87,215,338,81,279,360,171,83,10,242,162,909
3438,Arnold Louis,2009,2013,Savannah State,Total,120,2696,350,716,340,675,10,41,199,365,307,519,826,81,124,46,201,314,909
3439,Shaq Calhoun,2016,2018,Total,Total,98,2153,303,786,155,341,148,445,154,201,45,202,247,88,126,25,132,272,908
3440,Josh Carter,2008,2009,Texas A&M,Big 12,70,2082,289,677,133,276,156,401,174,208,73,216,289,109,49,14,66,104,908
3441,Dejuan Clayton,2017,2019,Coppin State,MEAC,69,2282,283,711,195,416,88,295,254,347,30,139,169,229,65,8,162,135,908
3442,Lamont Mack,2008,2009,Charlotte,A-10,65,1727,308,801,180,424,128,377,164,229,85,268,353,74,61,21,161,229,908
3443,Abdul Gaddy,2010,2013,Washington,Total,118,3210,345,807,275,586,70,221,147,222,81,200,281,469,85,18,256,295,907
3444,Dwight Hardy,2010,2011,St. John's (NY),Big East,62,1773,298,692,182,376,116,316,195,240,39,115,154,87,61,5,112,98,907
3445,Malik Harmon,2014,2018,Saint Francis (PA),NEC,120,3321,272,806,132,371,140,435,223,320,28,243,271,327,102,5,186,211,907
3446,JR Hobbie,2014,2017,Brown,Ivy,115,2425,275,653,18,54,257,599,100,111,9,107,116,53,31,2,70,194,907
3447,Joab Jerome,2011,2014,Winthrop,Big South,120,2817,291,648,242,496,49,152,276,393,127,307,434,216,81,41,247,272,907
3448,Corey Lyons,2008,2009,Norfolk State,MEAC,62,1999,308,745,213,437,95,308,196,262,79,153,232,64,58,30,127,158,907
3449,George Marshall,2013,2016,Total,Total,91,2429,300,769,137,349,163,420,144,194,9,209,218,172,48,4,110,161,907
3450,Justin Massey,2015,2018,Total,Total,91,2152,285,742,128,292,157,450,180,238,36,187,223,102,52,2,95,159,907
3451,Armani Moore,2013,2016,Tennessee,SEC,128,2892,343,804,308,673,35,131,186,319,199,417,616,245,117,131,200,276,907
3452,Will Regan,2011,2015,Total,Total,116,2669,305,683,194,379,111,304,186,243,178,293,471,73,38,60,107,201,907
3453,Sheldon Strickland,2011,2014,Charleston Southern,Big South,125,2487,319,813,174,423,145,390,124,170,54,160,214,231,89,3,160,177,907
3454,Trey Burch-Manning,2017,2019,South Dakota,Summit,95,2604,336,724,287,605,49,119,185,306,159,461,620,130,90,19,161,280,906
3455,Travis Cohn,2008,2011,Jacksonville,A-Sun,127,2281,339,738,245,482,94,256,134,169,115,197,312,146,97,16,193,183,906
3456,Isaiah Moss,2017,2019,Iowa,Big Ten,102,2223,323,787,197,465,126,322,134,164,48,181,229,153,73,27,126,143,906
3457,William Truss,2012,2015,Presbyterian,Big South,112,2666,368,602,362,589,6,13,164,255,179,498,677,45,51,111,154,282,906
3458,Keegan Bell,2008,2012,Total,Total,131,3659,294,868,106,239,188,629,129,181,56,304,360,633,97,4,312,187,905
3459,Kevin Punter,2015,2016,Tennessee,SEC,58,1878,288,650,187,371,101,279,228,294,15,141,156,151,87,12,122,163,905
3460,Cameron Rundles,2008,2011,Total,Total,99,2572,284,710,148,357,136,353,201,304,41,230,271,222,75,5,153,177,905
3461,Eric Williams Jr.,2018,2019,Duquesne,A-10,64,2066,298,731,175,396,123,335,186,250,161,361,522,96,79,17,122,137,905
3462,Marcus Barham,2017,2018,Florida A&M,MEAC,61,2043,294,756,141,342,153,414,163,213,55,187,242,118,58,20,150,128,904
3463,Rob Hampton,2008,2011,Total,Total,84,2389,304,707,245,514,59,193,237,352,93,191,284,166,85,9,223,209,904
3464,Sam Hughes,2013,2016,North Carolina-Asheville,Big South,127,2568,340,749,293,611,47,138,177,249,159,277,436,127,109,66,181,293,904
3465,Kyle Kelm,2011,2014,Milwaukee,Horizon,125,2805,309,668,264,486,45,182,241,359,162,325,487,122,47,37,171,211,904
3466,Neal Kingman,2008,2011,Northern Colorado,Big Sky,124,2461,304,709,187,364,117,345,179,255,98,307,405,137,49,36,197,245,904
3467,Taylor Brown,2009,2012,Bradley,MVC,91,2105,322,727,279,579,43,148,216,278,138,335,473,97,64,33,155,180,903
3468,DeMarcus Gatlin,2012,2015,Sam Houston State,Southland,90,2322,287,684,236,505,51,179,278,432,150,250,400,196,93,41,173,214,903
3469,Lucas Hargrove,2008,2010,Auburn,SEC,94,2493,334,704,256,461,78,243,157,243,162,367,529,177,98,45,187,229,903
3470,Patrick Heckmann,2012,2015,Boston College,ACC,118,2691,290,632,181,312,109,320,214,281,76,276,352,197,90,31,194,276,903
3471,James Johnson,2008,2009,Wake Forest,ACC,61,1821,351,682,301,513,50,169,151,218,172,336,508,99,85,88,152,184,903
3472,Dallis Joyner,2009,2012,Stony Brook,AEC,124,3134,353,748,353,747,0,1,197,375,316,414,730,86,63,83,202,269,903
3473,Vernon Macklin,2008,2011,Total,Total,105,2199,399,666,399,665,0,1,105,230,202,257,459,78,41,80,135,230,903
3474,Kelly Olynyk,2010,2013,Gonzaga,WCC,101,1735,338,569,313,494,25,75,202,285,152,309,461,107,52,46,140,197,903
3475,Cleveland Richard,2008,2010,Army,Patriot,89,2625,338,779,265,561,73,218,154,207,62,225,287,202,135,31,187,203,903
3476,Brandon Sebirumbi,2009,2012,Furman,Southern,123,2788,295,554,295,553,0,1,313,478,223,256,479,87,50,45,184,383,903
3477,Nickeil Alexander-Walker,2018,2019,Virginia Tech,ACC,67,2006,314,677,198,374,116,303,158,207,39,227,266,184,92,36,149,127,902
3478,Donta Harper,2012,2014,Gardner-Webb,Big South,96,2231,332,729,330,699,2,30,236,331,130,228,358,149,104,55,225,236,902
3479,Cameron Krutwig,2018,2019,Loyola (IL),MVC,72,1857,370,601,369,598,1,3,161,248,127,350,477,149,39,61,128,115,902
3480,Matt Morgan,2008,2012,Total,Total,123,2563,368,795,360,745,8,50,158,233,203,284,487,31,39,70,106,240,902
3481,Alex Petrie,2018,2019,Lafayette,Patriot,61,1440,314,743,181,412,133,331,141,165,19,114,133,54,22,1,91,40,902
3482,Bryan Smith,2012,2015,Fordham,A-10,116,3053,311,901,155,366,156,535,124,173,133,269,402,183,125,34,173,320,902
3483,Mychal Ammons,2012,2014,South Alabama,Sun Belt,90,2496,312,724,244,539,68,185,209,319,223,370,593,108,72,80,187,267,901
3484,Josh Delaney,2016,2019,Sam Houston State,Southland,129,2607,284,752,90,227,194,525,139,179,33,182,215,327,78,6,149,190,901
3485,Trey McCorkle,2009,2012,Purdue-Fort Wayne,Summit,118,2306,374,653,374,653,0,0,153,216,151,273,424,81,31,65,127,285,901
3486,Oliver McNally,2009,2012,Harvard,Ivy,118,3222,252,568,137,269,115,299,282,328,28,289,317,326,103,4,158,211,901
3487,Dwayne Sutton,2016,2019,Total,Total,104,2654,298,662,211,406,87,256,218,325,195,444,639,128,113,46,125,240,901
3488,Perrion Callandret,2014,2018,Idaho,Total,113,2571,291,721,160,365,131,356,187,252,46,278,324,208,76,25,182,206,900
3489,Willie Conner,2014,2017,Total,Total,94,2303,282,676,167,337,115,339,221,307,68,140,208,86,52,21,129,189,900
3490,Derric Jean,2016,2019,Louisiana Tech,CUSA,108,2724,293,725,167,395,126,330,188,257,91,229,320,270,114,30,172,250,900
3491,Jake Kelly,2008,2011,Total,Total,97,2732,302,722,207,459,95,263,201,251,45,216,261,237,69,34,231,251,900
3492,Jahenns Manigat,2011,2014,Creighton,Total,145,3592,296,679,90,171,206,508,102,129,44,284,328,298,117,5,139,307,900
3493,Chris McKnight,2008,2010,Akron,MAC,106,2232,305,621,264,507,41,114,249,372,177,267,444,101,81,33,142,230,900
3494,Nick Allen,2016,2019,Texas-San Antonio,CUSA,129,2846,350,737,266,491,84,246,115,174,164,399,563,124,58,55,206,361,899
3495,Tyree Appleby,2018,2019,Cleveland State,Horizon,63,1759,276,642,166,341,110,301,237,316,27,164,191,297,86,17,215,116,899
3496,Jalen Avery,2016,2019,Kent State,MAC,127,3287,280,744,118,283,162,461,177,226,44,197,241,326,61,3,76,101,899
3497,Montay Brandon,2013,2016,Florida State,ACC,135,3509,311,669,286,574,25,95,252,409,154,364,518,196,99,30,221,240,899
3498,Glenn Bryant,2010,2014,Total,Total,131,2364,356,739,338,644,18,95,169,260,183,303,486,42,78,168,104,226,899
3499,Brandon Bush,2008,2009,Texas State,Southland,59,1658,311,640,274,506,37,134,240,342,135,287,422,116,59,11,152,180,899
3500,Ria'n Holland,2015,2018,Total,Total,76,1743,299,675,160,327,139,348,162,192,44,131,175,113,66,9,78,136,899
3501,Deniz Kilicli,2010,2013,West Virginia,Total,112,2241,357,727,357,727,0,0,185,339,186,268,454,112,37,42,217,288,899
3502,Triston Simpson,2017,2019,South Dakota,Summit,99,2921,290,683,195,415,95,268,224,300,55,220,275,302,83,3,161,185,899
3503,Dexter Strickland,2010,2013,North Carolina,ACC,128,3083,323,702,303,611,20,91,233,339,70,226,296,342,146,9,189,217,899
3504,Mike Thomas,2014,2018,Hawaii,Big West,116,2112,324,626,309,550,15,76,236,357,187,312,499,82,41,58,128,316,899
3505,Karrington Ward,2014,2015,Eastern Michigan,MAC,72,2178,306,714,203,416,103,298,184,274,106,357,463,48,99,71,67,98,899
3506,Tavarus Alston,2008,2010,North Carolina A&T,MEAC,88,2063,320,782,235,493,85,289,173,267,45,152,197,281,111,10,221,132,898
3507,Bill Amis,2008,2011,Hawaii,WAC,81,2290,361,693,354,671,7,22,169,230,150,349,499,82,73,130,157,222,898
3508,D.J. Brown,2012,2015,Total,Total,121,3213,256,748,101,280,155,468,231,311,59,268,327,347,109,2,183,215,898
3509,Sean McNally,2008,2011,Maine,AEC,118,3024,330,750,299,651,31,99,207,297,263,439,702,116,74,110,179,297,898
3510,Eugene Myatt,2008,2009,Howard,MEAC,60,1953,324,796,264,609,60,187,190,258,37,174,211,90,41,7,161,144,898
3511,Darnell Porter,2008,2011,Total,Total,78,1936,278,662,169,364,109,298,233,296,108,222,330,120,89,21,190,256,898
3512,Karl Charles,2016,2018,Holy Cross,Patriot,89,2639,263,615,179,346,84,269,287,362,74,240,314,272,121,29,189,219,897
3513,Willie Mangum,2016,2017,Eastern Michigan,MAC,65,1603,311,782,153,355,158,427,117,167,26,121,147,122,88,4,119,148,897
3514,Michael Vogler,2008,2010,Troy,Sun Belt,93,2742,307,655,224,453,83,202,200,261,83,235,318,473,173,11,214,220,897
3515,Antonio Bostic,2011,2013,Stephen F. Austin,Southland,93,2755,344,838,267,587,77,251,131,173,52,232,284,184,107,14,166,173,896
3516,D'Aundray Brown,2008,2012,Cleveland State,Horizon,115,3262,356,731,321,626,35,105,149,194,240,316,556,214,209,31,168,275,896
3517,Ian Dubose,2018,2019,Houston Baptist,Southland,61,1797,302,674,214,453,88,221,204,307,100,249,349,164,91,20,147,170,896
3518,Jawun Evans,2016,2017,Oklahoma State,Big 12,54,1571,308,688,253,553,55,135,225,275,34,172,206,312,82,8,146,128,896
3519,Omar Wattad,2008,2012,Total,Total,98,2080,284,786,100,264,184,522,144,192,67,201,268,133,63,7,144,175,896
3520,Hasan Abdullah,2016,2019,Navy,Patriot,102,2742,320,848,190,445,130,403,125,198,44,257,301,351,181,12,273,262,895
3521,Armon Bassett,2008,2010,Total,Total,62,2062,269,659,128,299,141,360,216,264,17,165,182,213,68,2,128,83,895
3522,Amida Brimah,2014,2017,Connecticut,AAC,133,2909,347,545,347,545,0,0,201,312,235,357,592,28,25,367,134,384,895
3523,Pierre Curtis,2008,2010,James Madison,CAA,96,3071,273,600,221,459,52,141,297,364,94,243,337,351,138,20,222,201,895
3524,Nick Daniels,2015,2018,Oakland,Horizon,130,2617,280,726,95,253,185,473,150,205,49,241,290,282,110,5,186,193,895
3525,Travis Franklin,2009,2011,Colorado State,MWC,92,2091,275,536,275,536,0,0,345,565,181,226,407,116,96,20,194,220,895
3526,Dan Garvin,2014,2017,Bryant,NEC,109,2684,373,749,366,711,7,38,142,245,268,442,710,96,73,148,169,343,895
3527,Jon Harris,2011,2014,Total,Total,119,2851,318,694,165,282,153,412,106,145,118,341,459,126,83,54,108,192,895
3528,Nikola Malesevic,2010,2013,Rhode Island,A-10,100,2377,310,737,193,416,117,321,158,240,121,246,367,121,77,48,136,256,895
3529,Ray Penn,2010,2014,Total,Total,102,2792,284,780,124,328,160,452,167,216,39,129,168,364,56,4,217,199,895
3530,Darreon Reddick,2015,2018,Tennessee State,OVC,121,3259,287,805,168,444,119,361,202,274,43,284,327,169,75,8,192,220,895
3531,Torrance Rowe,2015,2016,Tennessee Tech,OVC,60,1942,284,711,151,321,133,390,194,231,29,123,152,215,44,2,139,73,895
3532,Matt Staff,2010,2013,Total,Total,93,1993,348,724,282,538,66,186,133,165,132,371,503,103,51,105,161,203,895
3533,Sebastian Townes,2017,2019,Bryant,NEC,83,1757,322,692,289,584,33,108,218,326,129,168,297,94,29,13,133,197,895
3534,Darrell Lampley,2008,2012,Total,Total,90,2260,295,836,187,465,108,371,196,242,48,132,180,265,93,4,233,221,894
3535,Derek Ogbeide,2016,2019,Georgia,SEC,128,2620,374,685,374,683,0,2,146,262,241,554,795,83,41,111,169,276,894
3536,Brian Rudolph,2008,2011,Loyola (MD),MAAC,124,3598,281,715,238,550,43,165,289,395,71,290,361,527,101,5,290,257,894
3537,Tyler Wideman,2015,2018,Butler,Big East,135,2654,345,554,345,548,0,6,204,312,251,370,621,74,81,104,140,374,894
3538,Derek Williams,2009,2010,Southern Methodist,CUSA,61,2099,303,706,234,491,69,215,219,294,30,152,182,219,55,8,154,102,894
3539,Marcus Byrd,2013,2016,Denver,Total,122,2679,318,667,155,278,163,389,94,120,54,283,337,152,61,45,119,285,893
3540,Bruce Ellington,2011,2014,South Carolina,SEC,80,2435,322,957,196,546,126,411,123,184,61,157,218,238,79,9,211,200,893
3541,Kendrec Ferrara,2013,2016,Furman,Southern,129,2998,357,756,307,593,50,163,129,227,187,362,549,83,36,123,204,231,893
3542,Larry Jackson,2008,2011,Florida A&M,MEAC,124,1627,313,668,312,662,1,6,266,481,189,435,624,56,63,38,167,344,893
3543,Amir Johnson,2008,2010,Radford,Big South,90,3163,293,785,179,446,114,339,193,293,32,326,358,493,131,11,297,240,893
3544,Brandon Ubel,2010,2013,Nebraska,Total,125,3020,312,646,283,548,29,98,240,299,211,337,548,109,49,47,165,299,893
3545,Al-Farouq Aminu,2009,2010,Wake Forest,ACC,62,1869,313,657,288,552,25,105,241,351,204,381,585,87,74,82,180,172,892
3546,Will Creekmore,2008,2011,Total,Total,98,2116,325,618,308,573,17,45,225,359,187,348,535,85,32,46,138,244,892
3547,Shannon Hale,2014,2017,Alabama,SEC,108,2173,282,716,174,370,108,346,220,318,87,224,311,84,56,38,187,209,892
3548,Tevin Hammond,2013,2015,Arkansas-Pine Bluff,SWAC,93,3063,255,755,130,367,125,388,257,354,66,195,261,365,229,5,307,267,892
3549,Tim Kamczyc,2010,2013,Cleveland State,Horizon,134,3566,328,682,219,402,109,280,127,176,144,321,465,188,108,31,145,294,892
3550,Eric Laster,2013,2016,Loyola (MD),Total,117,2706,330,845,224,529,106,316,126,217,141,217,358,121,48,38,134,239,892
3551,Josh Newkirk,2014,2018,Total,Total,135,2997,324,786,215,473,109,313,135,200,49,209,258,348,65,16,212,287,892
3552,Jared Quayle,2009,2010,Utah State,WAC,70,2169,294,672,166,356,128,316,176,214,96,329,425,275,89,5,120,124,892
3553,Jaime Serna,2009,2012,UC-Santa Barbara,Big West,117,2501,339,603,339,600,0,3,214,308,190,308,498,73,71,82,168,333,892
3554,Nick Stover,2013,2017,Total,Total,126,2568,310,741,219,455,91,286,181,256,104,206,310,140,66,33,163,230,892
3555,Kasey Wilson,2012,2015,Central Florida,Total,120,2487,308,688,192,392,116,296,160,248,149,374,523,64,63,61,135,265,892
3556,Josh Cameron,2014,2015,Coastal Carolina,Big South,67,1665,284,702,154,356,130,346,193,256,25,126,151,136,68,10,141,109,891
3557,Quinton Chievous,2013,2016,Total,Total,93,2069,335,666,287,488,48,178,173,313,156,422,578,93,35,8,159,173,891
3558,Rashad Bishop,2008,2011,Cincinnati,Big East,129,3291,334,772,235,466,99,306,123,183,152,338,490,239,112,58,163,223,890
3559,Keljin Blevins,2015,2019,Total,Total,117,2710,319,800,274,608,45,192,207,321,150,363,513,122,62,31,210,225,890
3560,D.J. Byrd,2010,2013,Purdue,Big Ten,130,2663,281,735,86,206,195,529,133,184,97,243,340,206,68,22,122,270,890
3561,Laimonas Chatkevicius,2013,2016,South Carolina,SEC,123,2234,361,703,343,638,18,65,150,213,191,351,542,71,45,108,167,276,890
3562,Kenny Cooper,2017,2019,Lipscomb,A-Sun,99,2485,316,731,252,517,64,214,194,299,48,225,273,377,182,33,233,257,890
3563,Andrew Hayles,2008,2009,Alabama State,SWAC,63,2056,310,706,174,344,136,362,134,182,68,154,222,99,64,14,114,111,890
3564,Rodney Hood,2012,2014,Total,Total,67,2200,318,699,200,401,118,298,136,176,60,231,291,139,38,23,84,132,890
3565,Bosko Kostur,2014,2018,Bryant,NEC,112,2217,294,646,180,359,114,287,188,237,98,259,357,75,50,13,146,309,890
3566,Konstantinos Mitoglou,2015,2017,Wake Forest,ACC,96,2262,290,674,167,320,123,354,187,245,167,348,515,64,52,65,128,227,890
3567,Brandon Mobley,2012,2015,Seton Hall,Big East,111,2529,313,715,220,441,93,274,171,217,136,391,527,77,52,95,122,286,890
3568,Jamel Outler,2011,2015,Total,Total,110,2250,274,746,93,226,181,520,161,235,28,149,177,66,67,2,126,204,890
3569,Namon Wright,2015,2019,Total,Total,105,2352,295,730,174,382,121,348,179,239,53,320,373,105,52,21,161,189,890
3570,Dennis Clifford,2012,2016,Boston College,ACC,125,2934,336,669,328,638,8,31,209,320,180,469,649,118,44,128,212,309,889
3571,Conner Frankamp,2014,2018,Total,Total,122,2307,309,738,130,270,179,468,92,105,15,154,169,209,63,20,44,110,889
3572,Martins Igbanu,2017,2019,Tulsa,AAC,95,2056,308,537,301,516,7,21,266,403,170,298,468,44,32,24,159,199,889
3573,Isaiah Lamb,2016,2019,Marist,MAAC,121,2709,304,755,191,400,113,355,168,252,92,319,411,73,65,20,135,224,889
3574,Kevin Lisch,2008,2009,Saint Louis,A-10,62,2157,265,675,131,323,134,352,225,274,22,205,227,175,78,5,117,117,889
3575,Jarell Martin,2014,2015,Louisiana State,SEC,65,1996,323,654,282,521,41,133,202,293,154,297,451,88,65,45,144,170,889
3576,Fred Miller,2012,2015,South Carolina Upstate,A-Sun,132,2789,322,836,230,539,92,297,153,207,59,286,345,346,159,11,224,222,889
3577,J.P. Prince,2008,2010,Tennessee,SEC,95,2248,342,638,326,567,16,71,189,313,147,208,355,259,130,52,199,254,889
3578,Zach Sellers,2017,2019,Savannah State,MEAC,92,2503,312,748,182,347,130,401,135,185,78,207,285,348,113,9,196,165,889
3579,Mitchell Wilbekin,2015,2018,Wake Forest,ACC,119,3196,272,747,75,237,197,510,148,179,34,204,238,177,91,5,84,225,889
3580,Adrian Bowie,2008,2011,Maryland,ACC,135,2605,321,688,258,498,63,190,183,269,99,230,329,286,126,21,188,222,888
3581,Aaron Carter,2008,2011,Indiana State,MVC,127,2523,265,661,131,290,134,371,224,276,95,223,318,95,52,26,155,253,888
3582,Sterling Carter,2011,2014,Total,Total,93,1982,298,822,100,269,198,553,94,142,50,211,261,141,88,29,170,224,888
3583,Jehvon Clarke,2012,2015,Bowling Green State,MAC,116,2423,328,854,230,541,98,313,134,179,70,197,267,261,109,6,227,147,888
3584,Stone Gettings,2016,2018,Cornell,Ivy,85,1758,321,696,232,436,89,260,157,206,104,302,406,169,45,46,164,216,888
3585,Willie Green,2012,2014,Stetson,A-Sun,91,2282,337,645,321,580,16,65,198,294,174,287,461,125,44,121,136,177,888
3586,I.J. Ready,2014,2017,Mississippi State,SEC,113,3057,328,812,246,534,82,278,150,177,41,226,267,401,153,2,184,169,888
3587,David Wear,2010,2014,Total,Total,130,2832,354,748,294,606,60,142,120,163,191,369,560,96,69,25,120,221,888
3588,Bilal Benn,2009,2010,Niagara,MAAC,65,2282,329,795,256,547,73,248,156,216,232,392,624,188,140,28,174,177,887
3589,Landon Clement,2008,2012,Total,Total,84,1825,287,698,107,239,180,459,133,163,25,138,163,70,53,1,92,82,887
3590,Corban Collins,2013,2017,Total,Total,119,2628,285,751,130,343,155,408,162,225,46,230,276,218,88,9,151,216,887
3591,Corey Law,2010,2013,High Point,Big South,109,2371,342,634,342,628,0,6,203,377,296,397,693,54,79,65,135,262,887
3592,Michael Messer,2011,2015,Southern Illinois-Edwardsville,Total,109,2641,307,688,218,453,89,235,184,258,108,269,377,149,67,19,155,290,887
3593,Jordan Reves,2010,2013,Texas-Arlington,Total,124,2717,332,637,332,637,0,0,223,350,257,503,760,85,82,167,210,360,887
3594,Deville Smith,2012,2015,Total,Total,92,2368,317,761,203,404,114,357,139,210,42,207,249,289,111,26,202,166,887
3595,Paul White,2015,2019,Total,Total,111,2471,311,696,201,394,110,302,155,200,101,264,365,157,65,51,112,276,887
3596,James Ennis,2012,2013,Long Beach State,Big West,67,2080,299,606,201,329,98,277,190,241,107,255,362,158,112,69,168,161,886
3597,Troyce Manassa,2016,2017,Savannah State,MEAC,61,1746,289,673,203,422,86,251,222,292,59,252,311,160,63,23,137,148,886
3598,Jalen McDaniels,2018,2019,San Diego State,MWC,67,1870,338,670,310,576,28,94,182,240,141,388,529,101,65,35,118,177,886
3599,Justice Sueing,2018,2019,University of California,Pac-12,63,2093,297,686,220,435,77,251,215,293,94,264,358,104,100,30,121,153,886
3600,Matt Willms,2014,2018,Texas-El Paso,CUSA,118,2475,348,606,348,603,0,3,190,310,162,379,541,107,46,125,188,284,886
3601,Yohanny Dalembert,2014,2017,James Madison,CAA,109,2152,331,603,330,602,1,1,222,365,193,381,574,73,36,116,202,265,885
3602,Lewis Jackson,2009,2012,Purdue,Big Ten,121,2991,325,708,298,607,27,101,208,300,110,241,351,456,109,6,212,262,885
3603,Cody John,2016,2019,Weber State,Big Sky,97,2461,330,724,264,488,66,236,159,220,19,262,281,191,43,15,148,184,885
3604,Darius Jones-Gibson,2015,2016,Samford,Southern,65,1934,286,593,265,525,21,68,292,435,44,148,192,183,74,10,159,159,885
3605,Chris Manresa,2010,2013,San Diego,WCC,117,2621,347,690,344,678,3,12,188,352,186,465,651,88,57,71,139,236,885
3606,Trevor Mbakwe,2008,2013,Total,Total,83,2107,306,538,306,537,0,1,273,434,249,460,709,89,62,110,164,212,885
3607,Richard Solomon,2011,2014,University of California,Total,109,2457,329,642,322,614,7,28,220,385,226,533,759,81,85,119,143,291,885
3608,Jordan Evans,2018,2019,Mississippi Valley State,SWAC,64,1856,291,817,180,498,111,319,191,255,46,135,181,124,59,3,117,161,884
3609,JT Gibson,2016,2019,Omaha,Summit,101,2400,319,743,151,294,168,449,78,100,29,186,215,177,79,9,118,164,884
3610,Anthony Goods,2008,2009,Stanford,Pac-10,68,2017,277,705,142,337,135,368,195,253,36,147,183,118,39,3,125,96,884
3611,Devon Hall,2015,2018,Virginia,ACC,128,3075,305,728,190,432,115,296,159,197,44,363,407,264,73,20,115,183,884
3612,Jermel Jenkins,2009,2012,Iona,MAAC,129,2926,302,786,126,324,176,462,104,139,57,204,261,268,115,1,168,157,884
3613,Kevin Rogers,2008,2009,Baylor,Big 12,71,2226,355,664,353,651,2,13,172,250,181,388,569,64,53,50,140,181,884
3614,T.J. Sapp,2012,2015,Total,Total,96,2301,284,689,145,307,139,382,177,224,42,220,262,172,86,11,148,189,884
3615,Isaiah Austin,2013,2014,Baylor,Big 12,73,2111,338,744,290,589,48,155,159,241,169,332,501,91,29,176,135,173,883
3616,Kyle Austin,2008,2010,Total,Total,53,1717,315,710,269,573,46,137,207,308,142,212,354,79,31,11,111,117,883
3617,Shane Hammink,2013,2017,Total,Total,115,2215,309,633,241,412,68,221,197,256,84,219,303,166,66,25,184,181,883
3618,Tevin King,2016,2019,South Dakota State,Summit,134,3186,315,640,268,490,47,150,206,308,129,450,579,328,181,26,207,347,883
3619,Xavier Lundy,2014,2017,Rider,MAAC,119,2356,334,737,242,455,92,282,123,169,123,238,361,90,66,76,141,218,883
3620,Kenny Thomas,2008,2009,Radford,Big South,61,1956,286,658,156,309,130,349,181,238,55,214,269,117,68,12,163,131,883
3621,Isaiah Whitehead,2015,2016,Seton Hall,Big East,56,1710,285,760,168,434,117,326,196,259,40,167,207,251,70,63,192,131,883
3622,Jeff Brooks,2008,2011,Penn State,Big Ten,132,2881,358,741,305,580,53,161,113,183,172,361,533,159,62,80,153,236,882
3623,Derrick Brown,2008,2009,Xavier,A-10,72,2071,318,580,268,458,50,122,196,271,156,298,454,131,58,60,131,179,882
3624,Ryan Cline,2016,2019,Purdue,Big Ten,139,2997,300,736,62,151,238,585,44,63,15,258,273,279,54,10,94,176,882
3625,Drake LaMont,2015,2018,Western Michigan,MAC,130,2877,365,713,363,707,2,6,150,232,233,333,566,96,53,89,95,307,882
3626,Malik Newman,2016,2018,Total,Total,68,2037,297,686,151,320,146,366,142,182,28,249,277,145,53,8,111,106,882
3627,Donte Poole,2009,2012,Murray State,OVC,117,2311,276,659,167,337,109,322,221,282,67,248,315,129,130,21,147,184,882
3628,Keaton Grant,2008,2010,Purdue,Big Ten,104,2720,278,713,118,273,160,440,165,217,75,233,308,184,85,41,144,240,881
3629,Jordyn Martin,2013,2017,Northern Arizona,Big Sky,135,3143,366,681,357,660,9,21,140,217,340,456,796,117,59,43,156,355,881
3630,Kenard Moore,2008,2009,Southeast Missouri State,OVC,60,1746,301,735,127,253,174,482,105,132,25,82,107,75,53,6,118,97,881
3631,Shane Walker,2008,2012,Total,Total,115,2762,293,731,225,538,68,193,227,301,184,444,628,110,67,142,204,355,881
3632,Tony Wroblicky,2011,2014,American,Patriot,125,2565,363,657,363,657,0,0,155,242,234,433,667,132,67,151,177,335,881
3633,Will Campbell,2009,2012,Monmouth,NEC,101,2207,283,759,159,375,124,384,190,244,62,156,218,93,90,11,151,176,880
3634,Curtis Cobb,2016,2019,Total,Total,84,2286,331,814,199,429,132,385,86,139,45,272,317,175,86,27,153,161,880
3635,Montell Goodwin,2017,2018,Eastern Illinois,OVC,60,1998,307,791,166,414,141,377,125,166,27,160,187,194,68,19,125,92,880
3636,Shane Johannsen,2008,2011,Northern Arizona,Big Sky,106,2260,347,499,347,499,0,0,186,332,178,358,536,49,55,138,111,245,880
3637,Damian Johnson,2008,2010,Minnesota,Big Ten,99,2464,338,673,308,562,30,111,174,268,178,260,438,171,181,173,133,278,880
3638,James Southerland,2010,2013,Syracuse,Big East,112,2089,325,724,172,311,153,413,77,104,95,276,371,68,102,85,66,169,880
3639,D'Shon Taylor,2015,2016,Norfolk State,MEAC,67,2028,292,649,198,384,94,265,202,281,111,234,345,96,66,45,120,179,880
3640,Issac Vann,2016,2019,Total,Total,76,2034,306,708,231,466,75,242,193,247,80,233,313,133,91,30,128,186,880
3641,J.D. Weatherspoon,2011,2015,Total,Total,102,2241,316,569,296,501,20,68,228,379,140,393,533,76,56,49,111,119,880
3642,Byron Eaton,2008,2009,Oklahoma State,Big 12,68,2091,236,570,178,398,58,172,349,447,49,187,236,315,146,13,198,239,879
3643,Tyler Hubbard,2013,2016,Loyola (MD),Total,119,2655,273,776,84,223,189,553,144,194,38,139,177,84,51,4,92,183,879
3644,De'Riante Jenkins,2017,2019,Virginia Commonwealth,A-10,86,2128,314,736,157,329,157,407,94,128,54,229,283,159,77,25,149,133,879
3645,Mindaugas Kacinas,2013,2016,South Carolina,SEC,132,3129,328,618,293,500,35,118,188,280,274,358,632,82,77,66,167,323,879
3646,Chris McEachin,2008,2012,Total,Total,98,2260,308,792,187,412,121,380,142,210,75,170,245,121,103,52,173,215,879
3647,Justin Miller,2017,2019,Louisiana,Sun Belt,97,2026,307,684,247,489,60,195,205,286,189,336,525,134,46,18,163,287,879
3648,Mike Watkins,2017,2019,Penn State,Big Ten,89,2111,362,587,362,586,0,1,155,269,200,525,725,53,70,199,126,214,879
3649,Kyle Cain,2011,2014,Total,Total,92,2299,368,761,359,729,9,32,133,192,171,444,615,78,48,23,153,213,878
3650,Reuben Clayton,2009,2011,Tennessee-Martin,OVC,91,2320,310,816,223,524,87,292,171,253,76,190,266,163,116,29,183,229,878
3651,Jaycen Herring,2008,2009,Southeast Missouri State,OVC,59,1895,306,661,251,516,55,145,211,298,55,172,227,137,53,37,164,138,878
3652,Jordan Johnson,2016,2018,Total,Total,66,2266,243,562,167,353,76,209,316,388,34,177,211,466,69,9,181,140,878
3653,Ryan Manuel,2012,2015,Southern Methodist,Total,134,3083,258,541,244,498,14,43,348,502,72,293,365,210,97,35,177,263,878
3654,Jodd Maxey,2010,2014,Total,Total,129,2693,356,693,356,688,0,5,166,267,256,364,620,138,138,151,164,322,878
3655,Mamadou Ndiaye,2014,2016,UC-Irvine,Big West,86,1869,344,509,344,508,0,1,190,348,158,396,554,33,15,218,163,234,878
3656,Frisco Sandidge,2008,2010,Delaware State,MEAC,90,2690,323,663,307,583,16,80,216,321,201,299,500,124,93,72,172,212,878
3657,Mikhail Torrance,2008,2010,Alabama,SEC,90,2011,290,632,224,428,66,204,232,269,21,191,212,299,51,12,159,105,878
3658,Eyassu Worku,2017,2019,UC-Irvine,Big West,103,2483,327,846,254,617,73,229,151,210,61,234,295,281,82,4,207,149,878
3659,Mitchell Young,2010,2013,Saint Mary's (CA),WCC,132,2251,350,630,343,602,7,28,171,269,176,367,543,76,62,63,138,270,878
3660,Casey Benson,2015,2018,Total,Total,147,3608,276,685,145,322,131,363,194,262,64,299,363,414,100,6,144,241,877
3661,Calvin Betts,2008,2010,Buffalo,MAC,92,2584,302,702,221,458,81,244,192,267,238,396,634,126,116,49,138,254,877
3662,Garrett Callahan,2009,2010,South Dakota State,Summit,63,1900,273,633,137,293,136,340,195,229,31,130,161,102,47,8,119,116,877
3663,Wesley Davis,2012,2015,Texas State,Total,120,3016,322,789,236,494,86,295,147,238,86,218,304,182,189,21,148,269,877
3664,Tommy Hubbard,2008,2012,East Tennessee State,A-Sun,108,2580,326,742,293,628,33,114,192,277,227,389,616,90,142,21,177,309,877
3665,Tim Johnson,2008,2011,Wofford,Southern,129,3155,342,785,342,783,0,2,193,428,347,655,1002,225,142,65,224,326,877
3666,Mustafaa Jones,2011,2015,Total,Total,112,2700,278,763,83,226,195,537,126,142,26,185,211,135,114,7,140,183,877
3667,Wyatt Lohaus,2015,2019,Northern Iowa,MVC,135,2843,310,763,183,431,127,332,130,166,24,232,256,144,67,1,120,164,877
3668,Jack Purchase,2015,2019,Total,Total,98,2697,287,698,85,144,202,554,101,129,68,401,469,192,48,46,124,196,877
3669,Alex Anderson,2013,2016,Total,OVC,94,2488,283,674,90,205,193,469,117,134,24,157,181,154,33,0,104,75,876
3670,Brett Bailey,2014,2017,San Diego,WCC,126,2593,306,751,246,541,60,210,204,307,146,362,508,114,53,29,145,225,876
3671,Yannick Crowder,2009,2012,Florida A&M,MEAC,122,2222,324,706,324,704,0,2,228,334,293,425,718,44,60,196,172,325,876
3672,Deividas Dulkys,2009,2012,Florida State,ACC,131,2804,299,779,96,207,203,572,75,106,80,207,287,141,138,48,160,252,876
3673,Matt Kenney,2010,2013,Valparaiso,Horizon,130,3137,296,649,201,356,95,293,189,287,72,378,450,330,119,65,212,247,876
3674,Nate Sestina,2016,2019,Bucknell,Patriot,100,1772,343,639,279,463,64,176,126,162,134,381,515,83,31,70,132,224,876
3675,Lewis Sullivan,2015,2019,Alabama-Birmingham,CUSA,127,2195,337,623,302,519,35,104,167,242,169,346,515,102,62,47,123,244,876
3676,Paul Williams,2009,2012,Dayton,A-10,137,3044,278,764,123,338,155,426,165,210,56,261,317,147,50,11,131,247,876
3677,Chris Wilson,2012,2015,Saint Joseph's,A-10,130,3815,294,775,172,387,122,388,166,260,72,375,447,377,100,15,219,173,876
3678,Trae Young,2018,2018,Oklahoma,Big 12,32,1133,261,618,143,290,118,328,236,274,14,111,125,279,54,8,167,57,876
3679,Patrick Behan,2008,2010,Bucknell,Patriot,90,2067,350,758,338,709,12,49,163,247,122,305,427,50,25,14,171,204,875
3680,Christopher Galbreath Jr.,2017,2018,Sam Houston State,Southland,70,1651,358,751,339,688,19,63,140,207,173,329,502,62,42,45,136,201,875
3681,Seth Gearhart,2012,2015,Rice,CUSA,108,2698,267,653,129,273,138,380,203,255,70,290,360,142,77,39,135,270,875
3682,DeQuan Hicks,2013,2014,Northwestern State,Southland,60,1343,327,628,325,613,2,15,219,318,150,246,396,132,89,37,169,150,875
3683,Cedric Jackson,2008,2009,Cleveland State,Horizon,71,2289,283,698,204,472,79,226,230,349,69,310,379,367,200,17,263,199,875
3684,Logan McLane,2015,2018,Miami (OH),MAC,120,2362,350,692,313,559,37,133,138,227,144,371,515,97,90,57,155,226,875
3685,Stefan Nastic,2011,2015,Stanford,Total,126,2182,307,645,305,637,2,8,259,365,154,276,430,107,23,81,162,310,875
3686,Kelly Beidler,2008,2010,Mount St. Mary's,NEC,90,2464,318,739,234,493,84,246,154,226,130,437,567,146,112,86,170,218,874
3687,Dee Davis,2012,2015,Xavier,Total,133,3417,284,722,163,372,121,350,185,249,31,184,215,493,133,2,249,309,874
3688,Kashief Edwards,2009,2012,Total,Total,125,2431,332,689,331,680,1,9,209,346,177,234,411,50,63,122,174,270,874
3689,Drew Hanlen,2009,2012,Belmont,A-Sun,134,2957,257,640,68,175,189,465,171,220,41,243,284,423,102,0,190,135,874
3690,Terry Rozier,2014,2015,Louisville,Total,73,1959,307,753,223,499,84,254,176,228,71,243,314,175,110,8,101,116,874
3691,Adam Waddell,2008,2012,Wyoming,MWC,124,2743,307,606,306,601,1,5,259,439,153,325,478,58,58,93,134,317,874
3692,Justin Anderson,2013,2015,Virginia,ACC,98,2364,288,669,191,397,97,272,200,266,75,266,341,180,60,84,125,137,873
3693,Zach Cooks,2018,2019,NJIT,A-Sun,65,1967,303,670,189,366,114,304,153,209,33,201,234,137,136,7,126,102,873
3694,Xavier Hill-Mais,2016,2019,Oakland,Horizon,99,1786,338,636,303,530,35,106,162,234,114,285,399,109,45,66,162,212,873
3695,A.J. Pacher,2011,2014,Wright State,Horizon,133,2127,317,650,261,468,56,182,183,261,134,291,425,78,33,26,172,349,873
3696,Jordan Williams,2010,2011,Maryland,ACC,66,1890,339,642,339,642,0,0,195,349,215,457,672,28,47,77,84,170,873
3697,Derrick Barden,2013,2014,Northern Colorado,Big Sky,63,1973,343,613,310,534,33,79,153,230,187,336,523,69,79,30,83,94,872
3698,DeAngelo Casto,2009,2011,Washington State,Pac-10,97,2356,332,614,332,611,0,3,208,342,198,374,572,64,73,165,175,232,872
3699,Brandon Gilbeck,2016,2019,Western Illinois,Summit,114,2596,366,629,366,628,0,1,140,267,231,506,737,80,52,285,209,377,872
3700,Justin Gordon,2013,2016,Wofford,Southern,132,2421,344,690,336,665,8,25,176,319,191,231,422,146,62,44,195,325,872
3701,Evan Hall,2016,2019,IUPUI,Total,113,2392,381,745,380,743,1,2,109,322,258,344,602,99,69,93,171,307,872
3702,Kerem Kanter,2015,2018,Total,Total,113,1513,338,636,300,513,38,123,158,227,136,297,433,45,22,32,86,159,872
3703,Paris Roberts-Campbell,2012,2015,East Carolina,Total,122,3073,275,734,115,254,160,480,162,222,50,254,304,212,146,46,128,238,872
3704,Isaiah Still,2016,2019,Total,Total,73,2210,266,714,166,387,100,327,240,373,57,238,295,120,58,19,145,160,872
3705,Jake White,2012,2016,Total,Total,110,1790,314,622,282,517,32,105,212,281,170,294,464,32,24,15,99,215,872
3706,Darrell Bowie,2013,2017,Total,Total,115,2532,302,709,285,647,17,62,250,465,199,364,563,91,109,53,248,244,871
3707,Mustafa Jones,2015,2018,Central Connecticut State,NEC,116,2540,381,793,377,773,4,20,105,151,134,296,430,93,55,99,134,196,871
3708,Zach McCabe,2011,2014,Iowa,Big Ten,137,2472,298,736,193,424,105,312,170,223,175,334,509,149,98,16,174,371,871
3709,Vince Oliver,2008,2009,UC-Davis,Big West,63,2080,314,681,237,449,77,232,166,212,46,147,193,148,52,3,142,113,871
3710,Malcolm Riley ,2015,2016,Texas Southern,SWAC,68,2074,292,621,190,353,102,268,185,242,121,291,412,48,50,9,78,136,871
3711,Dante Scott,2016,2019,Total,Total,71,1960,307,777,224,539,83,238,174,234,92,241,333,113,38,16,126,138,871
3712,Sharaud Curry,2008,2010,Providence,Big East,65,2046,272,665,154,344,118,321,208,242,33,93,126,247,71,1,134,115,870
3713,Donte DiVincenzo,2016,2018,Villanova,Big East,85,2163,303,646,173,302,130,344,134,190,93,250,343,204,79,18,137,151,870
3714,Cameron Golden,2013,2015,Arkansas State,Sun Belt,92,2406,288,809,140,334,148,475,146,215,51,204,255,224,116,11,175,165,870
3715,Wesley Gordon,2014,2017,Colorado,Pac-12,131,3406,309,638,293,592,16,46,236,357,336,546,882,176,54,204,169,287,870
3716,Chris Jenkins,2015,2017,Detroit Mercy,Horizon,81,2320,281,632,182,386,99,246,209,270,93,373,466,104,65,27,129,199,870
3717,Norville Carey,2013,2017,Total,Total,123,2076,340,668,334,645,6,23,183,288,185,313,498,51,90,68,161,202,869
3718,Toarlyn Fitzpatrick,2010,2013,South Florida,Big East,132,3156,316,778,205,462,111,316,126,191,201,471,672,89,83,112,178,299,869
3719,Issiah Grayson,2010,2014,Total,Total,76,2071,276,596,168,348,108,248,209,262,32,130,162,307,109,5,212,154,869
3720,Kerry Hammonds,2011,2014,Middle Tennessee,Total,124,2699,273,644,133,269,140,375,183,245,63,296,359,206,82,53,153,197,869
3721,Aundre Jackson,2017,2018,Loyola (IL),MVC,70,1484,348,561,314,475,34,86,139,195,74,182,256,67,34,21,113,171,869
3722,Jake Kretzer,2013,2016,Akron,MAC,129,3034,278,694,65,123,213,571,100,121,138,324,462,145,94,11,96,246,869
3723,Andrew Brown,2008,2009,Lafayette,Patriot,59,1774,274,720,109,247,165,473,155,183,26,94,120,176,59,1,172,136,868
3724,Griffan Callahan,2009,2012,South Dakota State,Summit,117,2758,270,647,105,224,165,423,163,209,159,301,460,101,120,24,113,310,868
3725,Jacob Gilyard,2018,2019,Richmond,A-10,63,2321,303,654,171,299,132,355,130,163,35,124,159,290,177,2,128,108,868
3726,Eric Griffin,2011,2012,Campbell,Total,60,1753,313,560,281,469,32,91,210,357,146,322,468,74,78,134,163,199,868
3727,Nick Griffin,2014,2018,Total,Total,134,2302,303,754,117,278,186,476,76,97,34,170,204,69,38,16,87,120,868
3728,Tyrell Johnson,2016,2019,Appalachian State,Sun Belt,124,2465,321,730,262,528,59,202,167,257,147,352,499,59,43,120,143,312,868
3729,Jason Love,2008,2010,Xavier,A-10,107,2398,308,559,308,559,0,0,252,360,291,422,713,64,38,121,141,266,868
3730,Marcus Shaver,2018,2019,Portland,WCC,64,1919,286,700,201,431,85,269,211,259,24,188,212,144,72,14,119,160,868
3731,Amar Stukes,2015,2018,La Salle,A-10,126,3766,303,716,251,556,52,160,210,275,70,210,280,370,144,8,184,309,868
3732,Willie Warren,2009,2010,Oklahoma,Big 12,57,1806,278,606,181,329,97,277,215,273,32,117,149,199,62,3,160,129,868
3733,Matt McQuaid,2016,2019,Michigan State,Big Ten,139,3077,286,712,95,227,191,485,104,131,79,188,267,215,59,19,113,258,867
3734,Brandon Penn,2009,2012,Rider,MAAC,128,2295,296,721,149,341,147,380,128,166,97,387,484,97,77,51,147,212,867
3735,Jordan Barham,2013,2016,Davidson,Total,120,1643,340,590,329,559,11,31,175,289,134,300,434,67,33,20,75,189,866
3736,Michael Beasley,2008,2008,Kansas State,Big 12,33,1041,307,577,271,482,36,95,216,279,131,277,408,38,42,54,95,85,866
3737,Gavin Block,2016,2019,Ohio,MAC,127,3148,276,711,131,288,145,423,169,251,61,336,397,290,92,22,168,241,866
3738,Braxton Bonds,2017,2019,Houston Baptist,Southland,92,2883,339,789,323,699,16,90,172,281,149,312,461,368,184,13,187,193,866
3739,Mike Coburn,2008,2011,Rutgers,Big East,127,3177,301,740,245,573,56,167,208,310,54,196,250,367,109,15,258,234,866
3740,Matthew McCarthy,2016,2019,San Francisco,WCC,131,2537,365,695,350,618,15,77,121,214,237,465,702,110,63,50,176,323,866
3741,M.J. Rhett,2012,2015,Total,Total,128,2968,339,637,339,636,0,1,188,274,252,511,763,71,62,93,196,310,866
3742,Christophe Varidel,2011,2013,Florida Gulf Coast,A-Sun,99,2193,262,679,84,217,178,462,164,193,47,173,220,101,72,8,163,149,866
3743,Andre Wolford,2016,2019,Saint Francis (PA),NEC,101,1989,279,623,91,182,188,441,120,145,42,163,205,46,47,16,66,130,866
3744,Kyle Anderson,2013,2014,UCLA,Pac-12,71,2242,303,670,267,574,36,96,223,303,119,498,617,355,126,58,183,132,865
3745,Marcus Johnson Jr.,2016,2017,Little Rock,Sun Belt,67,2175,277,655,148,325,129,330,182,226,35,176,211,145,56,0,113,86,865
3746,Shaquille Johnson,2013,2016,Total,Total,86,2352,318,741,258,501,60,240,169,246,123,312,435,230,98,33,245,210,865
3747,Dennis Kramer,2011,2014,San Diego,WCC,127,2409,344,693,283,507,61,186,116,174,144,367,511,61,37,99,156,313,865
3748,Rafael Maia,2013,2016,Total,Total,113,2661,313,622,302,585,11,37,228,425,319,447,766,131,83,42,184,298,865
3749,Joe O'Shea,2011,2015,Total,Total,102,2846,273,602,179,328,94,274,225,294,129,298,427,161,85,31,109,308,865
3750,Jarred Shaw,2010,2014,Total,Total,102,1897,352,693,351,683,1,10,160,220,132,397,529,54,20,70,134,230,865
3751,Speedy Smith,2012,2015,Louisiana Tech,Total,140,4109,279,718,165,398,114,320,193,280,111,426,537,858,258,14,340,293,865
3752,Davauhnte Turner,2018,2019,Saint Peter's,MAAC,63,1994,305,726,195,411,110,315,145,185,60,142,202,138,62,18,133,121,865
3753,Aaron Hawley,2010,2014,Drake,MVC,128,2436,308,758,154,375,154,383,94,137,82,258,340,66,59,11,117,189,864
3754,D.J. Johnson,2013,2017,Kansas State,Big 12,129,2271,327,551,327,550,0,1,210,323,252,298,550,30,67,110,139,308,864
3755,Terrence Williams,2008,2009,Louisville,Big East,73,2559,315,747,209,455,106,292,128,222,103,474,577,347,134,56,191,132,864
3756,Lenny Daniel,2010,2011,Cal State Northridge,Big West,61,1673,308,583,308,583,0,0,247,424,203,325,528,36,30,82,138,175,863
3757,Nathan Dieudonne,2013,2016,Boston University,Total,120,2888,312,651,269,496,43,155,196,299,203,490,693,136,62,35,199,314,863
3758,Karachi Edo,2014,2017,Fresno State,MWC,120,2470,327,615,322,595,5,20,204,334,252,306,558,41,34,148,77,247,863
3759,Mark Hughes,2016,2019,Wright State,Horizon,129,3279,280,688,130,240,150,448,153,203,52,337,389,286,117,32,163,272,863
3760,Sam Muldrow,2008,2011,South Carolina,SEC,110,2583,341,768,304,636,37,132,144,217,231,385,616,35,63,275,123,263,863
3761,James White,2012,2016,Total,Total,113,2188,357,706,354,691,3,15,146,240,202,343,545,78,39,109,157,278,863
3762,Roquez Johnson,2012,2015,Mississippi State,SEC,106,2386,289,609,284,585,5,24,279,448,192,262,454,46,68,28,189,227,862
3763,Perry Jones,2011,2012,Baylor,Big 12,63,2030,344,659,332,616,12,43,162,239,168,299,467,78,44,47,125,148,862
3764,Dejan Vasiljevic,2017,2019,Miami (FL),ACC,97,2331,294,725,95,195,199,530,75,85,53,215,268,66,46,4,56,130,862
3765,Alan Voskuil,2008,2009,Texas Tech,Big 12,64,2226,267,585,109,242,158,343,170,198,36,219,255,112,83,1,96,131,862
3766,Briante Weber,2012,2015,Virginia Commonwealth,Total,127,2965,296,695,256,549,40,146,230,299,103,320,423,378,374,26,186,280,862
3767,Avery Woodson,2015,2017,Total,Total,98,2474,289,703,76,184,213,519,71,94,26,219,245,105,68,26,67,235,862
3768,Glen Rice,2010,2012,Georgia Tech,ACC,87,2156,316,727,216,438,100,289,129,211,143,278,421,185,111,47,162,194,861
3769,Ross Rivera,2012,2014,Pacific,Total,97,1910,279,608,230,476,49,132,254,310,85,198,283,46,41,18,99,227,861
3770,Ridge Shipley,2014,2017,Cal Poly,Big West,121,2840,280,756,133,314,147,442,154,219,36,162,198,287,76,3,152,197,861
3771,D'Andre Wright,2013,2016,Tulsa,Total,124,2282,303,663,284,591,19,72,236,340,199,313,512,62,24,64,164,390,861
3772,R.J. Barrett,2019,2019,Duke,ACC,38,1341,319,702,246,465,73,237,149,224,59,229,288,164,34,16,123,70,860
3773,Jordan Burns,2018,2019,Colgate,Patriot,61,1834,302,694,182,381,120,313,136,171,27,146,173,264,61,6,173,94,860
3774,Kenny Carpenter,2015,2018,Cleveland State,Horizon,119,2478,337,793,246,503,91,290,95,138,66,282,348,168,69,27,116,175,860
3775,Kevin McKay,2017,2019,Central Michigan,MAC,97,2141,320,593,296,520,24,73,196,255,219,304,523,111,125,51,132,194,860
3776,Ivan Rabb,2016,2017,University of California,Pac-12,65,1987,312,574,303,552,9,22,227,341,188,426,614,79,39,73,119,201,860
3777,Calvin Thompson,2009,2013,Howard,MEAC,82,2231,272,775,221,592,51,183,265,370,95,240,335,146,69,8,201,157,860
3778,Devon Baker,2010,2011,Northwestern State,Southland,58,1568,246,616,139,332,107,284,260,344,49,92,141,108,74,1,134,122,859
3779,John Collins,2016,2017,Wake Forest,ACC,64,1324,315,524,315,523,0,1,229,314,176,270,446,24,30,75,91,180,859
3780,Tyrone Garland,2011,2014,Total,Total,96,1861,295,782,225,511,70,271,199,271,30,110,140,159,61,7,118,132,859
3781,Eric May,2010,2013,Iowa,Big Ten,133,3053,318,768,222,480,96,288,127,191,136,317,453,183,127,50,173,226,859
3782,Dennis Ogbe,2011,2014,Tennessee Tech,OVC,123,2116,326,534,286,409,40,125,167,234,204,248,452,60,49,66,129,300,859
3783,B.J. Raymond,2008,2009,Xavier,A-10,72,1915,293,646,127,242,166,404,107,132,51,206,257,82,36,28,86,142,859
3784,Troy Tabler,2008,2011,Wright State,Horizon,113,2492,265,690,100,232,165,458,164,191,40,194,234,133,74,11,146,179,859
3785,Hollis Thompson,2010,2012,Georgetown,Big East,99,2434,308,645,180,354,128,291,115,170,106,298,404,105,78,43,107,223,859
3786,Pooh Williams,2008,2011,Utah State,WAC,131,2992,305,724,188,404,117,320,132,194,47,158,205,242,52,20,140,224,859
3787,Georgi Boyanov,2014,2017,South Alabama,Sun Belt,115,2226,300,585,250,442,50,143,208,323,212,386,598,60,73,33,130,221,858
3788,Kyndall Dykes,2008,2009,New Orleans,Sun Belt,56,1853,330,670,324,636,6,34,192,288,80,211,291,83,67,11,108,106,858
3789,Marcus Harris,2015,2019,Total,Total,123,2706,271,727,151,333,120,394,196,263,35,206,241,139,84,9,125,240,858
3790,Michale Kyser,2012,2015,Louisiana Tech,Total,139,2963,350,644,350,643,0,1,158,283,283,458,741,56,76,363,92,329,858
3791,Sam McDaniel,2017,2018,Louisiana-Monroe,Sun Belt,65,2030,295,725,184,416,111,309,157,205,85,305,390,114,53,15,135,164,858
3792,Jovan Mooring,2017,2018,Nevada-Las Vegas,MWC,65,2032,251,672,130,314,121,358,235,297,15,170,185,238,74,5,143,150,858
3793,Jordan Parks,2014,2015,North Carolina Central,MEAC,67,1687,349,529,336,501,13,28,147,224,169,293,462,43,61,69,97,208,858
3794,LaQuinton Ross,2012,2014,Ohio State,Big Ten,81,1676,299,662,220,445,79,217,181,242,96,224,320,47,38,31,124,106,858
3795,Geno Thorpe,2014,2018,Total,Total,100,2216,276,678,210,485,66,193,240,295,62,165,227,195,104,6,164,227,858
3796,Tyrece Gibbs,2008,2009,New Hampshire,AEC,59,2055,293,732,123,307,170,425,101,147,64,202,266,161,49,43,158,135,857
3797,Stefon Johnson,2010,2014,Total,Total,123,2968,360,754,347,711,13,43,124,211,232,414,646,105,95,61,166,316,857
3798,Brandon Long,2008,2010,Texas-Arlington,Southland,67,2063,289,753,156,339,133,414,146,193,42,191,233,84,71,2,96,147,857
3799,Joseph Lopez,2015,2018,Total,Total,89,1960,362,686,360,658,2,28,131,246,229,380,609,58,50,55,139,192,857
3800,Xavier Moon,2016,2017,Morehead State,OVC,67,1948,299,662,181,375,118,287,141,170,29,172,201,207,70,13,95,145,857
3801,Venoy Overton,2008,2011,Washington,Pac-10,135,2879,266,645,219,466,47,179,278,383,83,239,322,390,177,21,267,351,857
3802,Roddy Peters,2014,2018,Total,Total,74,1608,316,658,302,597,14,61,211,290,45,217,262,237,73,9,216,138,857
3803,Nigel Ribeiro,2016,2019,Grambling,SWAC,114,2725,319,803,229,504,90,299,129,203,36,286,322,222,132,11,186,227,857
3804,Evan Singletary,2015,2016,Albany (NY),AEC,66,2251,277,675,166,378,111,297,192,247,30,207,237,191,66,13,139,147,857
3805,Quinton Stephens,2014,2017,Georgia Tech,ACC,135,2931,303,827,165,385,138,442,113,158,144,428,572,157,78,63,145,215,857
3806,Anthony Thompson,2014,2017,Holy Cross,Patriot,119,3561,236,730,96,279,140,451,245,332,60,243,303,278,150,2,137,249,857
3807,Mike Thorne,2012,2017,Total,Total,113,2199,355,685,355,683,0,2,147,276,229,383,612,47,19,67,133,232,857
3808,Brandon Barnes,2011,2014,Total,Total,92,2273,311,705,257,537,54,168,180,291,149,255,404,105,77,16,173,243,856
3809,Tony Gallo,2011,2012,Coppin State,MEAC,60,1863,249,650,118,273,131,377,227,298,16,133,149,191,78,2,142,122,856
3810,Jerai Grant,2008,2011,Clemson,ACC,127,2269,326,555,326,555,0,0,204,321,259,282,541,72,82,197,129,282,856
3811,Zach Green,2015,2018,Montana State,Big Sky,125,2537,300,685,260,528,40,157,216,315,192,338,530,140,65,24,134,312,856
3812,Yunus Hopkinson,2014,2017,St. Francis (NY),NEC,109,2290,264,852,110,340,154,512,174,222,34,159,193,196,75,1,178,174,856
3813,Stefan Jankovic,2013,2016,Total,Total,85,1531,283,558,220,383,63,175,227,301,120,259,379,67,41,80,109,228,856
3814,Sheldon Jeter,2013,2017,Total,Total,130,2586,320,674,252,484,68,190,148,207,191,392,583,105,78,84,119,284,856
3815,Kris Martin,2016,2019,Total,Total,85,2290,287,704,141,305,146,399,136,198,30,249,279,165,70,38,148,154,856
3816,Cody Wichmann,2014,2017,Milwaukee,Horizon,126,2516,288,680,90,174,198,506,82,107,56,229,285,121,62,13,68,200,856
3817,Paris Austin,2016,2019,Total,Total,91,2282,292,643,270,555,22,88,249,343,26,217,243,250,71,7,167,152,855
3818,Greg Brown,2013,2016,Saint Francis (PA),NEC,120,3221,312,766,237,532,75,234,156,222,42,276,318,292,95,26,187,261,855
3819,Rasheem Dunn,2017,2018,St. Francis (NY),NEC,60,1825,286,736,220,477,66,259,217,298,65,260,325,119,85,4,114,123,855
3820,Kameron Edwards,2016,2019,Pepperdine,WCC,75,2018,314,708,279,599,35,109,192,288,129,279,408,85,61,27,136,183,855
3821,Taj Gibson,2008,2009,Southern California,Pac-10,68,2237,328,554,328,554,0,0,199,315,203,372,575,87,57,184,153,218,855
3822,Jerry Johnson Jr.,2016,2019,Total,Total,88,2139,286,722,126,268,160,454,123,166,39,239,278,152,69,4,120,156,855
3823,Mike Schachtner,2008,2009,Green Bay,Horizon,63,1715,281,595,212,439,69,156,224,250,103,172,275,48,22,10,83,132,855
3824,Karviar Shepherd,2014,2017,Texas Christian,Big 12,131,2743,313,718,306,696,7,22,222,326,199,436,635,96,62,103,166,360,855
3825,Chris Smith,2015,2016,Utah State,MWC,62,1956,289,593,163,320,126,273,151,200,55,227,282,143,46,18,96,132,855
3826,Quinton Adlesh,2016,2019,Columbia,Ivy,86,2237,316,722,136,278,180,444,42,62,21,207,228,198,110,2,129,147,854
3827,Jeremiah Dominguez,2008,2009,Portland State,Big Sky,63,1968,283,640,110,242,173,398,115,149,35,120,155,229,115,4,145,97,854
3828,Weyinmi Efejuku,2008,2009,Providence,Big East,62,1702,273,613,198,418,75,195,233,308,70,170,240,146,77,14,152,102,854
3829,Terence Grier,2009,2011,Fairleigh Dickinson,NEC,84,2457,335,757,294,613,41,144,143,291,90,167,257,128,95,7,168,184,854
3830,Lawrence Kinnard,2008,2009,Alabama-Birmingham,CUSA,68,2115,314,729,220,447,94,282,132,203,142,402,544,82,61,49,100,152,854
3831,Steve Taylor,2013,2017,Total,Total,123,2303,355,715,332,609,23,106,121,236,195,505,700,154,47,23,175,151,854
3832,Lorrenzo Wade,2008,2009,San Diego State,MWC,59,1871,305,674,260,535,45,139,199,283,49,220,269,190,63,33,165,139,854
3833,Jonathan Holton,2012,2016,Total,Total,97,2354,326,710,286,515,40,195,161,241,326,367,693,117,98,73,160,306,853
3834,Anthony Townes,2016,2019,Pacific,WCC,111,2328,352,672,352,672,0,0,149,221,222,341,563,34,77,61,129,304,853
3835,DaShaun Wiggins,2014,2015,Portland State,Big Sky,60,1532,245,587,155,358,90,229,273,365,36,161,197,90,75,3,100,151,853
3836,Lindell Wigginton,2018,2019,Iowa State,Big 12,56,1671,268,648,153,358,115,290,202,294,38,179,217,141,47,22,141,127,853
3837,Booker Woodfox,2008,2009,Creighton,MVC,67,1421,283,614,136,291,147,323,140,170,41,117,158,79,35,1,64,75,853
3838,Kodi Augustus,2008,2011,Mississippi State,SEC,101,2120,269,618,193,391,76,227,238,298,148,359,507,87,40,71,191,222,852
3839,Paris Bass,2015,2016,Detroit Mercy,Horizon,57,1545,311,675,266,543,45,132,185,279,105,273,378,112,72,68,165,173,852
3840,Chane Behanan,2012,2014,Louisville,Total,91,2280,333,641,326,593,7,48,179,324,268,359,627,86,97,37,150,166,852
3841,Jared Berggren,2010,2013,Wisconsin,Big Ten,119,2276,321,688,247,461,74,227,136,194,151,306,457,70,53,144,105,186,852
3842,Vincent Goldsberry,2008,2011,Coppin State,MEAC,126,3113,296,733,277,636,19,97,241,305,100,189,289,285,163,9,209,148,852
3843,Riley Grabau,2012,2015,Wyoming,MWC,120,3457,232,605,61,140,171,465,217,246,17,179,196,239,35,4,143,220,852
3844,Jeronne Maymon,2010,2014,Total,Total,93,2248,306,568,306,560,0,8,240,374,256,388,644,86,62,26,170,235,852
3845,Josh Schuler,2011,2014,North Dakota,Total,115,2904,273,712,147,347,126,365,180,229,24,158,182,179,73,9,93,143,852
3846,Alex Thompson,2014,2018,Total,Total,110,2090,300,709,176,352,124,357,128,173,66,275,341,59,39,33,87,198,852
3847,Jonathan Wade,2016,2017,Norfolk State,MEAC,67,1719,280,606,200,391,80,215,212,276,86,233,319,82,35,5,139,128,852
3848,Corey Allen,2017,2018,Detroit Mercy,Horizon,59,1756,288,661,150,330,138,331,137,191,39,144,183,119,50,4,123,125,851
3849,Devin Cherry,2012,2015,Cornell,Ivy,106,2512,295,745,228,515,67,230,194,278,48,271,319,240,63,8,252,189,851
3850,Gorgui Dieng,2011,2013,Louisville,Big East,102,2789,338,620,337,617,1,3,174,272,304,497,801,127,104,267,166,280,851
3851,Joey McLean,2015,2018,James Madison,CAA,114,2779,287,711,156,337,131,374,146,185,38,174,212,240,114,10,167,286,851
3852,Eric Robertson,2013,2016,Chattanooga,Southern,132,2560,283,686,92,219,191,467,94,136,79,137,216,153,76,36,104,226,851
3853,Jabril Trawick,2012,2015,Georgetown,Big East,126,2884,270,579,196,358,74,221,237,334,84,256,340,205,100,37,176,306,851
3854,Cam Ward,2015,2018,Vermont,AEC,141,2621,276,659,138,283,138,376,161,247,26,216,242,266,62,6,130,189,851
3855,Quayson Williams,2016,2019,Citadel,Southern,115,1906,279,749,103,233,176,516,117,151,69,207,276,162,116,6,146,223,851
3856,Adam Woodbury,2013,2016,Iowa,Big Ten,138,2718,332,651,332,651,0,0,187,295,294,466,760,108,68,71,173,355,851
3857,Chase Foster,2015,2018,San Francisco,WCC,108,2243,289,692,153,324,136,368,136,181,69,254,323,125,50,16,117,182,850
3858,Jameel Grace,2010,2013,Southern,SWAC,116,3079,272,761,187,470,85,291,221,344,25,295,320,435,157,5,298,185,850
3859,Kelsey Howard,2012,2013,Jackson State,SWAC,59,1836,290,709,189,422,101,287,169,234,78,161,239,46,53,9,121,138,850
3860,David Kyles,2009,2012,Wichita State,MVC,128,2471,298,716,145,295,153,421,101,138,61,279,340,179,96,36,126,118,850
3861,David Perez,2009,2012,Total,Total,117,1610,271,714,118,274,153,440,155,186,26,102,173,95,74,1,119,120,850
3862,Courtney Stockard,2018,2019,St. Bonaventure,A-10,60,1948,296,672,236,479,60,193,198,260,51,300,351,171,78,24,171,184,850
3863,Brian Williams,2012,2015,Total,Total,107,2523,310,664,270,523,40,141,190,267,109,239,348,95,91,39,108,171,850
3864,Ayodeji Egbeyemi,2011,2015,Loyola Marymount,WCC,117,2932,305,764,215,479,90,285,149,223,120,328,448,143,85,35,148,191,849
3865,Nate Engesser,2013,2016,Denver,Total,110,2014,302,590,155,246,147,344,98,117,28,150,178,145,47,8,87,133,849
3866,Dexter Fields,2010,2014,Total,Total,125,2836,290,722,78,157,212,565,57,85,82,192,274,123,92,17,101,199,849
3867,Marvin King-Davis,2013,2016,Delaware,CAA,104,2152,309,661,309,659,0,2,231,330,191,350,541,52,19,63,92,231,849
3868,Walter Offutt,2009,2013,Total,Total,94,2255,276,633,174,342,102,291,195,266,84,207,291,141,106,11,123,195,849
3869,Nkem Ojougboh,2008,2010,Northeastern,CAA,96,2916,311,618,307,606,4,12,223,326,214,368,582,107,58,133,167,258,849
3870,Emmanuel Omogbo,2016,2017,Colorado State,MWC,69,1903,301,639,259,500,42,139,205,307,203,434,637,95,52,31,110,174,849
3871,Kruize Pinkins,2014,2015,San Francisco,WCC,65,1662,298,595,265,501,33,94,220,350,176,215,391,78,40,38,107,207,849
3872,Zac Swansey,2008,2012,Total,Total,131,3422,329,818,228,519,101,299,90,144,37,255,292,545,201,7,339,151,849
3873,Sidney Umude,2015,2019,Total,Total,103,1970,329,706,327,688,2,18,189,300,144,246,390,58,55,48,138,225,849
3874,Nura Zanna,2015,2018,Total,Total,128,2690,326,600,326,598,0,2,197,390,310,472,782,46,67,37,240,435,849
3875,Pat Birt,2014,2017,Total,Total,93,2371,271,758,117,316,154,442,152,199,43,197,240,98,66,15,98,207,848
3876,Montae Glenn,2016,2019,Georgia Southern,Sun Belt,118,2449,349,595,348,593,1,2,149,230,354,366,720,38,52,100,135,284,848
3877,Francis Kiapway,2015,2018,Ball State,MAC,122,2946,265,720,58,160,207,560,111,148,21,162,183,136,51,9,124,186,848
3878,King McClure,2016,2019,Baylor,Big 12,129,2524,294,711,149,308,145,403,115,158,69,247,316,168,108,17,146,235,848
3879,Zamal Nixon,2008,2011,Houston,CUSA,122,2398,275,664,193,412,82,252,216,281,39,135,174,283,129,17,181,216,848
3880,Antoine Pearson,2008,2010,Manhattan,MAAC,92,2364,261,631,176,407,85,224,241,365,24,141,165,206,104,13,187,196,848
3881,Vertrail Vaughns,2010,2014,Total,Total,138,2300,280,693,162,378,118,315,170,220,61,119,180,97,74,2,106,239,848
3882,Marcus Ware,2010,2014,Total,Total,118,2331,293,698,293,695,0,3,262,422,200,328,528,70,81,25,186,358,848
3883,James Webb,2015,2016,Boise State,MWC,63,1830,314,606,240,382,74,224,146,216,137,403,540,53,80,40,80,175,848
3884,Mike Aaman,2013,2017,Total,Total,107,2037,329,695,329,694,0,1,189,295,270,340,610,44,51,74,130,260,847
3885,Marcus Allen,2014,2017,Stanford,Pac-12,126,2716,309,709,264,522,45,187,184,289,107,234,341,171,121,9,143,244,847
3886,Brayon Blake,2017,2018,Idaho,Big Sky,63,1580,320,680,246,499,74,181,133,196,123,369,492,61,37,22,98,174,847
3887,Isaac Butts,2008,2012,Appalachian State,Southern,116,2508,365,605,365,605,0,0,117,197,295,510,805,95,38,96,203,328,847
3888,Jordan Cohen,2017,2019,Lehigh,Patriot,89,2336,291,586,198,357,93,229,172,195,67,216,283,242,88,24,137,174,847
3889,Calvin Crawford,2015,2018,Manhattan,MAAC,114,2356,316,723,231,470,85,253,130,172,113,302,415,88,68,71,170,224,847
3890,DJ Hogg,2016,2018,Texas A&M,SEC,91,2314,297,746,142,315,155,431,98,149,94,293,387,194,68,53,135,157,847
3891,Mike James,2011,2012,Lamar,Southland,56,1437,313,709,239,491,74,218,147,183,45,114,159,107,76,7,106,107,847
3892,Jahlil Jenkins,2018,2019,Fairleigh Dickinson,NEC,66,2340,295,683,218,443,77,240,180,227,17,173,190,293,95,4,147,99,847
3893,Joshua Langford,2017,2019,Michigan State,Big Ten,83,2053,316,701,206,431,110,270,105,130,62,171,233,122,38,7,121,184,847
3894,Ricardo Ratliffe,2011,2012,Missouri,Big 12,69,1749,366,576,362,561,4,15,111,166,199,266,465,60,29,80,90,200,847
3895,Patrick Rembert,2008,2011,UC-Irvine,Big West,119,3007,258,680,172,438,86,242,245,321,34,240,274,300,71,7,177,222,847
3896,Terrence Ross,2011,2012,Washington,Total,69,1681,317,700,201,381,116,319,97,127,77,244,321,82,63,45,94,168,847
3897,Brandon Sherrod,2012,2016,Yale,Ivy,114,2304,294,584,294,582,0,2,259,437,203,312,515,93,45,82,125,239,847
3898,Maurice Bolden,2010,2012,Southern Mississippi,CUSA,100,2150,290,698,226,513,64,185,202,279,190,325,515,68,43,74,149,220,846
3899,Tony Easley,2008,2010,Murray State,OVC,97,2057,340,521,340,521,0,0,166,249,242,290,532,64,56,141,120,229,846
3900,Joe Jakubowski,2008,2011,Bowling Green State,MAC,126,3418,281,690,151,353,130,337,154,213,27,258,285,381,124,1,241,214,846
3901,Eric McClellan,2012,2016,Total,Total,96,2177,278,622,216,431,62,191,228,321,48,212,260,190,69,17,200,164,846
3902,Craig Moore,2008,2009,Northwestern,Big Ten,61,2167,280,648,73,135,207,513,79,98,34,152,186,177,96,15,113,143,846
3903,Jeremy Smith,2010,2014,Nicholls State,Southland,99,2181,327,604,297,516,30,88,162,235,111,181,292,112,46,16,171,227,846
3904,Robert Smith,2010,2013,Total,Total,96,2914,288,818,183,471,105,347,165,244,46,275,321,293,95,2,274,200,846
3905,Roger Woods,2013,2016,Total,Total,96,2195,298,588,274,523,24,65,226,366,140,328,468,118,67,32,149,208,846
3906,Joey Accaoui,2008,2011,Vermont,AEC,126,2426,303,722,171,355,132,367,107,134,31,132,163,169,51,0,137,137,845
3907,Wes Cole,2012,2015,Hartford,AEC,121,2300,284,789,65,177,219,612,58,77,50,118,168,85,66,3,108,137,845
3908,Josh Cuthbertson,2014,2017,South Carolina Upstate,A-Sun,108,2612,310,717,190,346,120,371,105,153,128,285,413,258,60,8,151,173,845
3909,Everson Davis,2016,2019,Binghamton,AEC,126,2853,287,744,243,586,44,158,227,319,93,312,405,214,90,17,189,231,845
3910,Jarrey Foster,2016,2019,Southern Methodist,AAC,99,2514,318,684,242,469,76,215,133,214,200,247,447,188,52,70,122,201,845
3911,Jarkell Joiner,2018,2019,Cal State Bakersfield,WAC,64,1936,314,741,232,494,82,247,135,169,68,156,224,71,52,4,71,124,845
3912,Lucas Kuipers,2009,2012,Rice,CUSA,113,2509,309,737,177,362,132,375,95,123,136,251,387,86,45,41,129,282,845
3913,Zach Peacock,2008,2010,Georgia Tech,ACC,92,2087,321,673,284,567,37,106,166,214,152,241,393,89,92,43,152,223,845
3914,Theo Robertson,2009,2010,University of California,Pac-10,62,2089,293,595,189,374,104,221,155,195,58,207,265,148,42,6,130,141,845
3915,Ishmael Smith,2008,2010,Wake Forest,ACC,90,2740,356,840,313,686,43,154,90,182,57,274,331,426,117,22,238,147,845
3916,Carrio Bennett,2008,2011,South Carolina State,MEAC,119,2978,264,776,145,374,119,402,197,270,82,236,318,269,84,7,260,177,844
3917,C.J. Cooper,2012,2015,Texas-El Paso,CUSA,126,3008,254,692,96,232,158,460,178,221,20,158,178,275,61,1,157,147,844
3918,Chris Devine,2008,2009,UC-Santa Barbara,Big West,61,1786,297,581,282,526,15,55,235,303,128,233,361,85,72,22,156,153,844
3919,Tony Fiegen,2010,2013,South Dakota State,Summit,128,2691,341,673,340,672,1,1,161,237,188,274,462,106,47,30,119,261,844
3920,Justin Gray,2015,2018,Texas Tech,Big 12,115,2728,305,603,271,493,34,110,200,263,158,310,468,126,96,75,121,260,844
3921,Nimrod Hilliard,2012,2015,Total,Total,79,2396,287,642,208,430,79,212,191,238,32,197,229,377,83,25,189,151,844
3922,Derek Selvig,2009,2012,Montana,Big Sky,116,2800,288,682,182,418,106,264,162,243,132,430,562,256,95,83,236,282,844
3923,Daishon Smith,2017,2019,Total,Total,68,1644,245,562,107,214,138,348,216,259,33,189,222,194,104,4,109,109,844
3924,Michael Carey,2016,2017,Wagner,NEC,64,2015,318,653,287,550,31,103,176,221,203,380,583,103,45,33,123,157,843
3925,Willie Cauley-Stein,2013,2015,Kentucky,SEC,105,2575,346,583,346,583,0,0,151,297,250,405,655,90,115,233,127,246,843
3926,Tyren Johnson,2008,2010,Louisiana,Sun Belt,89,2341,316,684,264,513,52,171,159,226,159,334,493,173,104,113,191,221,843
3927,Anthony Lindauer,2014,2017,High Point,Big South,123,2427,277,682,110,284,167,398,122,137,14,236,250,200,93,22,169,196,843
3928,Malik Maitland,2016,2019,Total,Total,87,2185,283,791,183,488,100,303,177,227,53,145,198,339,140,7,185,170,843
3929,Robert Nwankwo,2008,2012,Towson,CAA,119,2698,306,641,306,641,0,0,231,458,341,465,806,50,96,223,143,247,843
3930,Dalton Pepper,2010,2014,Total,Total,122,2123,305,756,166,356,139,400,94,113,84,181,265,122,58,15,93,118,843
3931,Ryan Anderson,2008,2010,Nebraska,Big 12,94,2565,287,669,150,310,137,359,131,174,95,360,455,182,141,10,131,253,842
3932,Derrell Armstrong,2012,2013,North Carolina-Greensboro,Southern,62,1566,298,693,230,492,68,201,178,234,103,186,289,133,87,12,165,154,842
3933,Thomas Bryant,2016,2017,Indiana,Big Ten,69,1745,305,515,277,440,28,75,204,284,146,282,428,84,43,84,136,203,842
3934,Haanif Cheatham,2016,2019,Total,Total,80,2192,289,616,234,466,55,150,209,272,41,255,296,170,75,7,172,135,842
3935,Julian Jacobs,2014,2016,Southern California,Pac-12,95,2730,307,661,265,525,42,136,186,263,80,348,428,397,108,40,254,223,842
3936,Jeremiah Jefferson,2016,2019,Total,Total,68,1914,304,756,139,313,165,443,69,93,21,124,145,106,43,10,79,98,842
3937,Joshua Patton,2017,2019,Sacramento State,Big Sky,94,1976,309,513,308,512,1,1,223,344,146,273,419,43,45,142,130,283,842
3938,Yettra Specks,2015,2017,Jackson State,SWAC,99,2965,263,730,126,305,137,425,179,221,59,181,240,234,101,7,179,252,842
3939,Trey Chapman,2014,2017,Virginia Military Institute,Total,121,2679,301,723,245,513,56,210,183,282,175,321,496,115,65,66,179,311,841
3940,Maurice Creek,2010,2014,Total,Total,86,1791,280,664,134,282,146,382,135,178,56,163,219,108,62,15,119,143,841
3941,Jeremy Evans,2008,2010,Western Kentucky,Sun Belt,102,2478,340,533,329,501,11,32,150,218,242,364,606,56,65,180,106,257,841
3942,Matt Glass,2008,2012,Total,Total,130,2257,310,705,197,401,113,304,108,145,104,227,331,78,25,23,102,250,841
3943,Marc Gosselin,2016,2019,Western Carolina,Southern,128,2993,308,675,226,445,82,230,143,191,222,477,699,146,93,54,212,344,841
3944,Chris Howard,2008,2010,South Florida,Big East,95,3233,278,684,216,475,62,209,223,334,97,272,369,403,86,19,209,204,841
3945,De'Andre Hunter,2018,2019,Virginia,ACC,69,1810,294,580,231,426,63,154,190,244,84,212,296,108,40,33,77,134,841
3946,Jalen Jackson,2014,2017,Total,Total,90,1826,322,663,266,541,56,122,141,199,78,235,313,130,76,44,155,168,841
3947,DaQuan Jeffries,2016,2019,Total,Total,85,2009,302,570,222,358,80,212,157,204,125,298,423,100,64,92,107,236,841
3948,Stanton Kidd,2013,2015,Total,Total,65,2020,321,632,265,489,56,143,143,200,151,235,386,93,60,46,114,167,841
3949,Leslie McDonald,2010,2014,North Carolina,ACC,125,2129,287,786,140,344,147,442,120,173,76,162,238,115,54,12,96,210,841
3950,Caleb Tanner,2016,2019,Radford,Big South,121,1961,269,662,49,130,220,532,83,98,9,74,83,78,23,1,69,89,841
3951,Austin Tilghman,2015,2018,Monmouth,MAAC,132,2778,259,539,233,453,26,86,297,432,72,370,442,302,116,3,222,178,841
3952,Evan Fisher,2016,2019,Siena,MAAC,128,2460,329,719,274,539,55,180,127,179,83,336,419,79,24,47,121,233,840
3953,Jalen Jones,2016,2017,Texas-Arlington,Sun Belt,67,1698,300,648,199,368,101,280,139,176,119,194,313,80,60,7,63,115,840
3954,Marquis Jones,2008,2011,Rhode Island,A-10,134,3188,275,692,182,412,93,280,197,284,36,249,285,459,164,21,248,277,840
3955,Alessandro Lever,2018,2019,Grand Canyon,WAC,68,1592,293,651,227,457,66,194,188,248,84,210,294,87,26,16,116,200,840
3956,Rashad Ray,2013,2016,Tulsa,Total,131,2867,270,682,183,409,87,273,213,280,33,258,291,298,130,5,161,224,840
3957,P.J. Alawoya,2008,2011,McNeese State,Southland,119,2041,352,668,351,662,1,6,134,235,294,536,830,92,99,63,130,277,839
3958,Jadon Cohee,2015,2018,Total,Total,97,2345,277,709,191,473,86,236,199,252,13,183,196,180,40,2,152,142,839
3959,Cole Darling,2011,2014,Wright State,Horizon,114,2258,283,682,219,497,64,185,209,273,120,281,401,81,95,38,133,300,839
3960,Richard Delk,2009,2010,Troy,Sun Belt,65,2120,330,702,231,412,99,290,80,143,76,232,308,132,71,28,127,146,839
3961,Iverson Fleming,2014,2017,Long Island University,NEC,117,2442,287,777,187,469,100,308,165,230,52,168,220,148,97,18,165,209,839
3962,Derek Glasser,2008,2010,Arizona State,Pac-10,101,3119,232,606,117,298,115,308,260,307,30,186,216,454,97,5,206,123,839
3963,Quentin Goodin,2017,2019,Xavier,Big East,104,3029,290,746,216,491,74,255,185,271,25,253,278,451,105,19,239,229,839
3964,Traevon Jackson,2012,2015,Wisconsin,Big Ten,111,2741,273,683,203,472,70,211,223,285,46,237,283,307,81,14,194,197,839
3965,Isaiah Miller,2018,2019,North Carolina-Greensboro,Southern,71,1572,359,685,336,598,23,87,98,170,102,170,272,126,151,12,106,151,839
3966,Latreze Mushatt,2009,2013,Total,Total,111,2788,327,758,288,620,39,138,146,260,204,357,561,120,100,32,164,242,839
3967,Brendan Westendorf,2016,2017,Seattle,WAC,62,2005,290,720,175,403,115,317,144,182,59,236,295,247,111,7,190,127,839
3968,Tyler Williams,2016,2019,San Diego,WCC,126,3792,268,695,121,300,147,395,156,201,107,357,464,283,79,17,184,243,839
3969,Dedrick Basile,2016,2017,Cal State Bakersfield,WAC,68,2008,317,700,202,394,115,306,89,126,45,176,221,228,115,10,132,165,838
3970,Trent Frazier,2018,2019,Illinois,Big Ten,64,1817,288,706,147,333,141,373,121,173,17,114,131,181,98,2,136,142,838
3971,Rhett Harrelson,2013,2016,Western Carolina,Southern,124,2430,248,660,56,168,192,492,150,184,33,118,151,160,81,2,153,157,838
3972,Adam Pickett,2016,2019,Winthrop,Big South,121,1878,305,559,236,383,69,176,159,219,67,273,340,163,87,35,207,252,838
3973,Brandon Randolph,2014,2018,Total,Total,124,2676,297,724,226,502,71,222,173,239,55,315,370,353,88,8,232,185,838
3974,Dylan Smith,2016,2019,Total,Total,100,2210,258,718,98,257,160,461,162,202,38,223,261,134,58,28,172,200,838
3975,Malik Thomas,2012,2015,Total,Total,122,2600,312,734,227,467,85,267,129,195,155,384,539,152,76,78,157,258,838
3976,Keonta Vernon,2016,2018,Grand Canyon,WAC,99,2170,340,656,339,650,1,6,157,290,230,400,630,93,80,71,137,338,838
3977,Trae Anderson,2015,2016,Eastern Illinois,OVC,60,1460,319,664,298,590,21,74,178,271,101,203,304,108,55,40,155,177,837
3978,David Collins,2018,2019,South Florida,AAC,63,1876,245,576,180,382,65,194,282,394,35,162,197,175,102,14,183,197,837
3979,Aaseem Dixon,2014,2015,Northern Arizona,Big Sky,69,2320,284,755,139,368,145,387,124,160,45,166,211,155,61,1,113,106,837
3980,Rashon Dwight,2008,2011,Iona,MAAC,125,1445,270,720,192,482,78,238,219,292,90,266,356,295,143,53,243,307,837
3981,Travele Jones,2010,2011,Texas Southern,SWAC,57,1892,264,555,226,401,38,154,271,429,102,258,360,86,99,35,191,142,837
3982,Christian Kessee,2014,2017,Total,Total,109,2081,274,717,123,309,151,408,138,173,38,137,175,138,45,2,142,200,837
3983,Magnum Rolle,2009,2010,Louisiana Tech,WAC,64,1870,329,632,328,630,1,2,178,271,199,302,501,58,54,123,135,183,837
3984,Anthony Thomas,2008,2010,Boise State,WAC,98,2919,294,694,172,335,122,359,127,187,42,223,265,413,143,2,279,253,837
3985,JC Younger,2017,2019,Presbyterian,Big South,89,2310,282,699,97,244,185,455,88,113,44,230,274,84,32,3,112,139,837
3986,Jason Carter,2017,2019,Ohio,MAC,65,1645,300,617,268,503,32,114,204,287,127,292,419,84,45,40,95,150,836
3987,Keyon Carter,2008,2011,Old Dominion,CAA,127,2457,331,753,265,560,66,193,108,160,190,310,500,93,64,47,117,175,836
3988,Ben Dowdell,2008,2011,Santa Clara,WCC,128,3114,294,612,291,594,3,18,245,388,190,326,516,140,111,49,232,393,836
3989,Terrel Harris,2008,2009,Oklahoma State,Big 12,68,2084,286,633,196,363,90,270,174,216,69,238,307,114,109,18,153,218,836
3990,Sam Burmeister,2014,2018,Incarnate Word,Southland,103,2718,276,686,150,346,126,340,157,232,24,273,297,143,56,9,169,263,835
3991,Edric Dennis,2017,2019,Total,Total,59,1818,260,737,139,353,121,384,194,275,67,187,254,127,52,9,163,136,835
3992,Michael Griffin,2009,2012,Prairie View,SWAC,92,2326,290,874,157,444,133,430,122,179,63,182,245,268,136,2,228,193,835
3993,Ronald Nored,2009,2012,Butler,Horizon,143,4111,251,646,203,463,48,183,285,449,91,390,481,497,207,7,329,368,835
3994,Jovonni Shuler,2008,2011,Savannah State,Ind,89,2240,271,682,159,353,112,329,181,236,85,248,333,107,126,22,168,161,835
3995,Hasheem Thabeet,2008,2009,Connecticut,Big East,69,2169,292,467,292,467,0,0,251,381,230,418,648,29,31,299,126,176,835
3996,Jalen Jordan,2018,2019,St. Francis (NY),NEC,64,1868,264,624,111,255,153,369,153,186,31,176,207,78,34,12,89,108,834
3997,Gerrell Martin,2012,2015,Long Island University,NEC,115,2089,277,660,130,311,147,349,133,158,82,191,273,59,50,2,100,140,834
3998,Craig McFerrin,2012,2016,McNeese State,Southland,101,2484,353,686,353,679,0,7,128,224,211,428,639,67,36,92,185,240,834
3999,Afam Muojeke,2009,2012,Wyoming,MWC,72,1726,264,613,176,336,88,277,218,282,35,243,278,87,66,18,184,117,834
4000,Alex Renfroe,2008,2009,Belmont,A-Sun,67,1715,286,529,240,399,46,130,216,332,118,254,372,293,117,21,201,146,834
4001,Vee Sanford,2010,2014,Total,Total,122,2005,305,673,237,475,68,198,156,203,35,189,224,155,83,24,138,174,834
4002,Shamari Spears,2008,2011,Total,Total,63,1779,304,641,291,603,13,38,213,284,149,216,365,55,48,20,121,143,834
4003,Tay Waller,2009,2010,Auburn,SEC,62,1844,279,648,92,164,187,484,89,112,39,159,198,85,87,13,71,150,834
4004,Cameron Wright,2012,2015,Pittsburgh,Total,130,2719,341,754,320,665,21,89,131,217,64,230,294,225,139,30,147,220,834
4005,Alex Abreu,2011,2013,Akron,MAC,96,2530,258,622,130,303,128,319,189,239,54,163,217,450,135,6,245,183,833
4006,Jamelle Cornley,2008,2009,Penn State,Big Ten,62,2052,343,668,322,609,21,59,126,224,120,263,383,91,35,9,121,106,833
4007,Austin Hamilton,2012,2015,Elon,Total,105,2390,295,695,209,427,86,268,157,239,47,184,231,303,92,5,182,184,833
4008,Noah Horchler,2018,2019,North Florida,A-Sun,61,1741,347,639,303,502,44,137,95,170,148,398,546,80,44,102,105,152,833
4009,Kareem Nitoto,2008,2012,Total,Total,119,3084,261,715,181,461,80,254,231,315,63,251,314,306,84,22,265,214,833
4010,Teddy Okereafor,2012,2016,Total,Total,124,2700,255,659,155,328,100,331,223,306,48,285,333,351,125,11,223,108,833
4011,Steve Panos,2008,2010,Weber State,Big Sky,92,1898,303,560,303,558,0,2,227,314,132,265,397,40,22,22,144,228,833
4012,Rayshawn Simmons,2014,2016,Central Michigan,MAC,96,2648,289,679,239,513,50,166,205,293,121,236,357,360,77,5,174,238,833
4013,Mikel Trapp,2011,2015,Bethune-Cookman,MEAC,118,2874,278,745,96,209,182,536,95,137,58,188,246,105,60,7,140,210,833
4014,Steven Whitley,2016,2019,Total,Total,98,2318,296,694,240,497,56,197,185,305,78,342,420,326,128,10,242,234,833
4015,DeShawn Freeman,2016,2018,Rutgers,Big Ten,74,1945,310,689,299,639,11,50,201,301,190,347,537,67,94,62,141,182,832
4016,Ronald Moore,2008,2010,Siena,MAAC,103,3455,301,855,221,586,80,269,150,224,95,284,379,665,170,14,251,150,832
4017,Colin Reddick,2010,2013,Furman,Southern,122,2202,309,670,309,669,0,1,214,308,222,351,573,108,71,105,176,270,832
4018,Justin Roberson,2015,2016,Louisiana-Monroe,Sun Belt,72,2187,314,717,264,573,50,144,154,218,64,247,311,198,102,12,147,212,832
4019,Keaton Cole,2009,2012,Western Carolina,Southern,131,2442,259,669,55,143,204,526,109,147,56,109,165,141,104,1,114,142,831
4020,Tulio Da Silva,2017,2019,Total,Total,76,2150,323,657,301,588,22,69,163,262,155,355,510,60,66,44,174,189,831
4021,Darnell Foreman,2015,2018,Pennsylvania,Ivy,117,2906,278,706,210,461,68,245,207,287,47,323,370,312,103,21,175,234,831
4022,Cameron Forte,2014,2016,Total,Total,95,1600,347,599,346,595,1,4,136,256,166,275,441,128,46,29,149,99,831
4023,Daniel Hamilton,2015,2016,Connecticut,AAC,71,2247,298,777,205,501,93,276,142,184,70,518,588,298,71,28,166,152,831
4024,Brendan Mckillop,2008,2011,Davidson,Southern,117,2695,271,715,55,137,216,578,73,98,57,158,215,254,70,5,119,196,831
4025,Chris Olivier,2013,2016,Total,Total,80,1566,327,625,327,624,0,1,177,295,108,219,327,47,21,105,105,179,831
4026,Jordan Printy,2009,2012,Indiana State,MVC,125,2947,281,735,66,193,215,542,54,78,35,199,234,190,69,11,102,134,831
4027,Ross Travis,2012,2015,Penn State,Big Ten,131,3391,318,752,297,644,21,108,174,300,257,559,816,92,77,37,162,306,831
4028,Bolden Brace,2017,2019,Northeastern,CAA,98,2635,268,620,100,171,168,449,126,156,64,401,465,213,65,32,105,191,830
4029,Kyle Davis,2014,2017,Dayton,A-10,134,2980,278,560,213,343,65,217,209,305,40,317,357,257,160,38,131,292,830
4030,Marcos Knight,2012,2013,Middle Tennessee,Sun Belt,68,1839,309,666,273,548,36,118,176,268,108,264,372,181,82,28,137,165,830
4031,Kevin Langford,2008,2009,Texas Christian,MWC,61,1840,254,568,235,511,19,57,303,404,120,181,301,73,37,30,141,197,830
4032,Lotanna Nwogbo,2012,2016,Total,Total,97,1767,314,540,312,535,2,5,200,306,188,283,471,29,36,65,151,216,830
4033,Jabari Peters,2012,2015,Total,Total,96,2345,238,603,134,302,104,301,250,372,78,281,359,242,109,27,154,118,830
4034,Mike Proctor,2009,2012,Northern Colorado,Big Sky,118,2499,318,623,318,614,0,9,194,304,212,448,660,126,85,53,179,276,830
4035,Tim Quarterman,2014,2016,Louisiana State,SEC,99,2461,271,683,173,367,98,316,190,288,120,267,387,302,103,40,168,214,830
4036,Jake Bittle,2013,2016,South Dakota State,Summit,108,2674,289,630,212,407,77,223,174,226,127,278,405,225,124,22,180,273,829
4037,John Brisco,2012,2015,Total,Total,95,1959,292,720,187,422,105,298,140,186,52,136,188,113,113,5,132,213,829
4038,Chris Davis,2008,2009,Southern,SWAC,55,1774,277,636,195,416,82,220,193,251,41,191,232,147,74,12,138,89,829
4039,Tra-Deon Hollins,2016,2017,Omaha,Summit,64,2089,282,636,219,426,63,210,202,264,70,247,317,405,235,21,214,173,829
4040,Jamelle Horne,2008,2011,Arizona,Pac-10,129,2965,303,687,192,396,111,291,112,169,145,399,544,118,59,69,139,315,829
4041,Kevin Johnson,2014,2017,Cincinnati,AAC,136,2797,284,761,136,298,148,463,113,148,70,144,214,167,115,14,148,224,829
4042,Beau Levesque,2010,2014,Saint Mary's (CA),WCC,121,2132,276,595,185,354,91,241,186,240,133,283,416,135,53,17,124,224,829
4043,Aaron Linn,2008,2009,Gardner-Webb,Total,62,1914,299,690,215,458,84,232,147,199,58,221,279,197,111,21,151,197,829
4044,Elijah Millsap,2008,2010,Total,Total,64,1783,276,674,237,530,39,144,238,363,149,336,485,101,100,19,200,178,829
4045,Tyrel Reed,2008,2011,Kansas,Big 12,132,2517,256,591,80,158,176,433,141,175,43,202,245,163,117,10,90,147,829
4046,Marcus Thornton,2011,2015,Georgia,SEC,133,2885,289,687,268,615,21,72,230,361,208,456,664,91,66,120,165,307,829
4047,Taylor Broekhuis,2010,2013,Air Force,MWC,116,2743,303,606,251,426,52,180,170,266,87,337,424,149,59,83,176,241,828
4048,Brian Brown,2012,2015,Virginia Military Institute,Total,114,2540,286,744,83,175,203,569,53,63,70,127,197,143,72,2,111,153,828
4049,Matt Costello,2013,2016,Michigan State,Big Ten,138,2281,325,573,323,561,2,12,176,247,238,405,643,107,54,146,98,288,828
4050,Joe Dukes,2009,2010,Georgia State,CAA,63,1992,313,719,269,577,44,142,158,219,107,207,314,257,110,4,169,115,828
4051,Ben Emelogu,2014,2018,Total,Total,124,2891,289,745,144,354,145,391,105,155,90,314,404,195,102,20,152,245,828
4052,Ashen Ward,2009,2012,Youngstown State,Horizon,119,2791,278,744,128,300,150,444,122,177,111,251,362,184,74,18,158,213,828
4053,Mike Williams,2010,2011,Western Carolina,Southern,65,1737,304,741,225,513,79,228,141,193,59,147,206,197,111,6,158,174,828
4054,Max Yon,2012,2015,Air Force,MWC,103,2206,280,648,186,359,94,289,174,232,46,174,220,164,46,11,154,129,828
4055,Justin Dentmon,2008,2009,Washington,Pac-10,68,1791,269,609,179,371,90,238,199,257,50,122,172,162,89,9,119,117,827
4056,Gregory Graves,2013,2016,Mount St. Mary's,NEC,117,2606,275,662,227,509,48,153,229,339,202,410,612,77,89,61,135,238,827
4057,Cullen Hamilton,2013,2016,Holy Cross,Patriot,113,2677,289,784,168,406,121,378,128,167,69,201,270,125,56,1,109,141,827
4058,Ashton Pankey,2011,2015,Total,Total,99,2145,284,542,284,542,0,0,259,421,183,336,519,51,38,100,139,306,827
4059,Allen Roberts,2010,2014,Total,Total,110,2295,260,673,162,362,98,311,209,271,50,185,235,122,61,20,172,192,827
4060,Justin Tubbs,2008,2011,Total,Total,86,2147,271,684,108,205,163,479,122,181,111,196,307,38,76,7,104,181,827
4061,Lathen Wallace,2008,2011,Oregon State,Pac-10,120,1978,271,700,138,314,133,386,152,213,70,151,221,50,64,9,124,176,827
4062,Kaylon Williams,2009,2012,Total,Total,97,3107,273,727,188,454,85,273,196,333,46,436,482,544,123,11,309,216,827
4063,Courtney Beasley,2008,2009,Southern Mississippi,CUSA,65,2048,313,694,286,617,27,77,173,220,116,261,377,105,65,9,91,165,826
4064,Akeem Bennett,2010,2011,St. Francis (NY),NEC,58,1994,260,663,195,447,65,216,241,362,112,243,355,197,140,33,228,190,826
4065,James Kelly,2014,2016,Total,Total,60,1491,325,613,261,417,64,196,112,153,87,338,425,53,55,47,95,136,826
4066,Chris Martin,2008,2011,Stony Brook,AEC,102,1951,261,678,232,575,29,103,275,370,68,213,281,152,77,11,167,225,826
4067,J.J. Panoske,2013,2016,Milwaukee,Horizon,125,2227,312,692,219,414,93,278,109,133,116,356,472,103,27,154,151,228,826
4068,Errick Peck,2010,2014,Total,Total,119,2150,311,721,255,563,56,158,148,219,159,263,422,116,49,52,156,234,826
4069,Jonah Radebaugh,2017,2019,Northern Colorado,Big Sky,99,3516,270,621,115,215,155,406,131,190,107,472,579,183,102,22,105,205,826
4070,Reid Augst,2008,2009,North Carolina-Asheville,Big South,64,2105,292,606,227,407,65,199,176,239,110,199,309,145,74,17,127,109,825
4071,Chris Boucher,2016,2017,Oregon,Pac-12,69,1712,300,564,225,346,75,218,150,234,157,311,468,28,42,189,75,185,825
4072,Jourdan Demunyck,2012,2013,Prairie View,SWAC,64,1680,305,774,252,614,53,160,162,235,112,237,349,103,80,10,151,124,825
4073,Roosevelt Johnson,2010,2013,Southeastern Louisiana,Southland,103,1930,307,697,305,688,2,9,209,333,201,406,607,67,72,64,195,277,825
4074,Dequon Miller,2016,2017,Missouri State,MVC,65,2284,270,720,158,385,112,335,173,242,38,159,197,220,54,0,155,113,825
4075,Tommy Rutherford,2017,2019,UC-Irvine,Big West,108,2006,321,562,311,537,10,25,173,250,194,353,547,67,21,81,166,271,825
4076,Seth Towns,2017,2018,Harvard,Ivy,58,1527,280,662,179,421,101,241,164,202,64,228,292,90,52,34,129,159,825
4077,Tyrone Watson,2010,2013,New Mexico State,WAC,120,2994,296,573,272,479,24,94,209,350,183,292,475,266,108,30,210,220,825
4078,Jonathon Williams,2012,2013,Wagner,NEC,57,1554,304,569,269,458,35,111,182,239,103,219,322,56,48,18,126,181,825
4079,Paul Carter,2009,2011,Total,Total,94,1989,287,682,241,534,46,148,204,272,169,333,502,106,57,46,167,215,824
4080,Markus Crider,2013,2016,Georgia State,Total,129,3069,330,598,330,591,0,7,164,249,176,411,587,132,109,45,158,371,824
4081,Toby Hegner,2015,2018,Creighton,Big East,131,2474,278,640,123,226,155,414,113,153,102,344,446,83,30,48,79,283,824
4082,Fatodd Lewis,2016,2019,Tennessee-Martin,OVC,100,2137,310,695,250,489,60,206,144,237,153,337,490,90,68,41,139,178,824
4083,Chris Lykes,2018,2019,Miami (FL),ACC,64,1772,271,669,162,338,109,331,173,228,17,108,125,178,68,2,151,142,824
4084,Quinton Marshall,2013,2016,Citadel,Southern,117,2574,313,715,247,508,66,207,132,224,117,227,344,133,81,31,185,234,824
4085,Ervin Mitchell,2016,2017,Grambling,SWAC,57,1619,274,597,206,405,68,192,208,302,45,171,216,62,62,20,99,143,824
4086,Marquise Pointer,2016,2019,College of Charleston,CAA,125,3153,277,791,150,384,127,407,143,203,90,205,295,267,107,17,176,194,824
4087,Orlando Williams,2010,2014,Total,Total,109,2246,278,637,141,291,137,346,131,183,38,178,216,138,70,21,134,207,824
4088,Tone Boyle,2009,2011,Milwaukee,Horizon,63,2195,254,677,105,259,149,418,166,219,30,173,203,68,54,10,93,95,823
4089,Giovanni De Nicolao,2017,2019,Texas-San Antonio,CUSA,100,2887,301,823,219,550,82,273,139,208,45,301,346,348,153,13,217,309,823
4090,Will Egolf,2008,2013,Bradley,MVC,117,2447,326,715,289,595,37,120,134,194,144,324,468,67,81,79,141,364,823
4091,Tyler Lydon,2016,2017,Syracuse,ACC,71,2349,278,584,180,339,98,245,169,209,145,382,527,111,77,116,106,184,823
4092,Deandre Mathieu,2012,2015,Total,Total,100,2453,306,633,266,537,40,96,171,233,45,179,224,346,150,4,194,191,823
4093,Derrick Nix,2010,2013,Michigan State,Big Ten,139,2219,321,602,321,602,0,0,181,315,203,308,511,111,82,32,138,176,823
4094,Justin Simmons,2013,2014,Omaha,Summit,61,1511,305,709,235,493,70,216,143,180,41,156,197,110,69,28,146,66,823
4095,Drew Urquhart,2015,2018,Vermont,AEC,134,2084,313,587,298,549,15,38,182,257,138,322,460,108,20,86,138,263,823
4096,Philip Whittington,2016,2019,Total,Total,94,1747,352,670,351,658,1,12,118,193,199,398,597,52,31,100,130,231,823
4097,Troy Brewer,2008,2012,Total,Total,112,2337,285,716,140,299,145,417,107,135,54,213,267,101,58,20,96,124,822
4098,Anthony Downing,2012,2013,Missouri State,MVC,65,2104,282,677,206,416,76,261,182,226,43,203,246,162,50,3,110,136,822
4099,Todd Fletcher,2010,2013,Air Force,MWC,124,3441,292,644,172,310,120,334,118,145,32,261,293,366,132,11,172,239,822
4100,Kareem Maddox,2008,2011,Princeton,Ivy,104,2264,282,589,267,511,15,78,243,309,130,326,456,143,62,108,155,154,822
4101,Cheddi Mosely,2015,2019,Total,Total,88,2077,274,682,115,224,159,458,115,153,26,160,186,86,79,10,127,138,822
4102,Otto Porter,2012,2013,Georgetown,Big East,64,2077,293,588,238,433,55,155,181,241,121,336,457,135,94,55,85,125,822
4103,Greig Stire,2015,2018,Albany (NY),AEC,132,2876,306,568,306,567,0,1,210,326,311,424,735,107,53,21,125,359,822
4104,Ryan Tillema,2008,2009,Green Bay,Horizon,56,1498,258,531,131,249,127,282,179,227,42,189,231,72,33,26,69,140,822
4105,Jared Wilson-Frame,2018,2019,Pittsburgh,ACC,64,1899,281,719,109,240,172,479,88,109,61,210,271,95,33,12,108,137,822
4106,Holland Woods,2018,2019,Portland State,Big Sky,65,2201,255,641,190,416,65,225,247,315,30,157,187,356,99,6,198,140,822
4107,Jonathan Arledge,2011,2015,Total,Total,133,1991,296,662,265,559,31,103,198,273,181,295,476,68,56,59,135,292,821
4108,Kimmani Barrett,2008,2010,La Salle,A-10,78,2162,274,594,200,385,74,209,199,271,151,184,335,99,59,20,139,170,821
4109,Aric Brooks,2008,2012,Total,Total,122,2538,225,579,178,442,47,137,324,403,101,275,376,131,85,23,187,219,821
4110,Cameron McGriff,2017,2019,Oklahoma State,Big 12,100,2452,256,614,190,405,66,209,243,307,189,341,530,109,82,53,141,239,821
4111,Lindy Waters,2017,2019,Oklahoma State,Big 12,90,2395,275,615,137,284,138,331,133,164,73,233,306,180,85,21,115,199,821
4112,Ryan Kreklow,2016,2019,Missouri State,MVC,126,2716,256,666,88,209,168,457,140,171,44,241,285,145,98,26,156,268,820
4113,Reeves Nelson,2010,2012,UCLA,Total,68,1837,310,531,303,503,7,28,193,336,139,355,494,73,37,38,134,148,820
4114,Klint Carlson,2015,2018,Northern Iowa,MVC,113,2799,311,729,234,472,77,257,120,165,93,379,472,138,67,22,132,191,819
4115,Jonathan Cox,2008,2009,Drake,MVC,66,2113,276,585,166,325,110,260,157,210,138,424,562,52,56,60,96,153,819
4116,Luka Garza,2018,2019,Iowa,Big Ten,65,1474,302,556,265,438,37,118,178,242,138,217,355,63,21,49,77,154,819
4117,P.J. Miller,2010,2013,NJIT,GWC,112,2943,296,695,292,650,4,45,223,371,83,218,301,323,127,21,254,255,819
4118,Christian Wall,2008,2011,Chicago State,Total,120,2498,281,733,190,441,91,292,166,240,64,202,266,196,123,9,175,266,819
4119,Michael Davenport,2009,2013,St. Bonaventure,A-10,127,2581,311,749,239,524,72,225,124,163,102,283,385,204,87,30,178,225,818
4120,Kenny Dawkins,2008,2009,Lamar,Southland,55,1923,260,616,147,310,113,306,185,217,25,151,176,240,105,2,149,111,818
4121,Lamine Diane,2019,2019,Cal State Northridge,Big West,33,1165,340,701,333,678,7,23,131,251,108,260,368,68,50,72,105,112,818
4122,Devin Harris,2014,2018,Total,Total,97,2413,286,629,265,554,21,75,225,319,120,408,528,257,110,18,198,177,818
4123,Victor Joseph,2017,2018,Cal Poly,Big West,62,1704,270,673,156,356,114,317,164,193,35,100,135,83,50,8,111,142,818
4124,Marquise Kately,2008,2009,Morgan State,MEAC,68,2189,345,716,329,656,16,60,112,203,158,230,388,108,57,23,152,150,818
4125,A.J. Mosby,2017,2018,Alcorn State,SWAC,64,2025,290,634,173,337,117,297,121,145,38,262,300,211,89,7,113,111,818
4126,Stanford Robinson,2014,2018,Total,Total,132,2457,299,692,252,535,47,157,172,286,123,293,416,189,143,36,161,272,817
4127,Ola Atoyebi,2008,2009,Elon,Southern,63,1620,320,557,320,555,0,2,176,239,161,228,389,38,63,36,118,185,816
4128,Aaron Brown,2012,2016,Total,Total,116,2303,290,692,220,490,70,202,166,242,93,214,307,111,49,9,119,170,816
4129,Robert Dozier,2008,2009,Memphis,CUSA,74,2080,291,604,260,515,31,89,203,289,203,324,527,92,88,129,131,200,816
4130,John Egbunu,2014,2017,Total,Total,90,2184,302,533,301,531,1,2,211,387,231,345,576,31,33,126,157,263,816
4131,Denzel Gregg,2014,2017,St. Bonaventure,A-10,114,2390,312,658,296,593,16,65,176,282,197,342,539,90,52,137,149,273,816
4132,Tucker Halpern,2010,2013,Brown,Ivy,82,2234,282,733,138,326,144,407,108,138,52,243,295,164,85,41,116,135,816
4133,Nathan Healy,2010,2013,Appalachian State,Southern,126,2396,298,624,216,402,82,222,138,182,154,345,499,110,107,71,125,239,816
4134,Zedric Sadler,2013,2016,Rider,MAAC,124,3085,286,731,182,418,104,313,140,208,80,304,384,250,126,45,182,201,816
4135,Roeland Schaftenaar,2008,2010,Oregon State,Pac-10,99,2504,293,641,242,465,51,176,179,255,115,282,397,197,63,58,159,172,816
4136,Kevin Ware,2012,2016,Total,Total,131,2839,287,674,236,520,51,154,191,267,53,252,305,220,144,35,195,214,816
4137,Derrick Williams,2011,2014,Richmond,A-10,106,2056,250,477,211,365,39,112,277,372,158,267,425,80,45,35,141,216,816
4138,Brent Benson,2008,2009,Texas State,Southland,58,1373,242,572,84,188,158,384,173,243,35,93,128,72,39,5,83,155,815
4139,Kevin Coble,2008,2009,Northwestern,Big Ten,52,1794,309,649,227,440,82,209,115,147,42,220,262,113,68,28,75,94,815
4140,D.J. Foreman,2015,2019,Total,Total,131,2688,309,605,303,588,6,17,191,363,180,361,541,88,49,53,207,317,815
4141,Pat Forsythe,2012,2016,Total,Total,129,2210,327,615,326,609,1,6,160,267,199,297,496,72,58,132,171,288,815
4142,Dayon Griffin,2015,2019,Total,Total,121,2494,293,708,151,293,142,415,87,158,56,298,354,130,101,30,122,158,815
4143,Zane Martin,2017,2018,Towson,CAA,65,1434,290,659,202,419,88,240,147,210,32,138,170,118,47,8,114,110,815
4144,Geoff McCammon,2008,2011,Loyola (IL),Horizon,92,1827,280,659,137,312,143,347,112,148,33,142,175,59,48,12,97,116,815
4145,Ambrose Mosley,2014,2017,Total,Total,111,2456,272,713,73,162,199,551,72,100,68,226,294,108,67,5,79,217,815
4146,Curran Scott,2016,2019,Total,Total,96,2067,243,575,159,363,84,212,245,301,40,181,221,100,36,2,130,153,815
4147,Aaron Thomas,2013,2015,Florida State,ACC,76,1938,277,628,225,465,52,163,209,271,59,194,253,116,87,21,152,136,815
4148,J.T. Tiller,2008,2010,Missouri,Big 12,101,2314,294,673,260,533,34,140,193,255,107,193,300,298,144,18,168,279,815
4149,Clarence Trent,2010,2014,Total,Total,110,1952,300,702,243,490,57,212,158,236,162,302,464,97,101,53,196,247,815
4150,Tyler Ulis,2015,2016,Kentucky,SEC,72,2170,259,607,171,370,88,237,209,247,35,137,172,381,88,6,107,120,815
4151,Bashir Ahmed,2017,2018,St. John's (NY),Big East,66,1877,272,679,176,404,96,275,174,267,112,223,335,71,53,30,124,177,814
4152,Glenn Andrews,2008,2012,Total,Total,97,1838,267,808,128,340,139,468,141,205,41,183,224,115,84,14,157,108,814
4153,Jordan Bell,2015,2017,Oregon,Pac-12,105,2591,345,566,342,550,3,16,121,192,224,495,719,155,111,234,162,241,814
4154,Malcolm Bernard,2013,2017,Total,Total,124,2687,254,624,183,411,71,213,235,368,145,365,510,232,136,45,196,267,814
4155,Moussa Camara,2008,2011,Binghamton,AEC,108,2449,261,707,112,279,149,428,143,193,58,155,213,60,46,11,115,158,814
4156,Marc Egerson,2008,2009,Delaware,CAA,56,2010,251,638,162,391,89,247,223,292,92,404,496,157,69,8,177,124,814
4157,Michael Freeman,2008,2010,Hampton,MEAC,90,2391,279,571,278,558,1,13,255,357,174,329,503,55,115,85,214,202,814
4158,Akim Mitchell,2016,2019,Hampton,Total,128,2846,291,605,231,445,60,160,172,214,174,308,482,133,83,7,117,266,814
4159,Reese Morgan,2013,2016,Cal Poly,Big West,98,2017,206,577,52,151,154,426,248,286,68,187,255,119,77,12,65,220,814
4160,Tarik Phillip,2015,2017,West Virginia,Big 12,106,2118,248,589,170,378,78,211,240,336,68,177,245,238,154,25,161,206,814
4161,Matt Smith,2010,2014,Total,Total,132,2364,282,579,197,371,85,208,165,226,116,264,380,37,44,66,114,253,814
4162,Adrian Williams,2008,2011,Brown,Ivy,115,2793,254,659,94,208,160,451,146,191,33,222,255,127,65,4,149,132,814
4163,Dachon Burke,2017,2018,Robert Morris,NEC,65,1799,305,684,247,510,58,174,145,220,108,204,312,104,118,27,144,155,813
4164,Michael Craion,2010,2012,Oral Roberts,Summit,69,2023,311,577,308,561,3,16,188,294,172,287,459,108,99,62,154,186,813
4165,Reger Dowell,2010,2014,Total,Total,83,1565,267,647,149,314,118,333,161,215,16,110,126,116,33,4,127,152,813
4166,Tre Hale-Edmerson,2013,2016,Cal State Northridge,Big West,129,3522,325,682,290,554,35,128,128,177,147,581,728,303,137,185,232,422,813
4167,Chris Hines,2010,2013,Total,Total,117,2468,263,716,92,253,171,463,116,159,31,160,191,76,52,5,142,188,813
4168,Amath M'Baye,2010,2013,Total,Total,84,2158,313,669,291,559,22,110,165,250,126,284,410,56,55,72,172,226,813
4169,Deven Simms,2017,2018,Arkansas State,Sun Belt,54,1535,293,624,251,504,42,120,185,256,65,230,295,99,66,21,132,88,813
4170,Raymond Spalding,2016,2018,Louisville,ACC,100,2173,332,596,326,571,6,25,143,247,228,402,630,89,104,111,131,261,813
4171,Novak Topalovic,2016,2019,Total,Total,123,2500,331,607,331,604,0,3,151,303,176,445,621,83,30,107,184,288,813
4172,Andre Williamson,2009,2012,Appalachian State,Southern,126,2580,304,561,295,542,9,19,196,314,183,540,723,87,36,160,157,291,813
4173,Shaquille Boga,2014,2015,Texas-Rio Grande Valley,WAC,61,2067,291,750,205,483,86,267,144,199,29,169,198,211,105,5,124,133,812
4174,Mitch Bruneel,2012,2015,Total,WAC,97,2528,302,594,237,402,65,192,143,208,187,217,404,87,55,13,98,160,812
4175,Jordan Butler,2015,2019,Norfolk State,MEAC,129,3027,288,584,288,584,0,0,236,349,240,492,732,99,54,229,175,335,812
4176,Galal Cancer,2012,2016,Total,Total,118,2881,266,711,193,500,73,211,207,297,106,229,335,288,117,18,217,306,812
4177,Oscar Frayer,2017,2019,Grand Canyon,WAC,97,2488,304,697,192,349,112,348,92,157,138,316,454,101,104,73,124,223,812
4178,Jimmy Gray,2010,2013,Binghamton,AEC,115,3205,285,779,122,273,163,506,79,101,57,225,282,291,143,15,241,189,812
4179,Christian Lutete,2016,2019,Total,Total,89,1762,287,602,178,298,109,304,129,184,77,298,375,74,28,7,113,104,812
4180,Marcus Neal,2008,2010,Delaware State,MEAC,89,2609,285,735,153,378,132,357,110,153,131,175,306,150,42,10,197,165,812
4181,Roderick Pearson,2008,2012,Total,Total,103,2687,289,666,236,483,53,183,181,251,55,208,263,310,100,8,258,325,812
4182,David Rufful,2009,2012,Dartmouth,Ivy,114,2729,315,827,230,571,85,256,97,157,98,289,387,133,137,12,191,246,812
4183,Ryan Sawvell,2012,2017,Total,Total,135,2581,329,593,298,513,31,80,123,178,176,388,564,103,48,18,100,234,812
4184,Rosco Allen,2013,2016,Stanford,Pac-12,97,2288,255,641,156,349,99,292,202,283,99,309,408,105,73,21,126,199,811
4185,Justin Alston,2013,2017,Boston University,Total,120,2075,333,594,333,592,0,2,145,205,150,324,474,67,44,59,133,267,811
4186,Ledarrius Brewer,2018,2019,Southeast Missouri State,OVC,60,1732,279,698,160,343,119,355,134,182,34,220,254,97,63,26,140,134,811
4187,Grant Gibbs,2010,2014,Total,Total,124,3136,287,555,223,390,64,165,173,255,88,360,448,519,90,24,221,298,811
4188,Tyrone Hanson,2010,2011,Jackson State,SWAC,64,1857,273,675,143,348,130,327,135,190,67,211,278,109,48,31,133,126,811
4189,Derwin Kitchen,2009,2011,Florida State,ACC,91,2595,288,623,226,439,62,184,173,239,108,359,467,308,133,10,192,122,811
4190,Andy Rautins,2009,2010,Syracuse,Big East,72,2196,256,629,56,109,200,520,99,126,31,210,241,283,121,14,171,151,811
4191,Jalen Reynolds,2014,2016,Xavier,Big East,102,1818,328,581,326,574,2,7,153,234,187,376,563,41,51,73,114,295,811
4192,Tashombe Riley,2015,2017,South Carolina State,MEAC,98,2119,351,751,340,707,11,44,98,134,151,286,437,54,50,28,84,229,811
4193,Rudy Turner,2009,2012,Total,Total,89,2072,313,591,313,589,0,2,185,278,233,321,554,26,37,120,179,281,811
4194,Ryan Allen,2018,2019,Delaware,CAA,52,1863,277,680,130,294,147,386,109,157,12,115,127,96,29,8,82,127,810
4195,Nate Kennell,2017,2019,Bradley,MVC,100,2393,271,665,106,248,165,417,103,144,22,211,233,181,57,17,127,241,810
4196,Treg Setty,2012,2016,Total,Total,131,2418,295,655,243,482,52,173,168,251,129,300,429,106,83,25,166,307,810
4197,Justin Simon,2016,2019,Total,Total,91,2488,314,668,287,591,27,77,155,250,84,350,434,283,139,55,183,202,810
4198,Josh Davis,2016,2019,Western Michigan,MAC,116,2294,290,690,200,387,90,303,139,219,111,330,441,113,76,37,176,225,809
4199,Sam McLaurin,2009,2013,Total,Total,141,3209,325,556,324,552,1,4,158,286,336,434,770,117,64,179,149,310,809
4200,Nate Miller,2008,2009,Bowling Green State,MAC,60,1903,318,713,271,569,47,144,126,250,116,297,413,148,104,26,144,101,809
4201,Kavion Pippen,2018,2019,Southern Illinois,MVC,65,1673,361,650,360,647,1,3,86,126,106,268,374,82,43,108,130,183,809
4202,Dartaye Ruffin,2011,2014,Drexel,CAA,125,3255,322,632,322,632,0,0,165,269,290,539,829,58,93,75,148,390,809
4203,Cavel Witter,2008,2010,Creighton,MVC,101,1927,234,593,139,319,95,274,246,298,25,129,154,217,72,3,194,177,809
4204,DeVaughn Akoon-Purcell,2015,2016,Illinois State,MVC,60,1629,275,642,226,479,49,163,209,283,101,215,316,97,58,18,140,114,808
4205,Brandon Brown,2016,2017,Loyola Marymount,WCC,61,1913,284,727,208,517,76,210,164,220,57,112,169,299,85,1,149,103,808
4206,Richard Carter,2013,2014,Drake,MVC,63,1790,252,609,188,415,64,194,240,324,23,146,169,227,92,2,146,155,808
4207,Will Harris,2008,2010,Total,Total,75,1810,300,678,213,439,87,239,121,176,105,260,365,73,35,7,136,148,808
4208,Lonnie McClanahan,2014,2015,Texas-Arlington,Sun Belt,63,1618,267,596,266,586,1,10,273,368,63,176,239,205,61,2,192,159,808
4209,Dexter Pittman,2008,2010,Texas,Big 12,105,1474,308,493,308,493,0,0,192,312,240,237,477,36,28,114,132,223,808
4210,Rod Rucker,2013,2014,Alabama-Birmingham,CUSA,63,2009,318,728,317,713,1,15,171,267,163,319,482,138,50,36,147,159,808
4211,Liam Thomas,2014,2017,Nicholls State,Southland,119,2690,311,549,290,469,21,80,165,274,210,373,583,188,56,295,196,360,808
4212,Kendrick Washington,2010,2014,Total,Total,111,2620,295,614,290,590,5,24,213,341,200,357,557,112,79,59,170,326,808
4213,Jheryl Wilson,2010,2011,NJIT,GWC,59,1947,292,696,197,427,95,269,129,210,84,210,294,142,61,8,146,119,808
4214,Anson Winder,2012,2015,Brigham Young,WCC,129,2126,267,582,167,299,100,283,174,248,33,214,247,170,107,13,91,180,808
4215,Tevin Broyles,2014,2017,New Orleans,Southland,108,2446,271,632,236,506,35,126,230,348,86,229,315,182,97,11,237,264,807
4216,Damon Collins,2014,2017,Howard,MEAC,123,3497,267,703,242,594,25,109,248,361,110,385,495,210,118,21,313,249,807
4217,Marcus Landry,2008,2009,Wisconsin,Big Ten,69,2090,312,644,264,511,48,133,135,193,118,227,345,101,41,62,119,150,807
4218,Kevin Little,2015,2019,Total,Total,69,1896,285,775,137,351,148,424,89,117,22,123,145,205,74,2,160,127,807
4219,Anthony McDonald,2014,2015,Total,Total,65,1970,252,634,73,151,179,483,124,158,29,98,127,69,45,1,92,111,807
4220,Tyler Peterson,2017,2019,South Dakota,Summit,99,2425,297,659,239,431,58,228,155,204,81,286,367,161,79,20,137,252,807
4221,Jamar Gulley,2012,2014,Missouri State,MVC,65,1682,298,626,254,491,44,135,166,234,126,270,396,92,86,15,97,204,806
4222,Earvin Morris,2013,2016,Total,Total,84,1677,276,611,170,327,106,284,148,218,24,174,198,97,57,23,112,176,806
4223,Garrick Sherman,2010,2014,Total,Total,131,2024,342,627,342,627,0,0,122,194,167,309,476,54,44,53,165,210,806
4224,Blake Smith,2010,2013,Radford,Big South,115,2580,289,764,189,456,100,308,128,188,87,292,379,199,183,49,180,207,806
4225,Dave Sobolewski,2012,2015,Northwestern,Big Ten,123,3194,236,647,117,268,119,379,215,307,32,222,254,334,88,22,158,285,806
4226,Mark Socoby,2008,2009,Maine,AEC,60,2094,228,613,83,195,145,418,205,281,31,259,290,144,89,21,162,119,806
4227,Kaleb Wesson,2018,2019,Ohio State,Big Ten,65,1512,274,522,244,433,30,89,228,313,153,231,384,95,51,42,107,197,806
4228,Will Archambault,2008,2010,Davidson,Southern,102,2152,293,708,165,333,128,375,91,150,130,230,360,142,41,20,120,183,805
4229,Martin Hermannsson,2015,2016,Long Island University,NEC,61,2061,244,566,186,386,58,180,259,296,43,206,249,246,82,13,141,148,805
4230,Greg Malinowski,2015,2019,Total,Total,128,2320,276,643,124,253,152,390,101,136,83,319,402,155,59,15,137,196,805
4231,Anthony Myers,2011,2014,Robert Morris,NEC,137,3367,263,677,181,421,82,256,197,268,125,242,367,449,148,2,232,225,805
4232,Dwayne Smith,2010,2013,George Washington,A-10,120,1940,305,720,264,593,41,127,154,257,218,216,434,62,74,54,146,201,805
4233,P.J. Thompson,2015,2018,Purdue,Big Ten,137,3229,248,567,87,168,161,399,148,185,71,168,239,294,124,4,100,232,805
4234,Brian Voelkel,2011,2014,Vermont,AEC,134,4134,233,576,203,468,30,108,309,485,329,839,1168,679,207,27,295,239,805
4235,Will Weeks,2013,2017,North Carolina-Asheville,Big South,111,2883,309,566,309,566,0,0,187,346,210,326,536,211,106,21,174,207,805
4236,Garrius Adams,2010,2014,Miami (FL),ACC,120,2976,261,708,156,348,105,360,177,267,92,303,395,197,113,20,161,172,804
4237,Gary Browne,2012,2015,West Virginia,Total,129,2774,236,614,163,374,73,240,259,359,115,241,356,241,136,3,182,240,804
4238,Michael Dison,2012,2015,Montana State,Big Sky,115,2234,282,733,174,428,108,305,132,196,77,203,280,162,93,5,141,225,804
4239,Mike Fitzgerald,2010,2013,Air Force,MWC,117,2389,261,551,141,246,120,305,162,200,47,249,296,90,61,18,115,204,804
4240,Loren Leath,2008,2009,Sacramento State,Big Sky,56,1535,274,724,161,392,113,332,143,188,32,133,165,49,66,3,124,120,804
4241,Tyler Melville,2011,2014,Dartmouth,Ivy,112,2153,266,658,195,460,71,198,201,258,44,133,177,148,62,15,184,242,804
4242,Adam Wing,2013,2016,Evansville,MVC,127,3328,293,632,244,508,49,124,169,216,104,341,445,240,92,24,186,287,804
4243,Kameron Woods,2012,2015,Butler,Total,136,3315,289,623,277,558,12,65,214,329,272,684,956,148,103,125,188,267,804
4244,Drick Bernstine,2014,2018,Total,Total,106,2859,345,693,343,676,2,17,111,215,176,585,761,241,108,60,223,308,803
4245,DJ Cole,2012,2015,Youngstown State,Horizon,121,3071,260,619,187,408,73,211,210,299,39,245,284,418,133,9,227,198,803
4246,Ross Cummings,2017,2019,Mercer,Southern,73,1624,248,586,86,182,162,404,145,183,22,122,144,80,25,3,91,92,803
4247,David Knudsen,2016,2019,Marist,MAAC,119,2420,279,693,128,259,151,434,94,118,59,208,267,131,68,16,123,149,803
4248,Davon Marshall,2013,2014,Liberty,Big South,67,2097,253,646,80,204,173,442,124,150,18,112,130,173,55,2,120,74,803
4249,Janarius Middleton,2014,2017,Jackson State,SWAC,124,2696,345,717,321,633,24,84,89,144,288,362,650,102,52,43,135,298,803
4250,Brandon Moore,2008,2010,Eastern Washington,Big Sky,89,2233,300,661,300,661,0,0,203,318,197,397,594,41,49,65,155,280,803
4251,Terrell Smith,2008,2011,Pacific,Big West,131,3035,278,678,205,459,73,219,174,252,119,303,422,254,61,15,211,267,803
4252,Dan Werner,2008,2010,Florida,SEC,106,2945,288,703,177,354,111,349,116,149,173,371,544,237,127,34,176,267,803
4253,Cannen Cunningham,2012,2015,Southern Methodist,Total,134,2425,314,603,306,562,8,41,166,234,163,347,510,106,83,131,187,287,802
4254,Ivan Gandia-Rosa,2018,2019,North Florida,A-Sun,66,2080,270,642,135,283,135,359,127,152,32,162,194,397,51,5,187,97,802
4255,Tony Hooper,2008,2010,Louisiana-Monroe,Sun Belt,62,1771,272,698,149,321,123,377,135,203,53,138,191,153,97,11,199,188,802
4256,Nigel Johnson,2014,2018,Total,Total,125,2336,273,715,177,423,96,292,160,237,41,211,252,217,115,4,127,120,802
4257,Devin Peterson,2015,2018,Western Carolina,Southern,127,2749,293,798,241,593,52,205,164,234,44,188,232,283,104,19,204,244,802
4258,Quinton Pippen,2013,2014,Chicago State,Total,63,1876,274,698,116,260,158,438,96,119,49,203,252,147,113,18,119,193,802
4259,Sean Smith,2008,2010,North Carolina-Asheville,Big South,95,2326,261,665,82,222,179,443,101,141,88,220,308,171,62,10,128,131,802
4260,Ben Dillard,2012,2015,Little Rock,Sun Belt,123,2555,223,584,121,296,102,288,253,307,39,157,196,119,60,5,111,223,801
4261,Keon Lewis,2014,2015,Texas-San Antonio,CUSA,56,1736,220,578,159,395,61,183,300,361,36,104,140,159,65,0,133,126,801
4262,Rob McKiver,2008,2008,Houston,CUSA,34,1183,233,588,88,212,145,376,190,215,18,113,131,99,56,2,86,65,801
4263,Balint Mocsan,2017,2019,Idaho State,Big Sky,88,2161,270,607,97,201,173,406,88,123,24,191,215,106,59,15,116,173,801
4264,Tavares Speaks,2012,2013,Liberty,Big South,68,2101,299,674,281,617,18,57,185,231,38,192,230,67,79,6,126,165,801
4265,Julyan Stone,2008,2011,Texas-El Paso,CUSA,138,4261,253,595,201,399,52,196,243,394,97,657,754,714,209,58,264,313,801
4266,Nick Zeisloft,2013,2016,Total,Total,128,2620,259,613,43,81,216,532,67,80,64,219,283,101,46,9,59,206,801
4267,James Currington,2014,2018,Total,Total,96,2236,330,609,330,602,0,7,140,242,239,334,573,47,122,56,143,267,800
4268,Charron Fisher,2008,2008,Niagara,MAAC,29,1084,256,645,187,428,69,217,219,284,92,183,275,34,49,18,89,75,800
4269,Martin Krampelj,2016,2019,Creighton,Big East,89,1547,311,517,276,411,35,106,143,235,140,344,484,58,56,54,92,185,800
4270,Fabijan Krslovic,2015,2018,Montana,Big Sky,132,3215,311,578,311,570,0,8,178,291,237,435,672,177,126,68,175,364,800
4271,Josh Nebo,2016,2019,Total,Total,94,2284,317,545,316,543,1,2,165,272,210,383,593,45,24,213,132,209,800
4272,Taylor Rochestie,2008,2009,Washington State,Pac-10,68,2438,261,618,147,335,114,283,164,193,40,190,230,316,65,1,134,114,800
4273,Greer Wright,2010,2011,Binghamton,AEC,56,1801,258,611,183,374,75,237,209,284,70,223,293,185,64,25,213,177,800
4274,Josten Crow,2008,2011,Sam Houston State,Southland,115,2442,262,584,172,320,90,264,185,279,151,327,478,268,140,25,136,268,799
4275,Jamel Guyton,2009,2010,Louisiana Tech,WAC,67,2170,272,673,137,301,135,372,120,150,49,193,242,138,103,28,121,171,799
4276,Daniel Munoz,2010,2013,American,Patriot,124,3332,258,710,166,440,92,270,191,244,29,225,254,371,70,8,226,214,799
4277,Jaquon Parker,2010,2013,Cincinnati,Big East,113,2355,272,679,186,442,86,237,169,285,159,284,443,137,56,5,117,154,799
4278,Brandon Better,2018,2019,Southern Utah,Big Sky,64,1536,242,648,101,262,141,386,173,206,20,101,121,84,48,2,114,123,798
4279,Anthony Ervin,2010,2013,Saint Francis (PA),NEC,112,2593,284,715,192,437,92,278,138,178,95,217,312,144,87,6,148,205,798
4280,Charlie Harper,2009,2012,Lamar,Southland,106,2408,296,719,282,658,14,61,192,283,195,388,583,130,100,35,138,263,798
4281,Andrew Harrison,2014,2015,Kentucky,SEC,79,2261,222,597,153,409,69,188,285,367,45,168,213,298,61,17,173,189,798
4282,Trejon Jacob,2018,2019,Florida International,CUSA,64,1805,291,636,163,297,128,339,88,147,45,226,271,47,72,18,76,85,798
4283,Harris Mansell,2008,2009,Rider,MAAC,62,1942,253,594,111,241,142,353,150,191,39,176,215,105,65,12,94,138,798
4284,Jeffrey Merritt,2009,2012,Samford,Southern,116,3024,296,645,213,406,83,239,123,232,122,444,566,213,102,28,179,237,798
4285,Tariq Owens,2015,2019,Total,Total,129,2735,315,591,296,523,19,68,149,205,204,397,601,63,61,264,119,349,798
4286,Paul Thomas,2016,2019,Texas-El Paso,CUSA,114,2598,322,680,279,545,43,135,111,204,139,429,568,144,51,40,178,349,798
4287,Ryan Bogan,2008,2009,Longwood,Ind,62,1937,276,723,142,357,134,366,111,141,97,191,288,160,100,3,150,98,797
4288,DeAndre Brown,2010,2011,Louisiana Tech,WAC,62,2063,297,737,206,450,91,287,112,157,36,148,184,186,64,1,181,74,797
4289,Cliff Colimon,2011,2012,Eastern Washington,Big Sky,58,1753,267,660,153,349,114,311,149,189,38,142,180,207,76,5,165,148,797
4290,Carlin Dupree,2014,2017,North Dakota State,Summit,115,2903,301,714,268,581,33,133,162,263,71,300,371,214,116,11,187,179,797
4291,Donald Hicks,2017,2019,Radford,Big South,98,2685,269,727,101,308,168,419,91,117,109,235,344,128,55,5,126,227,797
4292,Nick Sherod,2017,2019,Richmond,A-10,73,1954,296,626,187,329,109,297,96,121,47,226,273,93,58,5,65,123,797
4293,Mardracus Wade,2011,2014,Arkansas,SEC,126,2662,235,569,106,228,129,341,198,253,70,99,169,153,153,9,121,267,797
4294,Karon Abraham,2010,2011,Robert Morris,NEC,58,1560,226,539,82,207,144,332,200,235,34,97,131,81,51,10,109,141,796
4295,Robert Arnold,2010,2011,Boise State,WAC,66,1819,270,632,178,351,92,281,164,237,120,169,289,102,69,45,126,150,796
4296,Braxton Key,2017,2019,Total,Total,96,2380,275,645,209,426,66,219,180,272,139,380,519,170,84,51,179,200,796
4297,Nemanja Mitrovic,2009,2012,Portland,WCC,101,2009,276,675,117,267,159,408,85,102,38,207,245,105,50,6,143,141,796
4298,Moses Morgan,2011,2015,Total,Total,114,2244,276,800,125,339,151,461,93,135,75,175,250,94,57,34,140,181,796
4299,Taylor Smith,2012,2013,Stephen F. Austin,Southland,64,1697,340,488,340,488,0,0,116,272,157,338,495,65,45,132,99,135,796
4300,Donivine Stewart,2012,2016,Total,Total,100,2861,283,673,194,412,89,261,141,218,73,211,284,367,126,4,150,130,796
4301,Tahj Tate,2012,2013,Delaware State,MEAC,56,1960,297,697,236,499,61,198,141,196,65,98,163,137,72,11,148,102,796
4302,Estan Tyler,2012,2015,Total,Total,86,2517,259,653,137,348,122,305,156,192,33,174,207,238,58,3,208,172,796
4303,Dimencio Vaughn,2017,2019,Rider,MAAC,65,1621,275,588,217,413,58,175,188,258,117,251,368,71,111,39,134,160,796
4304,Brendan Barry,2017,2019,Dartmouth,Ivy,81,2449,264,585,105,228,159,357,108,129,16,185,201,243,68,13,102,129,795
4305,Anders Broman,2014,2018,Total,Total,109,2190,246,593,92,194,154,399,149,185,19,151,170,134,69,10,78,164,795
4306,Mark Cisco,2010,2013,Columbia,Ivy,111,2222,326,601,326,601,0,0,143,221,233,358,591,69,36,72,131,263,795
4307,Dane DiLiegro,2008,2011,New Hampshire,AEC,116,3057,315,623,314,620,1,3,164,278,314,540,854,48,58,34,200,371,795
4308,LaVonte Dority,2011,2014,Total,Total,94,1880,242,586,148,344,94,242,217,257,33,101,134,157,44,4,145,127,795
4309,Dante Jackson,2008,2011,Xavier,A-10,137,3342,252,680,80,197,172,483,119,166,51,323,374,255,146,20,193,312,795
4310,Tyler Jones,2017,2019,Maryland-Eastern Shore,MEAC,93,1922,300,701,242,488,58,213,137,191,97,201,298,39,37,52,119,180,795
4311,Jeremiah Kelly,2009,2012,DePaul,Big East,123,3504,284,780,132,314,152,466,75,108,76,193,269,364,152,5,145,217,795
4312,An'Juan Wilderness,2008,2011,Charlotte,A-10,111,2829,300,604,284,533,16,71,179,326,206,235,441,146,87,11,186,251,795
4313,Cecil Williams,2017,2018,Central Michigan,MAC,68,1870,257,545,220,437,37,108,244,312,136,290,426,112,53,45,149,207,795
4314,Sheriff Drammeh,2016,2019,Hawaii,Big West,115,2733,246,672,133,329,113,343,189,254,40,235,275,191,80,8,149,276,794
4315,Leo Goodman,2016,2019,Stetson,A-Sun,121,2104,283,731,141,313,142,418,86,116,99,207,306,62,45,17,85,189,794
4316,John Karhoff,2013,2014,Omaha,Summit,63,1694,312,634,306,609,6,25,164,211,83,171,254,134,43,39,98,213,794
4317,Rashard Odomes,2016,2019,Oklahoma,Big 12,113,2159,303,602,288,558,15,44,173,296,139,200,339,132,60,11,117,178,794
4318,Kenny Onyechi,2010,2013,Long Island University,NEC,126,2235,274,529,274,529,0,0,246,465,220,250,470,28,47,144,159,320,794
4319,Brandon Richardson,2009,2012,Nebraska,Total,119,2810,238,569,150,285,88,284,230,278,22,255,277,235,145,9,154,217,794
4320,Burak Eslik,2016,2017,Southern Illinois-Edwardsville,OVC,58,1890,215,578,129,307,86,271,277,332,17,143,160,89,29,0,103,90,793
4321,Jesse Hunt,2016,2019,Eastern Washington,Big Sky,117,2102,284,600,205,383,79,217,146,197,134,397,531,154,36,51,114,278,793
4322,Jarvis Jones,2009,2013,East Tennessee State,A-Sun,115,2222,290,780,172,399,118,381,95,131,38,151,189,110,104,5,123,132,793
4323,Patrick McCaw,2015,2016,Nevada-Las Vegas,MWC,65,2060,273,622,148,281,125,341,122,162,61,212,273,214,129,23,125,122,793
4324,Chris Oakes,2008,2010,San Jose State,WAC,83,2175,316,567,316,567,0,0,161,250,263,398,661,79,39,111,125,243,793
4325,Juwan Parker,2014,2018,Georgia,SEC,116,2604,259,702,211,511,48,191,227,274,88,370,458,148,62,13,142,199,793
4326,Desmond Ringer,2014,2018,Total,Total,117,2517,299,523,297,518,2,5,193,249,200,336,536,50,24,46,163,278,793
4327,Marvin Roberts,2010,2011,Florida International,Sun Belt,59,1712,272,661,216,453,56,208,193,279,68,198,266,107,63,27,165,134,793
4328,Will Sullivan,2012,2015,Miami (OH),MAC,124,2950,265,587,129,243,136,344,127,166,61,271,332,130,107,4,122,193,793
4329,K.J. Walton,2016,2019,Total,Total,95,1884,276,586,259,522,17,64,224,336,121,181,302,87,94,13,120,163,793
4330,Tony Woods,2009,2013,Total,Total,131,2110,310,569,310,569,0,0,173,298,197,227,424,41,24,128,165,278,793
4331,Nathan Adrian,2014,2017,West Virginia,Big 12,140,2920,284,686,180,352,104,334,120,178,248,268,516,198,134,59,127,358,792
4332,Wade Baldwin,2015,2016,Vanderbilt,SEC,68,2011,234,543,150,344,84,199,240,300,30,247,277,327,90,15,158,171,792
4333,Jeff Elorriaga,2011,2014,Boise State,Total,116,3111,255,607,34,89,221,518,61,78,22,247,269,177,96,3,70,205,792
4334,Junard Hartley,2008,2011,Campbell,A-Sun,121,3536,261,634,218,494,43,140,227,331,103,323,426,600,212,17,342,309,792
4335,Brett James,2008,2009,Elon,Southern,62,1872,295,722,233,508,62,214,140,226,63,260,323,77,74,64,122,131,792
4336,Bryce Jones,2016,2017,Murray State,OVC,64,2027,228,603,137,333,91,270,245,278,37,193,230,245,80,18,140,182,792
4337,Chris Jones,2014,2017,Pittsburgh,ACC,129,2809,280,635,202,390,78,245,154,231,97,201,298,193,50,32,123,249,792
4338,Arkel Lamar,2017,2019,Maryland-Baltimore County,AEC,97,2353,280,721,156,365,124,356,108,184,90,382,472,90,112,41,102,223,792
4339,Korie Lucious,2009,2013,Total,Total,127,2696,265,744,101,256,164,488,98,128,43,147,190,434,81,11,263,172,792
4340,Jordan Potts,2013,2016,Total,Total,86,2233,240,666,104,255,136,411,176,225,27,172,199,240,89,5,161,197,792
4341,Gary Redus,2009,2011,Total,Total,82,1474,265,678,194,461,71,217,191,255,43,135,270,158,76,72,162,124,792
4342,Scott Suggs,2009,2013,Washington,Total,115,2089,278,640,134,281,144,359,92,112,44,136,180,100,39,18,118,171,792
4343,Nicholas Baer,2016,2019,Iowa,Big Ten,129,2530,282,635,142,260,140,375,87,139,199,379,578,169,132,121,99,244,791
4344,T.J. Campbell,2009,2010,Portland,WCC,64,2032,250,539,111,248,139,291,152,173,26,126,152,331,70,7,180,134,791
4345,Tyron Criswell,2015,2016,Nevada,MWC,69,1884,274,576,241,471,33,105,210,297,153,208,361,130,63,25,137,191,791
4346,Alberto Estwick,2009,2012,Fordham,A-10,112,2853,296,801,146,335,150,466,49,80,100,217,317,133,72,16,130,209,791
4347,Malachi Flynn,2017,2018,Washington State,Pac-12,62,2062,266,655,131,277,135,378,124,153,30,167,197,223,70,3,131,115,791
4348,Ray Gallegos,2010,2014,Nebraska,Total,118,2786,292,816,134,299,158,517,49,79,18,209,227,109,90,26,79,167,791
4349,Jermaine Mallett,2010,2011,Missouri State,MVC,71,2263,256,558,175,337,81,221,198,239,121,290,411,175,63,14,141,182,791
4350,Quinn Taylor,2016,2019,Utah State,MWC,130,2676,319,572,274,448,45,124,108,176,237,370,607,175,57,55,114,315,791
4351,Tonny Trocha-Morelos,2015,2018,Texas A&M,SEC,132,2549,302,732,223,477,79,255,108,189,188,339,527,148,62,98,120,237,791
4352,Ash Yacoubou,2012,2016,Total,Total,121,2443,297,727,214,451,83,276,114,192,112,329,441,124,64,19,164,219,791
4353,Ryan Cook,2012,2013,Maryland-Baltimore County,AEC,56,1732,274,660,203,446,71,214,171,202,101,196,297,99,57,21,128,161,790
4354,Olek Czyz,2009,2012,Total,Total,77,1783,289,545,245,424,44,121,168,275,124,259,383,70,39,17,144,130,790
4355,Kyle Downey,2009,2012,Siena,MAAC,111,2383,297,729,227,477,70,252,126,160,80,195,275,151,83,11,173,198,790
4356,Faronte Drakeford,2014,2015,Central Connecticut State,NEC,60,1741,313,692,306,661,7,31,157,211,122,248,370,78,67,22,171,191,790
4357,Antonio Hanson,2009,2010,Georgia Southern,Southern,62,1864,271,670,88,217,183,453,65,79,28,70,98,106,54,1,125,128,790
4358,Detrick Mostella,2015,2019,Total,Total,107,1934,260,730,123,289,137,441,133,175,39,184,223,118,45,16,134,175,790
4359,DaJuan Summers,2008,2009,Georgetown,Big East,64,1809,260,576,157,292,103,284,167,235,69,237,306,89,69,40,148,161,790
4360,Javares Brent,2014,2017,Jackson State,SWAC,124,2590,259,811,40,147,219,664,52,69,41,263,304,84,71,18,103,156,789
4361,Jerry Brown,2010,2014,Total,Total,127,2803,272,552,271,546,1,6,244,409,210,331,541,75,111,84,128,285,789
4362,Reece Chamberlain,2012,2015,Belmont,Total,128,2787,251,559,175,348,76,211,211,304,123,259,382,454,148,16,219,232,789
4363,Dominique Collier,2015,2018,Colorado,Pac-12,121,2438,243,661,117,318,126,343,177,247,32,168,200,221,98,12,176,299,789
4364,Jeylani Dublin,2011,2015,Total,Total,127,1797,344,647,344,647,0,0,101,167,186,222,408,27,50,45,122,221,789
4365,Ollie Jackson,2012,2015,Saint Francis (PA),NEC,118,2658,269,764,107,260,162,504,89,127,55,247,302,145,86,32,191,249,789
4366,Paul Jesperson,2012,2016,Total,Total,127,2848,268,649,91,190,177,459,76,88,37,282,319,78,46,28,96,191,789
4367,Carl Pierre,2018,2019,Massachusetts,A-10,65,2011,273,646,99,236,174,410,69,91,27,117,144,80,35,12,62,141,789
4368,Zoran Talley,2016,2019,Total,Total,105,2179,344,723,333,672,11,51,90,139,97,261,358,150,41,17,102,142,789
4369,DeJuan Wright,2011,2012,Florida International,Sun Belt,51,1673,263,514,228,431,35,83,228,316,136,232,368,76,80,27,139,150,789
4370,Darnell Hugee,2009,2010,Prairie View,SWAC,59,1503,281,553,272,519,9,34,217,375,139,252,391,46,29,92,112,204,788
4371,Tyreke Key,2018,2019,Indiana State,MVC,61,1908,263,573,197,406,66,167,196,257,51,186,237,98,62,9,92,122,788
4372,Cyril Langevine,2017,2019,Rhode Island,A-10,99,2095,294,520,294,518,0,2,200,357,253,411,664,50,51,110,151,274,788
4373,Christian Polk,2008,2011,Total,Total,89,2214,276,682,153,372,123,310,113,142,18,173,191,175,74,9,122,184,788
4374,Ako Adams,2017,2019,Rice,CUSA,98,2255,238,641,91,233,147,408,164,194,17,184,201,225,54,4,195,209,787
4375,Justin Bocot,2009,2012,Southern Illinois,MVC,117,2366,266,709,163,395,103,314,152,222,71,240,311,142,96,16,181,161,787
4376,Troy Franklin,2009,2013,Total,Total,84,2221,242,703,135,343,107,360,196,258,46,153,199,320,142,5,249,240,787
4377,JaMichael Hawkins,2012,2016,Total,Total,88,2058,256,698,115,298,141,400,134,166,30,143,173,80,54,12,129,107,787
4378,Jarvis Haywood,2013,2014,Jacksonville,A-Sun,57,1582,276,579,233,465,43,114,192,254,82,168,250,110,60,13,157,154,787
4379,Levi Knutson,2008,2011,Colorado,Big 12,123,2371,274,601,145,273,129,328,110,131,39,201,240,122,50,4,90,158,787
4380,Shaun Lawton,2013,2016,Maine,AEC,106,2647,255,624,199,439,56,185,221,309,53,279,332,303,183,9,259,274,787
4381,Casey Prather,2011,2014,Florida,SEC,127,2019,308,541,298,509,10,32,161,254,153,223,376,109,81,46,149,199,787
4382,Tyler Rawson,2015,2018,Total,Total,96,2215,269,589,176,322,93,267,156,218,102,371,473,211,57,84,148,206,787
4383,J-Mychal Reese,2016,2017,North Texas,CUSA,61,1888,270,634,202,444,68,190,179,240,27,154,181,210,51,0,169,143,787
4384,Justin Anyijong,2008,2011,Toledo,MAC,123,2618,301,733,196,412,105,321,79,121,144,351,495,58,47,65,139,207,786
4385,Patrick Holloway,2013,2016,George Mason,Total,100,1912,286,746,144,351,142,395,72,97,30,90,120,62,54,1,91,158,786
4386,Duop Reath,2017,2018,Louisiana State,SEC,64,1659,324,615,294,535,30,80,108,175,129,239,368,47,31,78,121,186,786
4387,Isaiah Roby,2017,2019,Nebraska,Big Ten,97,2319,280,588,231,442,49,146,177,252,155,375,530,143,80,154,154,273,786
4388,Shannon Scott,2012,2015,Ohio State,Big Ten,143,3164,296,730,235,512,61,218,133,201,94,293,387,528,211,22,229,247,786
4389,Aron Baynes,2008,2009,Washington State,Pac-10,68,1791,288,489,287,487,1,2,208,290,133,324,457,31,32,69,107,174,785
4390,Jaycee Carroll,2008,2008,Utah State,WAC,35,1304,267,508,153,279,114,229,137,149,56,153,209,76,33,7,70,65,785
4391,Chris Clover,2016,2019,Saint Joseph's,A-10,116,2421,282,734,203,468,79,266,142,209,61,218,279,94,56,7,96,203,785
4392,Isaac Fotu,2013,2014,Hawaii,Big West,63,1757,308,514,307,503,1,11,168,239,152,237,389,53,19,48,102,133,785
4393,Cory Gensler,2017,2019,Campbell,Big South,103,3175,292,656,144,263,148,393,53,75,74,359,433,147,100,36,70,217,785
4394,Bakari Lewis,2008,2011,Total,Total,84,2012,258,678,168,429,90,249,179,234,42,145,187,209,87,22,190,217,785
4395,Kahiem Seawright,2008,2009,Rhode Island,A-10,67,2005,264,552,264,550,0,2,257,384,195,336,531,142,52,76,159,177,785
4396,Stephen Thomas,2008,2012,Total,Total,116,2582,268,646,193,431,75,215,174,208,45,204,249,222,84,6,134,127,785
4397,Howard Crawford,2008,2010,Alabama-Birmingham,CUSA,98,1915,281,560,270,526,11,34,211,295,129,183,312,32,19,29,115,233,784
4398,Antoine Davis,2019,2019,Detroit Mercy,Horizon,30,1122,263,657,131,310,132,347,126,147,22,72,94,107,28,0,99,70,784
4399,Trent Forrest,2017,2019,Florida State,ACC,106,2515,260,561,249,509,11,52,253,348,104,322,426,331,165,26,168,160,784
4400,Cam Griffin,2012,2015,Denver,Total,102,2552,269,526,253,463,16,63,230,319,137,333,470,191,141,30,158,250,784
4401,Damarcus Harrison,2012,2015,Total,Total,128,2468,276,744,172,410,104,334,128,173,61,244,305,134,80,21,130,186,784
4402,Brandon McPherson,2008,2010,Valparaiso,Horizon,73,1900,258,569,144,289,114,280,154,189,27,121,148,190,41,4,123,186,784
4403,Ty Toney,2014,2017,Total,Total,83,2171,269,663,236,528,33,135,213,308,34,170,204,207,113,19,148,166,784
4404,Mike Douglas,2009,2012,Western Michigan,MAC,115,3162,248,626,199,491,49,135,238,311,41,270,311,477,131,16,263,214,783
4405,Gabriel McCulley,2008,2012,Texas-El Paso,CUSA,134,2564,268,574,197,367,71,207,176,250,165,329,494,132,93,60,141,324,783
4406,Rashad Muhammad,2014,2015,San Jose State,MWC,58,1744,240,644,106,290,134,354,169,210,37,142,179,55,32,4,90,101,783
4407,Jaron Nash,2012,2015,Total,Total,89,1785,318,632,286,523,32,109,115,256,110,260,370,42,70,38,109,151,783
4408,Biko Paris,2008,2011,Boston College,ACC,129,2961,260,633,148,332,112,301,151,211,47,170,217,391,88,6,242,145,783
4409,Chris Patton ,2013,2014,UC-Riverside,Big West,59,1605,319,602,319,600,0,2,145,217,124,204,328,81,35,34,149,161,783
4410,Matt Rose,2016,2019,Total,Total,102,1979,247,607,73,162,174,445,115,153,74,239,313,73,41,14,73,148,783
4411,Brocke Stepteau,2016,2019,Hawaii,Big West,107,2470,237,529,145,293,92,236,217,259,30,140,170,271,37,0,153,173,783
4412,Jonathan Williams,2015,2018,Virginia Commonwealth,A-10,133,2573,276,656,255,569,21,87,210,300,21,196,217,388,111,11,176,181,783
4413,Jo Acuil,2017,2018,Baylor,Big 12,68,1937,320,607,306,562,14,45,128,209,173,346,519,38,30,151,107,174,782
4414,Nate Britt,2014,2017,North Carolina,ACC,151,2650,260,694,179,450,81,244,181,223,42,191,233,300,121,6,168,270,782
4415,Chris Burgess,2013,2016,Appalachian State,Total,121,2712,265,670,133,305,132,365,120,149,37,146,183,271,52,1,159,220,782
4416,JerShon Cobb,2011,2015,Northwestern,Big Ten,94,2390,273,674,174,379,99,295,137,183,37,269,306,153,74,14,122,183,782
4417,C.J. Duff,2017,2019,Western Illinois,Summit,87,2823,287,731,148,375,139,356,69,97,36,178,214,146,64,3,100,193,782
4418,Luke Eddy,2014,2017,Elon,Total,96,2029,252,594,173,353,79,241,199,266,37,190,227,296,81,12,195,130,782
4419,Devonte Hall,2015,2018,Northwestern State,Southland,96,2386,261,676,218,507,43,169,217,297,48,202,250,379,121,9,201,261,782
4420,Trhae Mitchell,2017,2019,South Alabama,Sun Belt,94,2525,295,605,241,477,54,128,138,222,100,425,525,233,78,138,154,215,782
4421,DeShawn Painter,2010,2013,Total,Total,119,2171,298,691,285,650,13,41,173,266,205,326,531,44,24,74,123,243,782
4422,Dane Pineau,2014,2017,Saint Mary's (CA),WCC,126,2388,335,544,315,471,20,73,92,165,221,414,635,111,70,112,106,266,782
4423,Cliff Tucker,2008,2011,Maryland,ACC,131,2180,303,671,223,444,80,227,96,150,93,204,297,169,89,40,126,149,782
4424,Willie Veasley,2008,2010,Butler,Horizon,99,2622,286,590,207,356,79,234,131,214,150,239,389,89,82,31,154,236,782
4425,Kavon Waller,2015,2018,Delaware State,MEAC,121,2727,274,660,121,257,153,403,81,127,102,256,358,129,26,37,149,232,782
4426,John Walton,2012,2016,Total,Total,104,2513,272,607,271,603,1,4,237,374,203,369,572,55,69,51,162,281,782
4427,Chuck Champion,2017,2019,Loyola (MD),Patriot,87,2354,295,780,216,507,79,273,112,158,57,173,230,131,87,6,141,129,781
4428,Tarvin Gaines,2012,2013,Jacksonville State,OVC,58,1599,251,547,197,362,54,185,225,276,95,177,272,35,39,48,74,174,781
4429,Nick Harney,2012,2014,Akron,MAC,89,1686,298,606,272,505,26,101,159,238,100,204,304,77,58,29,151,223,781
4430,Jamie Harris,2008,2010,Drexel,CAA,93,2642,271,695,201,482,70,213,169,219,41,167,208,248,82,11,171,236,781
4431,Derrick Mercer,2008,2009,American,Patriot,65,2442,276,619,215,475,61,144,168,272,37,205,242,273,69,4,168,130,781
4432,Ajdin Penava,2016,2018,Marshall,CUSA,87,1652,281,522,237,371,44,151,175,231,110,334,444,89,48,180,108,282,781
4433,Brandon Riley,2011,2012,South Carolina State,MEAC,60,1593,288,700,199,442,89,258,116,149,41,144,185,78,50,9,157,118,781
4434,Nick Smith,2014,2017,Belmont,OVC,126,1546,262,591,69,106,193,485,64,77,70,134,204,32,21,15,51,177,781
4435,Zarko Valjarevic,2012,2015,Maine,AEC,83,2213,261,670,79,182,182,488,77,104,24,126,150,90,47,4,89,128,781
4436,Bilal Dixon,2010,2013,Total,Total,125,2656,316,602,315,599,1,3,147,255,293,475,768,48,55,179,140,320,780
4437,Evan Fitzner,2016,2019,Total,Total,136,2257,285,621,142,262,143,359,67,88,94,335,429,64,30,32,76,189,780
4438,John Golden,2012,2015,Dartmouth,Ivy,108,3044,266,662,175,375,91,287,157,241,76,286,362,153,90,26,136,216,780
4439,Ethan Jacobs,2011,2015,Total,Total,86,1671,293,595,202,354,91,241,103,136,58,230,288,57,19,59,99,170,780
4440,Torry Johnson,2016,2019,Total,Total,88,2243,237,588,180,417,57,171,249,338,47,145,192,132,66,3,172,196,780
4441,T.J. Maston,2015,2018,Baylor,Big 12,106,1608,319,594,316,574,3,20,139,176,152,228,380,53,42,31,119,169,780
4442,Matija Milin,2016,2019,Fairfield,MAAC,112,2117,302,607,230,382,72,225,104,161,132,286,418,101,37,25,113,235,780
4443,Justin Nabors,2008,2010,Lamar,Southland,60,1662,292,563,274,510,18,53,178,257,200,287,487,86,61,31,162,145,780
4444,Kentwan Smith,2012,2015,Total,Total,90,1900,298,587,252,430,46,157,138,215,153,261,414,92,56,81,152,157,780
4445,Julian Batts,2017,2019,Long Island University,NEC,99,2753,245,611,115,267,130,344,159,202,39,309,348,210,117,18,143,254,779
4446,Jamal Crook,2010,2013,Western Kentucky,Sun Belt,123,2677,297,715,281,646,16,69,169,249,61,226,287,358,124,20,235,220,779
4447,Marcus DeBerry,2016,2019,Total,Total,95,2641,271,783,110,278,161,505,76,96,40,267,307,176,67,18,108,102,779
4448,Ro'ger Guignard,2008,2009,Texas-Arlington,Southland,61,1867,287,691,117,239,170,452,35,47,32,131,163,186,90,3,166,87,779
4449,Sam Hinnant,2008,2009,East Carolina,CUSA,60,1906,243,619,84,201,159,418,134,169,52,150,202,98,30,4,83,90,779
4450,Kevin Huerter,2017,2018,Maryland,Big Ten,65,2072,273,586,135,236,138,350,95,127,53,271,324,196,52,44,126,136,779
4451,Tyere Marshall,2017,2019,Rider,MAAC,93,1824,320,647,320,645,0,2,139,258,204,327,531,77,50,47,105,242,779
4452,Tyler Roberson,2014,2017,Syracuse,ACC,119,2797,317,647,317,637,0,10,145,252,307,414,721,130,75,73,134,229,779
4453,Tom Tankelewicz,2010,2014,Total,Total,113,2020,256,662,77,178,179,484,88,101,68,146,214,73,63,17,101,200,779
4454,C.J. Williams,2009,2012,North Carolina State,ACC,128,2746,315,681,248,463,67,218,82,112,117,220,337,164,78,46,130,211,779
4455,Joseph Bertrand,2011,2014,Illinois,Big Ten,118,2366,314,622,274,506,40,116,110,153,121,247,368,94,67,13,140,212,778
4456,Chris Brady,2014,2017,Monmouth,MAAC,135,2307,328,616,322,590,6,26,116,174,210,415,625,37,49,150,136,306,778
4457,Austin Daye,2008,2009,Gonzaga,WCC,67,1506,275,577,213,430,62,147,166,210,59,327,386,69,45,124,129,176,778
4458,David DuBois,2008,2009,Western Illinois,Summit,57,1857,325,682,307,626,18,56,110,168,124,193,317,76,73,20,110,171,778
4459,L.G. Gill,2014,2017,Total,Total,127,2413,279,666,165,327,114,339,106,156,140,333,473,79,31,50,90,277,778
4460,Kevarrius Hayes,2016,2019,Florida,SEC,140,2727,287,454,287,454,0,0,204,339,290,352,642,53,104,214,132,329,778
4461,Jamel McLean,2009,2011,Xavier,A-10,101,2302,279,517,279,513,0,4,220,376,286,391,677,73,54,81,127,225,778
4462,Charles Minlend,2017,2019,San Francisco,WCC,64,1618,277,667,182,375,95,292,129,198,60,155,215,89,50,23,88,80,778
4463,Russell Powell,2010,2013,Jacksonville,A-Sun,126,3103,261,708,217,549,44,159,212,285,69,194,263,384,109,0,215,241,778
4464,Marcus Relphorde,2008,2011,Total,Total,89,1969,272,647,197,440,75,207,159,217,74,221,295,145,77,11,156,193,778
4465,A.J. Walton,2010,2013,Baylor,Big 12,141,3413,271,676,204,475,67,201,169,259,86,315,401,452,224,9,298,388,778
4466,Shawn Amiker,2012,2015,Youngstown State,Horizon,128,2306,289,580,276,530,13,50,186,288,129,256,385,91,50,25,153,283,777
4467,Matthew Dotson,2008,2009,Belmont,A-Sun,66,1609,279,642,135,262,144,380,75,100,86,192,278,109,34,19,80,131,777
4468,Josh Herbeck,2011,2014,Army,Patriot,109,2144,266,708,69,187,197,521,48,64,41,173,214,99,41,2,101,109,777
4469,Mike McFadden,2010,2014,Total,Total,106,2353,300,589,299,588,1,1,176,293,156,208,364,67,81,48,148,274,777
4470,Terrence Oglesby,2008,2009,Clemson,ACC,66,1446,236,625,59,177,177,448,128,151,40,74,114,99,48,1,101,127,777
4471,Eniel Polynice,2008,2011,Total,Total,99,2354,311,736,279,603,32,133,123,213,108,301,409,330,113,48,204,162,777
4472,Justin Ravenel,2018,2019,Florida A&M,MEAC,65,1968,256,582,89,198,167,384,98,117,21,121,142,72,44,5,55,115,777
4473,Troy Snyder,2010,2014,Total,Total,81,2108,279,645,226,464,53,181,166,251,183,261,444,104,91,35,144,199,777
4474,Marcus Burk,2017,2018,Campbell,Big South,69,1802,269,577,111,184,158,393,80,97,30,177,207,66,59,11,70,109,776
4475,Bryce Canda,2017,2018,Portland State,Big Sky,64,2068,281,668,149,289,132,379,82,115,73,252,325,148,90,10,92,64,776
4476,Sam Iorio,2018,2019,American,Patriot,55,1940,269,599,145,279,124,320,114,142,77,282,359,91,66,49,84,111,776
4477,Simi Socks,2016,2018,Incarnate Word,Southland,82,1686,252,551,210,433,42,118,230,277,87,186,273,52,45,40,157,252,776
4478,Jabari Trotter,2009,2012,Dartmouth,Ivy,112,2836,284,737,182,435,102,302,106,169,40,179,219,164,94,14,155,118,776
4479,Ray Turner,2010,2013,Texas A&M,Total,115,2068,300,561,300,560,0,1,176,289,214,319,533,21,38,65,131,298,776
4480,Devin Ebanks,2009,2010,West Virginia,Big East,69,2217,276,596,268,526,8,70,215,292,192,356,548,176,65,48,142,117,775
4481,Lawrence Hill,2008,2009,Stanford,Pac-10,70,1880,295,636,242,484,53,152,132,185,131,242,373,115,47,27,99,132,775
4482,Matt Massey,2010,2012,Southern Utah,Summit,89,2248,288,577,271,526,17,51,182,239,135,206,341,98,31,27,165,258,775
4483,Nick Weiermiller,2008,2012,Texas-Rio Grande Valley,Total,121,3209,261,694,122,280,139,414,114,152,29,217,246,409,118,1,274,228,775
4484,Gaellen Bewernick,2012,2015,Northern Arizona,Big Sky,129,3329,337,664,318,588,19,76,81,148,213,491,704,142,79,35,185,234,774
4485,Sean Evans,2008,2011,St. John's (NY),Big East,128,2425,311,643,311,642,0,1,152,304,257,339,596,54,81,31,164,265,774
4486,Michael Hale,2012,2013,Texas-San Antonio,Total,61,2013,239,598,136,315,103,283,193,257,26,151,177,214,84,0,140,133,774
4487,Rondae Hollis-Jefferson,2014,2015,Arizona,Pac-12,76,2050,259,522,251,483,8,39,248,356,160,315,475,114,72,72,103,186,774
4488,Luke Meikle,2014,2018,Total,Total,106,2212,280,745,186,451,94,294,120,158,78,292,370,77,41,39,91,196,774
4489,Jordan Roland,2016,2019,Total,Total,104,1904,266,600,122,237,144,363,98,117,37,128,165,111,72,19,59,146,774
4490,Kevin Swecker,2008,2010,Longwood,Ind,81,2250,260,679,103,266,157,413,97,120,40,135,175,165,128,5,87,152,774
4491,Gerdarius Troutman,2015,2018,Total,Total,92,1689,247,637,78,188,169,449,111,136,35,121,156,82,46,7,40,69,774
4492,Luuk van Bree,2016,2019,Bradley,MVC,121,2389,282,694,150,325,132,369,78,115,106,335,441,77,64,51,127,302,774
4493,Steve Zack,2012,2015,La Salle,A-10,123,2875,304,647,303,639,1,8,165,243,265,578,843,131,48,169,177,299,774
4494,Jonathan Amos,2008,2009,Toledo,MAC,60,1799,269,613,244,533,25,80,210,317,69,226,295,164,137,10,240,176,773
4495,Jordan Barnett,2015,2018,Total,Total,80,1924,262,599,135,256,127,343,122,144,99,258,357,59,44,35,90,112,773
4496,Ian Chiles,2012,2015,Total,Total,64,1911,272,645,204,449,68,196,161,219,43,156,199,108,70,33,115,114,773
4497,Taylor Dyson,2013,2016,Hartford,AEC,105,1968,244,670,77,210,167,460,118,144,38,200,238,56,45,6,90,161,773
4498,James Eayrs,2009,2010,Milwaukee,Horizon,65,1651,261,632,168,354,93,278,158,190,140,227,367,95,50,29,105,138,773
4499,Brandon Ellis,2011,2014,Alabama A&M,SWAC,100,2077,275,690,176,386,99,304,124,179,88,150,238,77,60,17,154,162,773
4500,Jaylen Hands,2018,2019,UCLA,Pac-12,64,1810,260,635,151,343,109,292,144,189,30,214,244,282,74,10,162,89,773
4501,Nick Hendra,2008,2011,American,Patriot,109,2777,271,657,166,343,105,314,126,199,82,343,425,275,63,8,211,225,773
4502,Moussa Kone,2012,2015,Hofstra,CAA,123,2475,327,561,327,561,0,0,119,219,240,332,572,47,65,112,110,367,773
4503,Chris Lowe,2008,2009,Massachusetts,A-10,64,2032,279,640,240,525,39,115,176,255,48,151,199,407,80,7,220,156,773
4504,Marlin Mason,2012,2015,Cleveland State,Horizon,113,2389,283,594,213,410,70,184,137,188,159,341,500,97,83,100,171,293,773
4505,Tyshon Pickett,2013,2014,Bradley,MVC,67,1985,300,631,284,580,16,51,157,208,180,256,436,75,69,26,103,199,773
4506,Frederick Scott,2016,2019,Total,Total,66,1526,267,540,207,381,60,159,179,331,111,272,383,67,43,19,107,134,773
4507,Jarod Williams,2014,2017,Detroit Mercy,Horizon,126,2427,264,622,214,457,50,165,195,280,83,259,342,215,110,28,213,245,773
4508,Zach Bailey,2009,2012,Tennessee Tech,OVC,122,2607,237,589,163,369,74,220,224,273,75,201,276,160,113,10,178,287,772
4509,Bo Calhoun,2013,2016,Ball State,MAC,119,2207,301,636,249,483,52,153,118,159,185,420,605,70,59,45,140,258,772
4510,Alihan Demir,2018,2019,Drexel,CAA,60,1844,305,611,262,475,43,136,119,167,104,254,358,145,28,22,131,135,772
4511,Daniel Northern,2008,2009,Tennessee Tech,OVC,61,1806,269,550,265,540,4,10,230,367,175,374,549,39,58,164,123,156,772
4512,Aqeel Quinn,2011,2015,Total,Total,120,2274,250,683,132,341,118,342,154,203,50,187,237,172,87,11,145,189,772
4513,Hunter Williams,2013,2014,Troy,Sun Belt,64,2292,265,721,105,303,160,418,82,122,23,130,153,208,50,2,145,86,772
4514,Dre Wills,2014,2017,Vermont,AEC,112,2290,304,523,299,498,5,25,159,290,121,323,444,188,135,76,161,201,772
4515,Sherman Blanford,2013,2014,Eastern Illinois,OVC,62,1639,277,575,277,571,0,4,217,318,177,268,445,119,69,38,114,156,771
4516,Deion Hammond,2018,2019,Monmouth,MAAC,65,1678,258,653,108,244,150,409,105,150,29,117,146,57,42,14,97,138,771
4517,Leon Powell,2011,2012,Southeast Missouri State,OVC,62,1801,298,486,298,486,0,0,175,340,214,246,460,52,38,91,117,226,771
4518,Carlos Strong,2008,2010,Boston University,AEC,75,2065,261,602,137,292,124,310,125,176,95,204,299,118,83,28,99,192,771
4519,J.J. Thompson,2012,2016,Total,Total,115,2845,266,682,192,464,74,218,165,237,44,157,201,373,89,6,238,235,771
4520,Hunter Ware,2015,2018,Bryant,NEC,123,2547,286,710,189,423,97,287,102,138,59,230,289,147,107,14,154,243,771
4521,Jack Crook,2013,2016,Seattle,WAC,123,2739,306,652,304,641,2,11,156,255,197,422,619,148,50,41,212,353,770
4522,Bruno Fernando,2018,2019,Maryland,Big Ten,64,1692,291,489,287,476,4,13,184,241,145,413,558,89,33,101,148,179,770
4523,Justin Jackson,2011,2014,Cincinnati,Total,136,2740,322,633,320,612,2,21,124,267,261,382,643,166,143,218,212,369,770
4524,Dominic James,2008,2009,Marquette,Big East,64,1970,281,687,203,426,78,261,130,223,56,136,192,298,124,17,129,132,770
4525,Will Kelly,2013,2016,Navy,Patriot,125,2676,298,532,298,532,0,0,174,319,172,384,556,86,44,199,174,337,770
4526,Mike Laster,2015,2018,Ohio,MAC,123,2319,293,615,219,424,74,191,110,157,75,149,224,84,37,8,110,164,770
4527,Phillip Leonard,2014,2016,Mercer,Total,101,2166,247,535,239,482,8,53,268,421,76,243,319,337,52,2,144,205,770
4528,Yves Mekongo Mbala,2008,2010,La Salle,A-10,79,2423,233,547,166,362,67,185,237,325,133,328,461,127,39,35,184,175,770
4529,Marshun Newell,2014,2015,Tennessee-Martin,OVC,65,2033,254,646,159,382,95,264,167,233,85,252,337,198,77,9,153,138,770
4530,Luke Roh,2012,2015,Colgate,Patriot,126,3516,308,579,306,572,2,7,152,252,147,534,681,337,86,31,224,274,770
4531,JaShaun Smith,2017,2019,Longwood,Big South,96,2556,295,640,201,393,94,247,86,151,79,201,280,57,61,71,136,169,770
4532,Ryan Staudacher,2008,2010,Montana,Big Sky,91,2705,273,600,82,178,191,422,33,39,30,133,163,128,50,6,69,150,770
4533,Remy Abell,2012,2016,Total,Total,139,2567,251,555,162,333,89,222,178,236,59,156,215,145,55,6,110,143,769
4534,Jabril Banks,2008,2009,Northern Colorado,Big Sky,61,1663,272,455,267,441,5,14,220,300,116,231,347,34,23,17,111,112,769
4535,Terrance Calvin,2008,2010,Arkansas-Pine Bluff,SWAC,74,2409,249,663,240,621,9,42,262,345,110,258,368,260,99,3,239,219,769
4536,Farad Cobb,2013,2016,Total,Total,91,2126,271,722,119,276,152,446,75,96,44,156,200,140,98,5,93,84,769
4537,Tonye Jekiri,2013,2016,Miami (FL),ACC,139,3053,312,623,311,618,1,5,144,225,306,595,901,97,64,126,142,343,769
4538,Justin Martin,2012,2015,Total,Total,104,2196,262,589,170,316,92,273,153,215,96,315,411,82,71,33,140,226,769
4539,Theo Pinson,2015,2018,North Carolina,ACC,122,2647,261,606,215,427,46,179,201,274,147,389,536,416,96,39,186,212,769
4540,A'Torri Shine,2014,2015,Grambling,SWAC,58,1852,260,641,183,400,77,241,172,230,65,157,222,59,46,12,127,121,769
4541,Marcus Stroman,2015,2019,Total,Total,122,2974,228,579,202,468,26,111,287,416,95,280,375,553,161,22,299,275,769
4542,Jeremy Underwood,2011,2014,North Carolina A&T,MEAC,130,2761,207,634,93,289,114,345,241,348,42,200,242,255,97,2,313,321,769
4543,Isaiah Zierden,2014,2017,Creighton,Big East,114,2545,229,569,58,128,171,441,140,161,16,221,237,153,74,3,68,136,769
4544,Spencer Butterfield,2013,2014,Utah State,Total,61,1827,261,545,144,282,117,263,129,155,108,282,390,158,40,19,102,135,768
4545,Kyle Spain,2008,2009,San Diego State,MWC,56,1495,228,569,129,315,99,254,213,259,96,200,296,75,67,20,113,117,768
4546,Noah States,2008,2011,Furman,Southern,117,2327,291,642,201,404,90,238,96,138,90,309,399,142,41,78,163,245,768
4547,RaShawn Stores,2013,2016,Manhattan,MAAC,124,3127,223,592,80,228,143,364,179,258,58,203,261,314,142,1,173,342,768
4548,Jared Stutzman,2017,2019,Total,Total,91,2146,248,521,111,190,137,331,135,175,25,235,260,112,40,26,86,121,768
4549,Gary Talton,2012,2013,Illinois-Chicago,Horizon,64,2092,251,664,190,456,61,208,205,237,41,196,237,250,66,11,175,111,768
4550,James Towns,2017,2019,Niagara,MAAC,98,1950,241,587,180,403,61,184,225,281,34,173,207,212,55,0,153,109,768
4551,Lorenzo Bonam,2016,2017,Utah,Pac-12,68,1913,283,522,231,380,52,142,149,186,39,176,215,205,80,30,130,118,767
4552,Josh Miller,2008,2010,Army,Patriot,89,2589,263,688,192,445,71,243,170,238,52,304,356,317,133,7,227,188,767
4553,Kouat Noi,2018,2019,Texas Christian,Big 12,64,1663,271,594,138,250,133,344,92,132,92,189,281,60,59,12,76,125,767
4554,Jake Pemberton,2015,2018,Denver,Summit,108,2911,262,587,146,286,116,301,127,154,22,255,277,308,128,14,186,233,767
4555,Jeremi Booth,2008,2011,Appalachian State,Southern,121,2120,265,663,127,255,138,408,98,139,62,220,282,85,66,7,95,137,766
4556,Derreck Brooks,2016,2017,Central Arkansas,Southland,59,1880,280,668,188,417,92,251,114,142,102,297,399,167,58,57,123,166,766
4557,Tasheed Carr,2008,2009,Saint Joseph's,A-10,61,2073,260,607,179,394,81,213,165,235,50,222,272,301,90,7,162,164,766
4558,Ioannis Dimakopoulos,2014,2017,UC-Irvine,Big West,130,1795,312,642,270,520,42,122,100,150,78,254,332,84,23,95,117,204,766
4559,Josh Gantz,2016,2019,Massachusetts-Lowell,AEC,91,2687,285,608,189,331,96,277,100,140,114,249,363,211,84,87,144,290,766
4560,Clevin Hannah,2009,2010,Wichita State,MVC,66,1929,243,535,115,226,128,309,152,185,31,131,162,295,85,3,153,143,766
4561,Lakeem Jackson,2010,2013,South Carolina,SEC,120,3001,343,675,338,650,5,25,75,215,239,332,571,227,119,49,177,215,766
4562,Terrance Woodbury,2008,2009,Georgia,SEC,62,1842,273,685,179,401,94,284,126,157,69,198,267,86,49,14,156,147,766
4563,Ben Woodside,2009,2009,North Dakota State,Summit,33,1137,234,504,167,347,67,157,231,275,9,97,106,204,47,5,104,44,766
4564,Aaron Anderson,2011,2013,Kennesaw State,A-Sun,92,2854,325,616,322,600,3,16,112,246,266,477,743,85,60,46,114,229,765
4565,Trevond Barnes,2016,2019,Hampton,Total,114,2184,275,507,237,400,38,107,177,248,165,328,493,54,24,157,95,303,765
4566,Josh Benson,2010,2013,Dayton,A-10,116,2022,312,558,312,557,0,1,141,221,146,247,393,66,42,65,152,275,765
4567,Josh Brinkley,2010,2013,Delaware,CAA,105,2385,284,541,284,538,0,3,197,304,174,269,443,46,18,49,124,270,765
4568,Kyle Castlin,2015,2019,Total,Total,111,2461,263,586,201,401,62,185,177,236,131,247,378,102,66,22,103,161,765
4569,Kenny Daniels,2009,2010,Cal State Northridge,Big West,62,1477,262,494,222,374,40,120,201,266,80,165,245,96,72,5,168,137,765
4570,Jorge Brian Diaz,2010,2012,Nebraska,Total,81,2061,340,655,340,654,0,1,85,157,132,210,342,75,37,110,131,161,765
4571,Markell Johnson,2017,2019,North Carolina State,ACC,89,2203,271,593,164,318,107,275,116,175,53,171,224,397,105,22,188,187,765
4572,Jabari Sandifer,2014,2017,Western Illinois,Summit,96,2820,248,666,180,448,68,218,201,294,33,266,299,369,118,12,231,250,765
4573,Travis Smith,2012,2013,Mercer,A-Sun,66,1732,246,528,142,287,104,241,169,194,36,140,176,121,52,2,118,149,765
4574,Javier Gonzalez,2008,2011,North Carolina State,ACC,119,2567,252,655,132,305,120,350,140,195,59,204,263,336,123,4,265,210,764
4575,Omari Johnson,2008,2011,Oregon State,Pac-10,120,2496,286,685,202,398,84,287,108,180,154,329,483,89,69,40,159,169,764
4576,Tyrique Jones,2017,2019,Xavier,Big East,103,1729,303,489,303,489,0,0,158,264,219,301,520,54,55,64,102,232,764
4577,David Nurse,2008,2010,Western Illinois,Summit,88,2652,231,613,71,168,160,445,142,181,29,174,203,166,64,5,141,292,764
4578,Kyle Odister,2010,2014,Cal Poly,Big West,115,2059,266,691,90,237,176,454,56,75,42,127,169,128,69,4,97,165,764
4579,Chris Perry,2014,2016,South Florida,AAC,78,1803,302,625,302,618,0,7,160,263,162,320,482,57,35,61,126,220,764
4580,Carson Williams,2017,2018,Northern Kentucky,Horizon,67,1727,291,481,284,460,7,21,175,258,149,237,386,80,47,29,95,100,764
4581,Isaiah Briscoe,2016,2017,Kentucky,SEC,70,2189,295,648,273,552,22,96,151,272,102,274,376,258,65,12,155,188,763
4582,Jeremy Caldwell,2008,2009,Jackson State,SWAC,66,1758,269,488,265,478,4,10,221,304,175,273,448,64,65,63,156,213,763
4583,Junior Hairston,2008,2009,Towson,CAA,61,1921,290,654,241,505,49,149,134,197,162,336,498,75,63,110,100,171,763
4584,Matthew Hezekiah,2013,2014,South Carolina State,MEAC,60,1834,326,591,326,588,0,3,111,158,168,241,409,37,49,59,101,109,763
4585,Connor Lammert,2013,2016,Texas,Big 12,136,3119,281,639,178,309,103,330,98,144,193,488,681,135,56,58,111,292,763
4586,Austin Luke,2015,2018,Belmont,OVC,125,3020,250,594,89,169,161,425,102,138,31,258,289,681,88,5,337,171,763
4587,Dago Pena,2009,2012,Marshall,CUSA,119,2284,263,610,116,228,147,382,90,142,94,183,277,141,78,24,116,140,763
4588,Tyrell Sturdivant,2015,2018,Stony Brook,AEC,130,2246,277,659,247,555,30,104,179,300,205,343,548,105,102,46,150,269,763
4589,Walter Wright,2016,2017,Montana,Big Sky,64,1758,258,647,186,423,72,224,175,212,30,142,172,242,46,2,153,144,763
4590,Daviyon Draper,2015,2016,Florida International,CUSA,62,1925,295,655,253,546,42,109,130,183,77,297,374,103,80,42,148,161,762
4591,Justin Eller,2008,2010,Sacramento State,Big Sky,87,2168,271,637,262,593,9,44,211,318,162,293,455,45,31,33,133,198,762
4592,Lawrence Ghoram,2008,2010,Rice,CUSA,93,2243,277,647,240,547,37,100,171,268,140,196,336,117,67,22,171,245,762
4593,Dan Kimasa,2015,2018,Texas-Rio Grande Valley,WAC,122,2474,298,674,295,650,3,24,163,255,178,387,565,73,37,98,127,303,762
4594,Orion Outerbridge,2009,2012,Rhode Island,A-10,95,1872,304,650,276,562,28,88,126,189,154,230,384,31,32,103,81,160,762
4595,Devon Peltier,2010,2011,Cal State Fullerton,Big West,62,1678,243,562,95,204,148,358,128,147,28,73,101,54,45,2,79,125,762
4596,Marcel Smith,2012,2015,Houston Baptist,Total,112,2739,248,603,130,292,118,311,148,178,53,137,190,276,80,1,168,194,762
4597,Jeremy Hollimon,2016,2017,Troy,Sun Belt,68,1643,247,609,164,368,83,241,184,251,52,139,191,109,52,9,120,140,761
4598,Jerrell Houston,2008,2009,Tennessee State,OVC,60,1719,297,602,285,555,12,47,155,217,133,271,404,103,78,71,185,200,761
4599,Trent Hutchin,2010,2011,Southeastern Louisiana,Southland,60,1524,255,577,98,206,157,371,94,102,15,62,77,43,28,5,74,60,761
4600,Jeremiah Jones,2013,2016,Duquesne,A-10,103,2755,260,661,183,418,77,243,164,247,138,274,412,209,54,8,139,193,761
4601,D.J. McCall,2015,2019,IUPUI,Total,125,3089,268,627,238,520,30,107,195,299,215,353,568,212,129,28,200,257,761
4602,Leonard Mendez,2008,2009,Georgia State,CAA,62,1919,278,661,174,382,104,279,101,139,51,149,200,83,69,10,86,70,761
4603,Ben Richardson,2015,2018,Loyola (IL),MVC,127,3346,260,612,104,228,156,384,85,117,28,274,302,307,139,32,138,278,761
4604,Anthony Tarke,2017,2018,NJIT,A-Sun,60,1617,280,627,212,410,68,217,133,214,96,230,326,87,71,40,129,127,761
4605,Desmond Wade,2009,2013,Total,Total,131,3415,258,739,161,444,97,295,148,211,72,210,282,487,168,15,214,286,761
4606,Chase Adams,2008,2010,Total,Total,89,285,232,551,123,266,109,285,187,253,1,11,254,311,165,4,162,15,760
4607,Mike Best,2012,2016,UC-Irvine,Big West,148,2090,314,687,302,636,12,51,120,165,122,321,443,59,30,95,117,274,760
4608,Evan Bruinsma,2011,2014,Detroit Mercy,Horizon,128,2338,260,543,214,380,46,163,194,264,173,339,512,111,84,55,148,272,760
4609,Roger Franklin,2010,2013,Total,Total,120,2343,301,658,296,636,5,22,153,215,136,334,470,81,76,55,124,257,760
4610,Corey Johnson,2016,2019,Harvard,Ivy,105,2558,255,663,49,117,206,546,44,57,36,220,256,122,44,23,90,184,760
4611,Jimmy Langhurst,2008,2010,Robert Morris,NEC,80,2098,235,546,81,164,154,382,136,163,36,137,173,193,53,1,117,97,760
4612,Shane Larkin,2012,2013,Miami (FL),ACC,68,2131,256,585,155,316,101,269,147,182,35,183,218,245,121,6,142,111,760
4613,Kalob Ledoux,2017,2018,McNeese State,Southland,56,1521,274,628,163,331,111,297,101,129,36,168,204,60,25,5,130,121,760
4614,Lateef McMullan,2010,2013,Total,Total,87,2481,238,632,127,317,111,315,173,235,30,188,218,249,68,2,163,155,760
4615,Tim Meadows,2009,2012,Prairie View,SWAC,123,2847,268,725,175,405,93,320,131,201,127,284,411,136,122,9,161,211,760
4616,Maverick Morgan,2014,2017,Illinois,Big Ten,135,2136,318,587,318,587,0,0,124,177,140,227,367,55,29,63,125,219,760
4617,Jawanza Poland,2011,2013,South Florida,Big East,89,2132,273,700,199,424,74,276,140,196,89,203,292,99,82,33,149,193,760
4618,Yvon Raymond,2010,2013,Saint Peter's,MAAC,118,2558,285,631,268,569,17,62,173,303,155,284,439,184,123,46,200,348,760
4619,Jeff Robinson,2008,2011,Total,Total,88,1935,299,622,249,457,50,165,112,166,139,267,406,38,56,40,77,191,760
4620,Mamadou Seck,2011,2012,Southern Illinois,MVC,63,1911,292,600,292,598,0,2,176,236,152,352,504,127,63,26,118,192,760
4621,Jahmel Taylor,2014,2018,Total,Total,103,2320,238,566,56,145,182,421,102,134,39,222,261,156,79,10,79,189,760
4622,Darius Theus,2010,2013,Virginia Commonwealth,Total,146,3079,277,636,237,475,40,161,166,252,64,171,235,460,236,28,236,316,760
4623,Ore Arogundade,2015,2018,Drake,MVC,125,2641,261,642,145,351,116,291,121,159,84,315,399,123,101,12,127,213,759
4624,Derrick Bruce,2016,2019,Total,Total,85,1890,236,622,104,266,132,356,155,197,24,166,190,149,69,13,132,157,759
4625,Zvonko Buljan,2009,2010,Texas Christian,MWC,62,1721,284,596,231,420,53,176,138,194,129,381,510,121,50,16,196,180,759
4626,Connor Burchfield,2015,2018,William & Mary,CAA,111,1918,259,497,80,144,179,353,62,74,13,198,211,97,48,7,82,124,759
4627,Rob Chubb,2010,2013,Auburn,SEC,99,2191,315,675,315,674,0,1,129,214,185,303,488,63,38,85,178,299,759
4628,Brandon Davis,2008,2009,South Alabama,Sun Belt,66,1651,281,461,281,461,0,0,197,283,169,277,446,62,45,88,123,220,759
4629,Zach Glotta,2016,2019,Austin Peay,OVC,130,2515,239,619,54,128,185,491,96,117,33,126,159,199,90,1,102,192,759
4630,Alex Hobbs,2017,2019,Boise State,MWC,88,2075,290,614,228,436,62,178,117,138,27,201,228,159,42,4,138,123,759
4631,Jer'Vaughn Johnson,2008,2011,Total,Total,81,1874,285,565,274,516,11,49,178,258,140,279,419,72,54,22,143,237,759
4632,Toney McCray,2009,2012,Nebraska,Total,95,2086,291,644,211,423,80,221,97,148,90,280,370,101,87,36,170,202,759
4633,Jalen Poyser,2016,2019,Total,Total,91,2057,244,656,150,357,94,299,177,229,47,164,211,149,56,6,138,143,759
4634,Clint Steindl,2009,2012,Saint Mary's (CA),WCC,122,2513,251,615,66,152,185,463,72,87,78,212,290,102,54,19,76,197,759
4635,Ronnie Boyce III,2016,2017,San Francisco,WCC,61,1206,281,658,203,401,78,257,118,162,48,180,228,89,53,19,102,91,758
4636,Justin Hamilton,2009,2012,Total,Total,96,2091,289,540,286,528,3,12,177,239,230,269,499,45,36,93,101,192,758
4637,Kedren Johnson,2012,2016,Total,Total,106,2293,249,628,159,353,90,275,170,225,27,205,232,260,64,27,199,166,758
4638,Steffan Johnson,2008,2010,Total,Total,62,1869,254,593,116,252,138,341,112,151,23,157,180,250,81,14,160,73,758
4639,Chris Manhertz,2011,2014,Canisius,MAAC,116,2694,268,545,268,543,0,2,222,309,320,469,789,61,67,76,152,349,758
4640,Donovan Mitchell,2016,2017,Louisville,ACC,65,1689,265,634,167,336,98,298,130,165,71,198,269,145,95,20,86,166,758
4641,Lamar Morgan,2018,2019,Coppin State,MEAC,64,1979,239,630,68,138,171,492,109,144,30,265,295,30,44,11,113,150,758
4642,Barrington Stevens,2013,2016,South Alabama,Sun Belt,125,3481,259,690,149,373,110,317,130,179,45,232,277,300,75,10,198,244,758
4643,Travis Charles,2016,2018,Albany (NY),AEC,72,1582,301,523,301,523,0,0,155,208,107,203,310,39,22,21,89,196,757
4644,Aaron Cook,2017,2019,Southern Illinois,MVC,97,2375,248,612,165,371,83,241,178,257,29,150,179,238,119,26,181,139,757
4645,Daniel Dingle,2013,2017,Temple,Total,121,2657,246,659,149,348,97,311,168,269,109,251,360,220,58,55,151,215,757
4646,Henry Dugat,2008,2009,Baylor,Big 12,71,1989,261,625,182,395,79,230,156,207,47,207,254,134,106,14,119,142,757
4647,Urule Igbavboa,2008,2009,Valparaiso,Horizon,66,1896,260,503,247,454,13,49,224,362,102,336,438,125,47,47,148,188,757
4648,Markus Terry,2014,2016,Presbyterian,Big South,93,2344,265,631,199,422,66,209,161,227,40,178,218,124,46,8,121,124,757
4649,Greg Tucker,2013,2017,Total,Total,93,2143,207,612,89,246,118,366,225,280,32,127,159,146,54,3,139,164,757
4650,Jaylen Bond,2012,2016,Total,Total,120,2590,339,723,325,645,14,78,64,166,305,456,761,87,106,60,104,312,756
4651,Kevin Burwell,2009,2012,Mississippi Valley State,SWAC,122,2939,237,693,138,350,99,343,183,256,44,231,275,374,97,2,274,265,756
4652,Brad Davison,2018,2019,Wisconsin,Big Ten,67,2124,239,605,127,287,112,318,166,204,20,167,187,145,76,3,93,188,756
4653,Menno Dijkstra,2016,2019,UC-Riverside,Big West,125,2110,309,613,246,443,63,170,75,92,145,253,398,71,39,65,83,209,756
4654,Kenny Gabriel,2010,2012,Auburn,SEC,83,1963,283,663,198,392,85,271,105,156,125,310,435,53,64,105,133,187,756
4655,Kyle Gaillard,2010,2014,William & Mary,CAA,127,2934,285,594,205,372,80,222,106,177,109,320,429,169,57,24,109,228,756
4656,Brandon Gfeller,2014,2017,Montana,Big Sky,125,2318,238,599,35,78,203,521,77,105,47,181,228,90,71,15,76,259,756
4657,Duane Gibson,2014,2018,Evansville,MVC,123,2861,277,584,277,581,0,3,202,291,61,305,366,396,113,45,283,348,756
4658,Charles Hinkle,2009,2012,Total,Total,90,1659,230,584,121,291,109,293,187,226,54,196,250,85,50,18,108,139,756
4659,Robert Lewandowski,2009,2012,Texas Tech,Big 12,126,2312,323,631,322,627,1,4,109,170,112,336,448,98,33,101,151,295,756
4660,Andy Polka,2008,2011,Loyola (IL),Horizon,103,3012,281,616,260,537,21,79,173,296,283,476,759,216,70,40,177,235,756
4661,Markel Humphrey,2008,2009,Marshall,CUSA,59,1892,265,523,225,403,40,120,185,274,129,193,322,95,51,22,88,107,755
4662,Marcus Lee,2014,2018,Total,Total,132,2254,326,533,326,533,0,0,103,206,253,336,589,67,36,151,142,304,755
4663,Naji Marshall,2018,2019,Xavier,Big East,68,1950,262,602,199,386,63,216,168,229,71,321,392,169,60,17,164,148,755
4664,Chris Matthews,2009,2010,St. Bonaventure,A-10,61,2081,256,668,74,164,182,504,61,78,23,175,198,159,35,7,127,120,755
4665,Tony Mitchell,2012,2013,North Texas,Sun Belt,55,1713,258,526,210,385,48,141,191,272,136,375,511,62,51,157,143,163,755
4666,Kevin Parrom,2010,2013,Arizona,Total,110,2257,259,557,163,304,96,253,141,196,139,293,432,204,59,27,116,195,755
4667,Kyle Riley,2008,2011,Howard,MEAC,95,2426,275,699,194,389,81,310,124,201,39,148,187,216,93,6,203,146,755
4668,Stevie Taylor,2012,2015,Ohio,MAC,137,2322,269,737,163,374,106,363,111,167,35,168,203,246,122,6,151,187,755
4669,Zeke Upshaw,2011,2014,Total,Total,95,1583,230,588,122,261,108,327,187,250,46,134,180,78,34,8,112,100,755
4670,Cedrick Bowen,2012,2015,Charleston Southern,Big South,118,2129,312,523,311,516,1,7,129,203,203,229,432,51,61,53,83,182,754
4671,Kenny Chery,2014,2015,Baylor,Big 12,66,2008,250,619,159,361,91,258,163,190,27,161,188,293,74,2,152,110,754
4672,Jesse Chuku,2014,2016,Lehigh,Patriot,94,2481,268,652,144,321,124,331,94,135,133,336,469,80,44,110,93,213,754
4673,Blake Francis,2017,2018,Wagner,NEC,60,1621,246,574,101,218,145,356,117,148,40,58,98,85,70,1,69,147,754
4674,Byron Frohnen,2017,2019,Texas-San Antonio,CUSA,100,2885,313,611,308,572,5,39,123,218,219,471,690,181,91,34,128,213,754
4675,DaVon Haynes,2013,2014,Arkansas-Pine Bluff,SWAC,61,1812,284,572,271,521,13,51,173,281,145,254,399,62,76,43,137,179,754
4676,Mike Holmes,2008,2011,Total,Total,74,1764,314,635,312,631,2,4,124,238,200,298,498,37,72,65,82,176,754
4677,Maurice Joseph,2009,2010,Vermont,AEC,68,1728,229,575,110,252,119,323,177,206,34,137,171,67,36,12,82,111,754
4678,Dominique Matthews,2016,2019,Illinois-Chicago,Horizon,84,1656,252,673,129,319,123,354,127,179,47,148,195,88,46,13,111,136,754
4679,Malik Monk,2017,2017,Kentucky,SEC,38,1218,251,558,147,296,104,262,148,180,12,83,95,87,36,19,75,72,754
4680,Garrett Nevels,2014,2015,Hawaii,Big West,63,1969,287,653,180,371,107,282,73,95,50,192,242,97,49,28,65,138,754
4681,Calvin Newell ,2011,2014,Total,Total,91,2135,261,653,169,343,92,310,140,217,41,122,163,204,101,6,175,126,754
4682,Kaheem Ransom,2014,2015,Sam Houston State,Southland,70,2082,216,592,97,251,119,341,203,264,66,232,298,267,95,9,145,179,754
4683,Addison Spruill,2014,2015,North Carolina-Wilmington,CAA,64,1683,275,679,244,547,31,132,173,244,90,232,322,84,47,23,111,144,754
4684,Elliot Williams,2009,2010,Total,Total,68,1696,234,515,165,315,69,200,217,302,54,158,212,151,66,5,129,127,754
4685,DelFincko Bogan,2016,2019,Total,OVC,92,2205,272,604,156,304,116,300,93,110,48,176,224,222,119,15,137,165,753
4686,Jordan Cyphers,2009,2013,Total,Total,101,1786,215,569,92,218,123,351,200,246,47,103,150,59,46,22,102,150,753
4687,Traylin Farris,2015,2018,Total,Total,82,1702,303,534,301,525,2,9,145,252,140,227,367,48,59,70,69,256,753
4688,Courtney Fortson,2009,2010,Arkansas,SEC,47,1551,251,632,195,452,56,180,195,288,74,178,252,275,58,6,220,126,753
4689,Niyi Harrison,2010,2013,Santa Clara,WCC,128,2192,275,537,275,537,0,0,203,340,200,319,519,24,53,59,165,284,753
4690,Maurice Jones,2011,2012,Southern California,Total,66,2393,256,729,163,439,93,290,148,225,27,146,173,221,125,1,147,111,753
4691,Demetrius McReynolds,2016,2017,Eastern Illinois,OVC,56,1530,266,587,158,294,108,293,113,138,83,196,279,100,40,4,57,97,753
4692,Dante Thorpe,2018,2019,Northern Illinois,MAC,61,1846,292,552,248,441,44,111,125,163,47,137,184,131,61,8,115,140,753
4693,John Vaughan,2008,2009,George Mason,CAA,65,2130,261,618,169,357,92,261,139,187,51,226,277,124,54,26,126,128,753
4694,Ron Anderson,2008,2012,Total,Total,133,2686,279,528,279,525,0,3,194,362,306,389,695,129,70,70,155,307,752
4695,B.J. Glasford,2014,2018,Stetson,A-Sun,125,2338,285,750,189,431,96,319,86,133,56,256,312,142,102,21,132,246,752
4696,Justin Jaworski,2018,2019,Lafayette,Patriot,59,1751,245,515,99,199,146,316,116,135,22,127,149,131,33,3,95,113,752
4697,Isaac Johnson,2017,2019,Appalachian State,Sun Belt,94,2368,259,515,244,432,15,83,219,344,225,519,744,141,89,45,156,224,752
4698,Darius Leonard,2011,2015,Total,Total,127,2177,306,674,233,460,73,214,67,111,155,249,404,70,50,31,83,218,752
4699,Javier Martinez,2014,2017,Tennessee-Martin,OVC,116,1924,319,475,319,475,0,0,114,153,227,285,512,65,29,29,95,206,752
4700,Amadou Sidibe,2013,2017,Fairfield,MAAC,119,2701,302,587,302,587,0,0,148,227,288,567,855,97,58,38,155,351,752
4701,Nate Sikma,2012,2015,Hartford,AEC,112,2663,265,703,146,294,119,409,103,148,107,364,471,228,82,44,205,272,752
4702,Maurice Walker,2011,2015,Minnesota,Big Ten,107,1704,285,517,283,512,2,5,180,266,173,283,456,70,83,81,145,220,752
4703,Ian Francis,2010,2013,Alcorn State,SWAC,119,2720,273,613,273,608,0,5,205,346,185,413,598,86,99,78,193,299,751
4704,Lance Goulbourne,2009,2012,Vanderbilt,SEC,122,2527,243,552,189,372,54,180,211,305,171,452,623,110,87,68,170,215,751
4705,Julius Ingram,2008,2011,Southern,SWAC,106,1935,296,553,288,523,8,30,151,240,126,228,354,62,46,36,172,161,751
4706,Andrew Jones,2008,2011,Penn State,Big Ten,134,3309,301,551,301,551,0,0,149,239,263,418,681,59,47,36,155,333,751
4707,Kevin Kanaskie,2008,2009,Middle Tennessee,Sun Belt,64,2276,206,552,83,198,123,354,216,263,30,237,267,226,70,1,137,137,751
4708,Jeff Kari,2008,2010,Lafayette,Patriot,92,2205,225,560,118,269,107,291,194,261,51,201,252,194,93,9,159,139,751
4709,Charlon Kloof,2012,2014,St. Bonaventure,A-10,94,2504,236,550,174,357,62,193,217,303,36,200,236,310,90,29,173,261,751
4710,Tyler Les,2011,2015,UC-Davis,Big West,119,2525,235,533,26,59,209,474,72,85,20,141,161,147,39,0,100,130,751
4711,Ed Nixon,2008,2011,Virginia Commonwealth,CAA,140,2728,266,633,181,392,85,241,134,184,98,174,272,184,111,33,153,290,751
4712,Timajh Parker-Rivera,2013,2016,Towson,CAA,132,3120,271,536,271,528,0,8,209,382,311,376,687,100,79,128,141,334,751
4713,Diago Quinn,2016,2019,Monmouth,MAAC,136,2058,266,534,266,533,0,1,219,321,206,311,517,17,28,77,127,369,751
4714,Bryan Alberts,2016,2019,Total,Total,114,2170,269,713,108,271,161,442,51,69,36,143,179,86,59,16,63,128,750
4715,Tony Armstrong,2014,2017,Alabama State,SWAC,86,1820,285,588,285,588,0,0,180,289,138,272,410,54,35,56,102,216,750
4716,Omar Calhoun,2013,2016,Connecticut,Total,125,2355,243,641,127,280,116,361,148,193,75,190,265,100,62,29,131,122,750
4717,Nnanna Egwu,2012,2015,Illinois,Big Ten,136,3246,316,722,300,660,16,62,102,144,272,358,630,73,67,201,134,379,750
4718,Jarvis Garner,2012,2013,Central Arkansas,Southland,57,1495,280,654,200,423,80,231,110,160,92,280,372,68,51,27,125,141,750
4719,De'Jon Jackson,2008,2010,San Diego,WCC,82,2576,264,651,194,443,70,208,152,207,62,201,263,204,90,26,146,187,750
4720,Cameron Jones,2015,2016,Radford,Big South,65,1504,280,609,160,311,120,298,70,98,80,154,234,62,31,19,89,115,750
4721,Eddie Keith,2015,2018,Towson,CAA,127,2796,266,604,211,436,55,168,163,291,134,299,433,201,86,89,162,343,750
4722,Marek Olesinski,2012,2015,Air Force,MWC,102,2234,265,578,142,252,123,326,97,134,98,262,360,121,47,21,103,181,750
4723,Tyler Smithpeters,2014,2018,Southern Illinois,MVC,126,2779,217,563,70,178,147,385,169,236,50,278,328,185,110,21,169,298,750
4724,Chad Troyer,2008,2009,Pacific,Big West,64,1858,248,590,93,202,155,388,99,124,23,122,145,99,35,1,89,97,750
4725,L.D. Williams,2008,2010,Wake Forest,ACC,88,2514,280,613,242,461,38,152,152,234,133,225,358,117,102,22,142,241,750
4726,Garrett Williamson,2008,2010,Saint Joseph's,A-10,97,2931,236,528,218,454,18,74,260,364,66,258,324,354,142,88,208,265,750
4727,Tevin Falzon,2013,2016,Sacred Heart,NEC,107,2273,237,641,214,538,23,103,252,339,281,363,644,87,51,98,129,240,749
4728,DeAndre Mays,2009,2010,Youngstown State,Horizon,60,1898,251,686,179,482,72,204,175,247,64,161,225,207,54,16,168,160,749
4729,Chance Murray,2014,2018,Total,Total,106,2217,252,703,184,459,68,244,177,264,41,309,350,223,91,17,156,140,749
4730,Michael Rogers,2008,2011,Valparaiso,Horizon,129,2467,291,634,209,374,82,260,85,132,145,293,438,102,79,13,144,196,749
4731,Adrian Thomas,2008,2011,Miami (FL),ACC,105,2322,250,615,46,96,204,519,45,63,95,212,307,105,60,18,103,230,749
4732,Trevon Allen,2017,2019,Idaho,Big Sky,96,2083,261,657,165,371,96,286,130,168,20,242,262,191,41,10,138,116,748
4733,Dominique Archie,2008,2010,South Carolina,SEC,68,2046,280,557,229,409,51,148,137,205,170,240,410,74,91,67,118,187,748
4734,Larry Austin,2015,2019,Total,Total,118,1890,285,592,279,568,6,24,172,307,96,205,301,278,106,6,176,175,748
4735,Zach Haney,2016,2019,Boise State,MWC,125,2095,310,599,288,510,22,89,106,198,200,304,504,62,50,63,116,282,748
4736,Tyler Hines,2009,2012,Maryland-Eastern Shore,MEAC,119,2538,307,602,307,600,0,2,134,243,348,348,696,60,43,34,167,364,748
4737,John Holmes,2008,2009,Bethune-Cookman,MEAC,63,1771,254,493,254,489,0,4,240,376,122,241,363,79,62,32,154,210,748
4738,Chrishawn Hopkins,2011,2015,Total,Horizon,112,2309,246,627,171,400,75,227,181,241,31,202,233,197,65,7,189,155,748
4739,Bo Ingram,2011,2012,Texas-Arlington,Southland,62,1613,248,582,135,262,113,320,139,183,85,202,287,43,45,5,127,186,748
4740,Jason Johnson,2008,2009,South Carolina State,MEAC,59,1438,279,476,279,474,0,2,190,362,185,279,464,48,54,87,125,145,748
4741,Tre Lynch,2011,2015,Total,Total,90,1534,253,615,156,322,97,293,145,194,57,157,214,85,62,8,93,133,748
4742,Ricky Madison,2016,2019,High Point,Big South,117,2337,280,551,273,514,7,37,181,281,248,384,632,69,44,34,155,246,748
4743,Stevie Mejia,2009,2013,Total,Total,128,2786,225,634,150,412,75,222,223,326,43,199,242,384,154,3,234,282,748
4744,Roscoe Smith,2011,2014,Total,Total,105,2545,269,595,235,473,34,122,176,252,226,436,662,43,37,92,103,196,748
4745,Jay Threatt,2008,2012,Total,Total,89,3026,253,637,190,421,63,216,179,241,86,220,306,460,253,15,172,150,748
4746,Donald Boone,2009,2011,Arkansas State,Sun Belt,63,1915,268,652,184,389,84,263,127,162,57,178,235,117,111,5,123,121,747
4747,Jalen Bradley,2014,2017,Total,Summit,74,1950,270,626,178,383,92,243,115,140,42,153,195,188,73,2,90,87,747
4748,Mike Burwell,2010,2014,Total,Total,117,2269,246,642,142,319,104,323,151,224,86,204,290,121,45,33,139,232,747
4749,Chris Evans,2011,2014,Sacred Heart,NEC,79,2025,244,574,215,482,29,92,230,329,84,184,268,140,66,15,149,170,747
4750,Jonathan Hall,2009,2010,St. Bonaventure,A-10,58,1937,303,595,291,549,12,46,129,211,123,229,352,197,75,38,163,154,747
4751,Andrew Henke,2008,2009,Air Force,MWC,61,1796,243,526,112,217,131,309,130,180,22,241,263,118,37,14,136,167,747
4752,Garrius Holloman,2011,2012,Bethune-Cookman,MEAC,69,1916,320,638,307,592,13,46,94,161,145,296,441,118,68,42,126,198,747
4753,Joey Mundweiler,2008,2009,Wagner,NEC,61,1910,252,629,77,160,175,469,68,106,14,91,105,107,40,9,96,105,747
4754,Wesley Alcegaire,2013,2017,Total,Total,88,1824,269,637,170,350,99,287,109,163,65,164,229,67,40,24,112,169,746
4755,Jamar Diggs,2010,2011,Wofford,Southern,68,1925,236,566,186,428,50,138,224,295,28,178,206,192,96,45,130,179,746
4756,Tom Droney,2011,2014,Davidson,Southern,132,3208,254,585,198,385,56,200,182,252,103,351,454,315,72,8,197,259,746
4757,Akeem Ellis,2011,2012,Coppin State,MEAC,60,1922,249,584,146,306,103,278,145,241,71,263,334,167,39,16,155,143,746
4758,James Gallman,2010,2013,Middle Tennessee,Sun Belt,130,2269,241,604,97,223,144,381,120,163,30,121,151,126,49,0,116,210,746
4759,Bobby Moorehead,2016,2019,Montana,Big Sky,134,3276,254,690,86,194,168,496,70,105,72,440,512,134,83,57,112,276,746
4760,Jeremy Pargo,2008,2009,Gonzaga,WCC,67,2139,287,588,242,441,45,147,127,185,37,201,238,366,93,14,192,128,746
4761,Charlie Reddick,2011,2014,Furman,Southern,104,2209,250,609,135,279,115,330,131,181,103,330,433,132,91,39,144,237,746
4762,Nate Renfro,2016,2019,San Francisco,WCC,132,2877,293,610,247,429,46,181,114,266,200,401,601,188,105,123,180,358,746
4763,Joe Seymore,2008,2010,Central Connecticut State,NEC,90,2203,262,695,139,310,123,385,99,129,86,241,327,109,45,23,121,118,746
4764,Matt Smith,2013,2017,Total,Total,88,2033,290,564,290,557,0,7,166,312,201,245,446,36,77,86,122,282,746
4765,Josh Terry,2011,2012,Austin Peay,OVC,65,1989,282,597,280,580,2,17,180,263,103,166,269,127,121,7,130,164,746
4766,Zion Williamson,2019,2019,Duke,ACC,33,990,296,435,272,364,24,71,130,203,116,177,293,68,70,59,78,68,746
4767,Roderick Bobbitt,2015,2016,Hawaii,Big West,68,2280,219,571,137,299,82,272,225,292,67,196,263,367,168,13,188,188,745
4768,Javoris Bryant,2010,2013,Bethune-Cookman,MEAC,119,2618,274,642,274,637,0,5,197,280,135,344,479,95,89,54,131,277,745
4769,Bryce Dulin,2015,2018,Navy,Patriot,117,2344,252,620,159,336,93,284,148,227,89,209,298,141,58,19,145,190,745
4770,Jerome Garrison,2014,2015,Grand Canyon,WAC,62,1982,215,488,144,293,71,195,244,326,54,137,191,104,27,20,92,158,745
4771,Khadeem Lattin,2015,2018,Oklahoma,Big 12,134,2598,293,545,293,542,0,3,159,237,248,439,687,61,116,235,110,374,745
4772,Justin Mitchell,2015,2018,Wright State,Horizon,99,2224,285,586,277,549,8,37,167,253,121,392,513,236,108,28,198,205,745
4773,Franz Rassman,2013,2016,Loyola (MD),Total,124,2375,299,626,274,547,25,79,122,178,136,317,453,71,53,69,132,307,745
4774,Robert Sampson,2011,2015,Total,Total,127,2687,284,634,216,406,68,228,109,194,237,519,756,85,89,122,150,304,745
4775,Greg Smith,2010,2011,Fresno State,WAC,64,1855,287,499,287,498,0,1,171,303,146,298,444,94,62,75,126,180,745
4776,Eric Tramiel,2009,2010,North Texas,Sun Belt,60,1557,265,472,251,426,14,46,201,321,126,255,381,43,29,42,103,174,745
4777,Ronnie Harrell,2016,2019,Total,Total,114,2052,258,611,177,379,81,232,147,198,90,382,472,183,55,24,151,144,744
4778,Saben Lee,2018,2019,Vanderbilt,SEC,64,1899,240,521,192,377,48,144,216,311,36,166,202,221,72,10,159,140,744
4779,Chas McFarland,2008,2010,Wake Forest,ACC,92,2039,264,542,262,524,2,18,214,325,212,358,570,55,47,112,159,272,744
4780,Joshua Montgomery,2011,2014,Savannah State,Total,94,2163,249,609,177,359,72,250,174,242,133,271,404,54,77,14,116,198,744
4781,Landry Nnoko,2013,2016,Clemson,ACC,128,2632,300,573,300,573,0,0,144,229,237,369,606,65,26,212,146,312,744
4782,Ivory White,2009,2012,Alabama State,SWAC,114,2891,269,665,159,330,110,335,96,152,181,372,553,152,118,63,113,226,744
4783,C.J. Anderson,2008,2009,Xavier,A-10,72,1918,268,553,267,548,1,5,206,327,158,253,411,141,57,27,164,170,743
4784,Lawrence Cooks,2014,2017,Hampton,MEAC,110,2282,229,597,108,259,121,338,164,202,49,257,306,150,67,6,131,194,743
4785,Shane Dansby,2008,2009,Belmont,A-Sun,63,1698,278,572,188,324,90,248,97,148,122,206,328,63,45,9,85,163,743
4786,Nikola Dragovic,2008,2010,UCLA,Pac-10,89,2018,249,621,132,255,117,366,128,156,67,246,313,90,51,42,104,150,743
4787,Zena Edosomwan,2014,2017,Harvard,Ivy,107,1684,296,598,296,598,0,0,151,291,190,390,580,68,38,108,128,229,743
4788,Deremy Geiger,2009,2012,Total,WAC,83,2060,222,555,79,181,143,374,156,192,14,158,172,179,54,4,111,112,743
4789,Lazeric Jones,2011,2012,UCLA,Total,66,2034,254,612,169,385,85,227,150,195,33,150,183,256,91,18,155,153,743
4790,JaQuan Lyle,2016,2017,Ohio State,Big Ten,66,1948,254,599,190,395,64,204,171,239,33,229,262,289,67,12,179,109,743
4791,Keaton Nankivil,2008,2011,Wisconsin,Big Ten,117,2255,277,567,185,348,92,219,97,125,172,220,392,68,47,77,77,189,743
4792,Liam O'Reilly,2017,2018,Gardner-Webb,Big South,65,2020,259,637,115,255,144,382,81,103,20,226,246,169,57,11,135,109,743
4793,Onochie Ochie,2012,2015,Southeastern Louisiana,Southland,109,1795,273,532,238,437,35,95,162,249,114,284,398,36,41,84,123,322,743
4794,Tomas Sanchez,2013,2014,Idaho State,Big Sky,58,2069,219,539,127,284,92,255,213,256,36,143,179,237,96,4,170,108,743
4795,Reggie Willhite,2009,2012,Yale,Ivy,96,2229,290,623,259,509,31,114,132,195,123,238,361,213,132,53,168,206,743
4796,Jordan Allen,2018,2019,Rider,MAAC,63,1648,246,662,81,203,165,459,85,106,40,149,189,42,42,20,73,96,742
4797,Dalan Ancrum,2015,2018,Western Illinois,Summit,95,1905,257,606,163,373,94,233,134,162,65,231,296,98,50,29,130,146,742
4798,Dominic Cheek,2010,2012,Villanova,Big East,97,2042,244,611,149,309,95,302,159,210,120,198,318,79,71,22,99,169,742
4799,Andy King,2008,2011,Samford,Total,123,2303,251,561,90,158,161,403,79,110,40,233,273,191,44,21,138,212,742
4800,Matt Lander,2010,2011,Western Illinois,Summit,60,1745,227,566,177,418,50,148,238,307,24,102,126,139,51,9,158,105,742
4801,Tommie Liddell,2008,2009,Saint Louis,A-10,63,2189,264,639,207,477,57,162,157,211,60,254,314,149,44,14,145,105,742
4802,Bo McCalebb,2008,2008,New Orleans,Sun Belt,32,1065,261,516,214,400,47,116,173,224,50,93,143,99,76,3,74,85,742
4803,Nemanja Mikic,2011,2014,George Washington,A-10,125,2438,258,690,69,193,189,497,37,70,54,199,253,70,46,22,109,220,742
4804,Jeremie Mitchell,2010,2013,McNeese State,Southland,100,2167,264,669,117,274,147,395,67,110,35,134,169,110,92,5,120,129,742
4805,Arizona Reid,2008,2008,High Point,Big South,31,1093,304,571,270,481,34,90,100,134,105,237,342,75,54,16,65,87,742
4806,Nate Sherwood,2015,2018,Idaho,Big Sky,104,2541,284,577,251,486,33,91,141,191,173,290,463,118,39,37,123,269,742
4807,Lazar Trifunovic,2008,2010,Total,Total,55,1692,306,671,297,646,9,25,121,182,107,313,420,124,36,12,183,98,742
4808,Kaleb Bishop,2017,2019,Fairleigh Dickinson,NEC,93,2143,279,558,227,424,52,134,131,185,181,338,519,56,45,61,131,241,741
4809,Austin Cooke,2014,2016,Abilene Christian,Southland,92,2391,239,565,103,227,136,338,127,162,138,338,476,108,61,9,95,235,741
4810,Aaron Fuller,2009,2013,Total,Total,112,2278,276,593,248,489,28,104,161,253,208,284,492,46,54,33,125,208,741
4811,Brady Manek,2018,2019,Oklahoma,Big 12,66,1703,276,590,160,277,116,313,73,102,89,276,365,41,34,45,69,74,741
4812,Kemy Osse,2013,2017,Little Rock,Sun Belt,123,2156,247,648,109,252,138,396,109,147,57,235,292,92,80,17,89,169,741
4813,Caleb Patterson,2008,2012,Total,Total,108,1740,286,617,252,509,34,108,135,173,88,157,245,40,19,56,82,163,741
4814,A.J. Rompza,2009,2012,Central Florida,CUSA,112,3159,242,649,145,332,97,317,160,229,51,243,294,487,211,7,217,253,741
4815,Shane Southwell,2011,2014,Kansas State,Big 12,126,2605,269,669,174,399,95,270,108,156,90,301,391,271,87,75,167,194,741
4816,Patrick Steeves,2016,2018,Total,Total,86,2039,293,598,252,493,41,105,114,160,100,252,352,158,55,41,155,133,741
4817,Matt Stucki,2008,2009,Idaho State,Big Sky,62,2075,243,541,158,302,85,239,170,223,35,166,201,229,83,31,153,162,741
4818,Evan Conti,2012,2015,Quinnipiac,Total,121,2444,251,654,143,340,108,314,130,190,111,339,450,228,49,11,157,199,740
4819,Fran Dougherty,2011,2014,Pennsylvania,Ivy,101,2057,295,560,284,517,11,43,139,235,162,337,499,63,52,65,150,221,740
4820,John Flowers,2008,2011,West Virginia,Big East,142,2569,278,608,232,464,46,144,138,243,195,307,502,156,78,157,129,297,740
4821,Anthony Humpty Hitchens,2011,2012,James Madison,CAA,63,2102,260,632,114,266,146,366,74,115,19,122,141,177,74,3,132,162,740
4822,Kamari Murphy,2013,2017,Total,Total,131,3219,309,610,307,598,2,12,120,210,241,528,769,79,51,114,149,332,740
4823,Colton Ray-St Cyr,2014,2017,Coastal Carolina,Total,124,2227,266,613,180,352,86,261,122,193,118,388,506,170,92,43,144,219,740
4824,Calaen Robinson,2014,2017,Total,Total,82,2088,248,616,117,233,131,383,113,142,24,193,217,248,139,3,147,177,740
4825,Derrik Smits,2017,2019,Valparaiso,Total,97,1689,290,514,290,510,0,4,160,267,131,237,368,73,24,69,161,246,740
4826,Nic Thomas,2016,2019,Total,Total,67,1626,209,592,86,259,123,333,199,248,49,149,198,101,37,2,128,139,740
4827,Ethan Thompson,2018,2019,Oregon State,Pac-12,63,2095,231,555,154,333,77,222,201,262,77,209,286,231,52,26,138,169,740
4828,Alex Tucker,2009,2012,Florida Atlantic,Sun Belt,121,3204,230,577,214,502,16,75,264,364,107,221,328,538,121,18,272,281,740
4829,Jimmy Williams,2009,2012,Total,Total,97,2440,255,562,198,392,57,170,173,316,99,324,423,277,93,22,260,296,740
4830,Zach Brown,2015,2018,Wichita State,Total,130,2357,229,528,129,229,100,299,181,252,126,225,351,152,80,36,124,254,739
4831,Chris Howell,2017,2019,Total,Total,86,1777,284,624,279,604,5,20,166,250,104,342,446,141,50,15,196,159,739
4832,Tyreek Jewell,2015,2016,St. Francis (NY),NEC,67,2074,264,724,190,426,74,298,137,212,107,199,306,106,58,15,110,122,739
4833,Aaron Ross,2014,2017,Texas Tech,Big 12,111,1806,225,518,152,310,73,208,216,252,72,246,318,79,20,21,93,218,739
4834,Korey VanDussen,2010,2013,North Carolina-Greensboro,Southern,113,2565,268,641,190,415,78,226,125,163,80,181,261,220,120,6,189,239,739
4835,Demetric Williams,2010,2013,Wichita State,MVC,140,2659,252,589,167,320,85,269,150,192,26,198,224,249,103,12,185,250,739
4836,Junior Bernal,2008,2010,Maine,AEC,85,2541,278,646,272,609,6,37,176,334,149,259,408,273,116,15,208,169,738
4837,Matt Donlan,2014,2017,Total,Total,73,2016,251,598,102,244,149,354,87,102,31,251,282,97,30,15,86,125,738
4838,Aaren Edmead,2015,2019,Total,Total,125,2308,226,645,116,313,110,332,176,232,31,121,152,217,69,6,190,198,738
4839,Anthony Jones,2009,2012,Baylor,Big 12,129,2653,272,600,187,353,85,247,109,155,142,334,476,89,69,44,129,99,738
4840,Curtis Kelly,2008,2011,Total,Total,86,1755,277,512,276,510,1,2,183,297,161,248,409,106,51,115,175,187,738
4841,Todd Mayo,2012,2014,Marquette,Big East,88,1777,231,544,158,315,73,229,203,256,48,154,202,119,59,10,140,149,738
4842,Dwight Meikle,2013,2015,Hampton,MEAC,91,1836,288,585,264,503,24,82,138,197,143,320,463,56,54,73,184,217,738
4843,Djibril Thiam,2008,2011,Total,Total,94,2355,276,523,265,477,11,46,175,291,158,306,464,65,75,99,147,228,738
4844,Joston Thomas,2011,2012,Hawaii,WAC,63,1474,277,576,271,532,6,44,178,286,96,233,329,73,34,39,161,157,738
4845,Mitchell Badillo,2014,2016,Incarnate Word,Southland,83,2471,245,510,172,326,73,184,174,226,73,207,280,390,112,1,175,182,737
4846,Raven Barber,2010,2013,Mount St. Mary's,NEC,111,2116,287,491,287,491,0,0,163,271,131,229,360,31,25,48,141,235,737
4847,Rob Diggs,2008,2009,George Washington,A-10,54,1588,281,566,274,539,7,27,168,226,148,257,405,42,41,78,124,149,737
4848,Ridge Graham,2010,2011,Stetson,A-Sun,60,1755,302,655,292,611,10,44,123,280,125,237,362,62,75,23,182,213,737
4849,Jacob Grandison,2018,2019,Holy Cross,Patriot,64,1993,269,620,162,311,107,309,92,119,50,255,305,158,60,16,117,146,737
4850,Joe Toye,2016,2019,Vanderbilt,SEC,129,2368,249,623,154,324,95,299,144,218,69,212,281,96,48,26,138,218,737
4851,Josip Vrankic,2018,2019,Santa Clara,WCC,61,1900,262,561,213,396,49,165,164,227,89,237,326,89,59,52,134,177,737
4852,Geo Baker,2018,2019,Rutgers,Big Ten,64,2099,256,698,143,375,113,323,111,146,18,151,169,211,86,30,149,128,736
4853,A.J. Hardeman,2009,2012,New Mexico,MWC,137,2616,297,577,297,574,0,3,142,288,233,296,529,55,68,100,152,354,736
4854,Anthony Henderson,2012,2015,Bowling Green State,MAC,115,2451,261,630,151,326,110,304,104,167,89,210,299,123,121,13,83,172,736
4855,Jordan Nwora,2018,2019,Louisville,ACC,62,1420,250,556,148,293,102,263,134,175,55,267,322,55,49,15,103,105,736
4856,Jordan Weethee,2012,2016,Virginia Military Institute,Total,127,2081,253,645,107,213,146,432,84,114,105,270,375,101,49,20,107,224,736
4857,Eric Devendorf,2008,2009,Syracuse,Big East,46,1562,254,566,150,302,104,264,123,157,24,73,97,147,55,16,141,111,735
4858,Donovan Gibbs,2011,2014,IUPUI,Summit,128,2680,307,584,278,505,29,79,92,145,133,349,482,91,43,44,126,195,735
4859,Trey Kennedy,2014,2016,Southern Utah,Big Sky,84,2132,240,611,183,430,57,181,198,266,22,166,188,188,53,20,170,145,735
4860,Alex Larsson,2015,2018,UC-Riverside,Big West,120,2531,300,589,300,589,0,0,135,253,226,327,553,51,22,70,178,374,735
4861,Courtney Lee,2008,2008,Western Kentucky,Sun Belt,36,1079,259,543,190,369,69,174,148,180,48,127,175,75,65,28,84,87,735
4862,Collin Stewart,2014,2017,Monmouth,MAAC,129,1776,236,639,122,275,114,364,149,197,52,150,202,70,53,41,123,171,735
4863,Christopher Tolson,2009,2012,Hampton,MEAC,118,2294,253,717,143,280,110,437,119,166,70,191,261,128,121,12,137,207,735
4864,Milan Acquaah,2018,2019,Total,Total,61,1520,243,594,152,334,91,260,157,203,27,183,210,162,67,5,172,143,734
4865,Rasheem Barrett,2008,2009,Auburn,SEC,63,1751,292,668,220,451,72,217,78,107,65,171,236,113,54,6,106,114,734
4866,Eric Childress,2014,2017,UC-Santa Barbara,Big West,124,3020,253,637,158,379,95,258,133,186,73,288,361,407,153,11,236,250,734
4867,James Dickey,2017,2019,North Carolina-Greensboro,Southern,97,2403,296,554,295,546,1,8,141,261,268,495,763,114,81,169,185,255,734
4868,Keith Frazier,2014,2018,Total,Total,86,1839,258,615,132,264,126,351,92,120,42,240,282,95,50,30,107,122,734
4869,Dustin Hogue,2014,2015,Iowa State,Big 12,70,1969,267,472,217,343,50,129,150,243,145,323,468,74,51,31,89,183,734
4870,Michael Jacobson,2016,2019,Total,Total,100,2243,280,575,257,489,23,86,151,217,229,317,546,77,72,71,87,226,734
4871,Mfiondu Kabengele,2018,2019,Florida State,ACC,71,1301,249,500,215,409,34,91,202,279,142,235,377,21,36,85,83,169,734
4872,Richaud Pack,2011,2015,Total,Total,83,2049,203,492,120,251,83,241,245,315,85,188,273,92,43,11,93,122,734
4873,Allen Payne,2011,2014,Auburn,SEC,113,2765,266,635,227,481,39,154,163,231,147,333,480,135,117,13,193,227,734
4874,Scootie Randall,2009,2013,Temple,A-10,97,2177,265,627,148,277,117,350,87,120,137,242,379,116,67,14,76,146,734
4875,Quinten Rollins,2011,2014,Miami (OH),MAC,116,3447,269,613,248,526,21,87,175,284,55,302,357,391,214,13,259,307,734
4876,Chehales Tapscott,2011,2012,Portland State,Big Sky,56,1712,259,513,242,458,17,55,199,281,168,324,492,105,81,62,124,142,734
4877,De'Monte Buckingham,2017,2018,Richmond,A-10,65,1993,244,544,163,307,81,237,164,214,93,313,406,182,87,35,150,179,733
4878,Donnell Gresham Jr.,2016,2019,Northeastern,CAA,90,2484,215,534,72,188,143,346,160,202,44,320,364,195,75,5,90,136,733
4879,Josh Heytvelt,2008,2009,Gonzaga,WCC,56,1447,264,498,233,417,31,81,174,250,102,228,330,35,36,45,76,130,733
4880,Khalil Iverson,2016,2019,Wisconsin,Big Ten,135,2787,279,524,272,469,7,55,168,271,177,321,498,131,87,83,167,179,733
4881,Parker Jackson-Cartwright,2015,2018,Arizona,Pac-12,134,2943,238,556,122,270,116,286,141,204,33,229,262,459,119,16,177,239,733
4882,Taishaun Johnson,2015,2019,Total,Total,81,1934,206,558,151,341,55,217,266,347,68,173,241,170,65,9,176,168,733
4883,Jamie Jones,2009,2010,Portland State,Big Sky,64,1583,306,523,306,523,0,0,121,171,166,247,413,47,45,105,89,168,733
4884,Isiaha Mike,2017,2019,Total,Total,64,1889,257,580,161,306,96,274,123,171,100,258,358,105,56,62,137,185,733
4885,Samir Sehic,2016,2019,Total,Total,84,1588,257,522,203,355,54,167,165,233,154,277,431,52,29,34,80,155,733
4886,Christian Williams,2010,2013,Jackson State,SWAC,95,1746,245,657,141,342,104,315,139,170,64,116,180,121,92,11,123,156,733
4887,Dante Williams,2012,2015,Oakland,Total,129,2734,263,625,143,277,120,348,87,133,111,205,316,124,70,33,93,289,733
4888,Gerry Blakes,2015,2016,Arizona State,Pac-12,66,1828,268,678,182,399,86,279,110,142,54,260,314,136,62,8,146,161,732
4889,Michael Holyfield,2012,2015,Sam Houston State,Southland,131,2165,286,489,286,488,0,1,160,289,312,457,769,31,46,191,181,380,732
4890,Jon House,2008,2011,Belmont,A-Sun,133,2669,269,554,235,447,34,107,160,269,163,290,453,201,83,37,178,211,732
4891,Carlos Johnson,2017,2019,Total,Total,82,1525,262,558,221,422,41,136,167,231,98,156,254,77,44,13,142,182,732
4892,Jason Jones,2009,2013,Total,Total,121,2003,259,545,238,477,21,68,193,300,114,206,320,101,73,9,138,235,732
4893,Terrence Joyner,2011,2012,Mississippi Valley State,SWAC,63,1804,237,623,120,304,117,319,141,204,67,121,188,150,81,4,149,167,732
4894,D.J. Augustin,2008,2008,Texas,Big 12,38,1417,242,551,168,357,74,194,173,221,20,92,112,219,47,0,105,61,731
4895,Daniel Barnes,2009,2013,Total,Total,79,2096,248,658,99,232,149,426,86,128,25,222,247,80,98,23,121,140,731
4896,Geoff Beans,2015,2018,Furman,Southern,128,2124,217,584,41,87,176,497,121,149,56,202,258,66,42,25,67,270,731
4897,Keaton Belcher,2008,2010,Belmont,A-Sun,98,1715,262,621,120,208,142,413,65,83,102,218,320,74,50,23,86,184,731
4898,Brandon Brooks,2008,2009,Alabama State,SWAC,63,2076,251,533,211,413,40,120,189,244,54,211,265,402,80,19,178,114,731
4899,Wil Carter,2011,2012,San Jose State,WAC,64,1996,270,553,266,538,4,15,187,243,191,342,533,59,26,24,107,225,731
4900,Montarrio Haddock,2009,2010,Middle Tennessee,Sun Belt,63,1517,269,560,237,475,32,85,161,214,120,224,344,75,45,9,128,207,731
4901,Thomas Kennedy,2009,2010,Detroit Mercy,Horizon,64,2009,287,637,250,505,37,132,120,163,96,191,287,73,36,27,135,124,731
4902,Rayshaun McGrew,2014,2016,Stony Brook,AEC,96,2087,309,639,309,634,0,5,113,201,182,343,525,80,49,13,110,168,731
4903,Doug Anderson,2012,2013,Detroit Mercy,Horizon,69,1758,293,554,279,508,14,46,130,187,124,196,320,87,82,35,81,176,730
4904,Al'lonzo Coleman,2011,2012,Presbyterian,Big South,46,1373,253,489,250,472,3,17,221,338,120,271,391,101,55,17,153,160,730
4905,Kristian Doolittle,2017,2019,Oklahoma,Big 12,87,2139,256,574,237,523,19,51,199,257,134,397,531,104,59,30,115,160,730
4906,PJ Dozier,2016,2017,South Carolina,SEC,70,1680,282,708,230,520,52,188,114,197,66,208,274,171,94,23,168,183,730
4907,Kameron Hankerson,2017,2019,Green Bay,Horizon,94,1934,266,610,169,342,97,268,101,128,54,159,213,161,74,50,137,161,730
4908,Eric Lockett,2015,2019,Total,Total,93,2397,286,618,253,515,33,103,125,189,88,288,376,206,76,27,134,189,730
4909,Tre'Larenz Nottingham,2018,2019,Texas State,Sun Belt,67,1885,221,641,88,219,133,422,155,205,19,191,210,158,67,8,140,141,730
4910,Schane Rillieux,2012,2016,Nicholls State,Southland,120,3594,231,608,191,454,40,154,228,411,49,245,294,322,120,7,266,302,730
4911,Warren Sledge,2014,2017,Citadel,Southern,119,2812,229,597,107,256,122,341,150,193,50,178,228,320,82,15,153,207,730
4912,Andrew Smith,2012,2015,Liberty,Big South,122,2161,298,538,297,530,1,8,133,211,182,376,558,75,74,102,130,267,730
4913,Emmanuel Addo,2011,2014,Total,Total,116,1811,258,520,219,424,39,96,174,243,131,197,328,66,13,17,139,274,729
4914,Jerrold Brooks,2013,2014,Southern Mississippi,CUSA,71,2071,251,646,115,254,136,392,91,122,23,136,159,172,87,0,107,124,729
4915,Rob Garrison,2009,2010,Niagara,MAAC,68,2169,246,623,165,357,81,266,156,195,54,181,235,164,102,18,142,130,729
4916,Jordan Hasquet,2008,2009,Montana,Big Sky,59,1790,251,577,161,338,90,239,137,195,101,288,389,104,30,23,88,138,729
4917,Omar Johnson,2009,2010,Texas-San Antonio,Southland,61,2069,225,560,133,319,92,241,187,255,45,120,165,231,86,0,167,131,729
4918,Winfield Willis,2014,2016,NJIT,Total,71,1863,239,535,136,284,103,251,148,173,48,139,187,157,67,9,109,176,729
4919,Kamren Belin,2013,2014,Youngstown State,Horizon,65,1984,244,623,127,295,117,328,123,154,95,227,322,99,48,47,111,195,728
4920,Martez Cameron,2016,2019,Morgan State,MEAC,122,3396,263,755,226,647,37,108,165,257,92,216,308,444,129,3,268,266,728
4921,Chris Clarke,2016,2018,Virginia Tech,ACC,79,1985,261,476,243,422,18,54,188,282,113,404,517,210,82,12,157,146,728
4922,Justin Hawkins,2010,2013,Nevada-Las Vegas,MWC,137,2696,245,635,163,345,82,290,156,234,103,204,307,181,170,40,90,179,728
4923,Romain Martin,2008,2010,Eastern Illinois,OVC,55,1474,259,623,128,284,131,339,79,99,19,123,142,55,31,2,98,93,728
4924,Matthew Miller,2008,2009,Texas Southern,SWAC,64,1959,245,645,147,338,98,307,140,198,26,131,157,154,62,0,191,116,728
4925,Melvin Morgan,2012,2013,Idaho State,Big Sky,60,1909,248,668,149,370,99,298,133,173,35,137,172,156,95,2,185,113,728
4926,Alex Stepheson,2008,2011,Total,Total,99,2377,302,578,302,578,0,0,124,251,269,413,682,21,23,116,136,218,728
4927,Marcus Allen,2008,2009,Jacksonville,A-Sun,62,1589,266,518,243,447,23,71,172,279,167,263,430,70,70,48,124,175,727
4928,Gabby Belardo,2009,2013,Total,Total,97,2071,271,709,181,412,90,297,95,148,44,140,184,226,88,3,210,134,727
4929,Jorge Bilbao,2014,2017,Texas-Arlington,Sun Belt,131,2554,275,541,273,515,2,26,175,281,273,399,672,122,81,43,158,353,727
4930,Cinmeon Bowers,2015,2016,Auburn,SEC,64,1877,258,652,238,563,20,89,191,378,187,428,615,92,65,33,173,159,727
4931,Aaron Clayborn,2010,2014,Texas Southern,SWAC,135,2489,288,585,288,580,0,5,151,264,187,363,550,62,52,41,154,286,727
4932,J.T. Escobar,2016,2019,Total,Total,83,1880,245,570,75,141,170,429,67,86,15,116,131,82,40,3,109,129,727
4933,Mike Evanovich,2008,2010,Fairfield,MAAC,96,1865,243,574,78,164,165,410,76,96,61,219,280,143,40,34,99,162,727
4934,Mustapha Farrakhan,2008,2011,Virginia,ACC,103,1941,234,620,145,353,89,267,170,219,30,141,171,135,43,19,144,119,727
4935,Blake Hibbitts,2013,2017,Central Michigan,MAC,125,2407,231,617,55,116,176,501,89,120,96,232,328,48,41,37,74,178,727
4936,Pierce Hornung,2010,2013,Colorado State,MWC,123,3038,304,518,286,456,18,62,101,173,342,457,799,188,156,57,134,354,727
4937,Max Jacobsen,2012,2014,Northern Arizona,Big Sky,81,1767,315,542,310,524,5,18,92,143,133,176,309,85,46,33,131,186,727
4938,Mike Miklusak,2014,2017,Western Illinois,Summit,90,2118,249,622,112,260,137,362,92,130,56,366,422,121,65,20,108,210,727
4939,Phillip Anglade,2013,2016,Virginia Military Institute,Total,126,2401,315,562,315,560,0,2,96,241,276,296,572,53,86,194,96,328,726
4940,Carlton Guyton,2011,2012,Kent State,MAC,65,2044,260,613,160,337,100,276,106,142,45,168,213,196,67,23,126,108,726
4941,Deion Lavender,2015,2019,Total,Total,117,2667,269,593,229,440,40,153,148,199,36,336,372,289,73,6,181,124,726
4942,Andre McFarland,2008,2011,Colorado State,MWC,114,2389,245,615,101,252,144,363,92,118,86,239,325,77,31,23,104,152,726
4943,Jamine Peterson,2008,2010,Providence,Big East,56,1204,280,600,229,451,51,149,115,203,172,215,387,40,47,37,75,107,726
4944,Lance Pevehouse,2009,2011,Sam Houston State,Southland,93,2272,225,599,77,153,148,446,128,178,86,227,313,185,96,28,82,177,726
4945,Shaqquan Aaron,2015,2019,Total,Total,127,2384,264,633,170,352,94,281,103,165,82,262,344,149,54,23,121,200,725
4946,Jordan Campbell,2008,2011,Belmont,A-Sun,101,2292,247,544,98,171,149,373,82,130,113,296,409,191,150,37,140,212,725
4947,Josh Ferguson,2017,2019,Winthrop,Big South,93,1876,263,511,202,346,61,165,138,180,151,366,517,73,46,70,124,157,725
4948,Rayshawn Goins,2011,2013,James Madison,CAA,66,1696,264,630,248,581,16,49,181,275,163,305,468,48,36,18,107,146,725
4949,A.J. Harris,2016,2019,Total,Total,101,2233,270,674,170,358,100,316,85,136,32,128,160,266,73,12,142,162,725
4950,Maverick Rowan,2016,2017,North Carolina State,ACC,58,1850,246,636,112,248,134,388,99,125,50,144,194,45,31,6,79,117,725
4951,Chris Douglas-Roberts,2008,2008,Memphis,CUSA,40,1147,259,479,214,370,45,109,161,226,53,112,165,71,49,18,83,68,724
4952,Larry Drew,2009,2013,Total,Total,131,3150,263,638,184,408,79,230,119,198,31,243,274,632,116,9,289,207,724
4953,Braun Hartfield,2017,2018,Youngstown State,Horizon,66,1786,260,593,195,400,65,193,139,216,91,210,301,118,78,42,110,140,724
4954,Melvin Jones,2010,2011,Portland State,Big Sky,62,1971,244,591,91,210,153,381,83,105,19,122,141,130,32,1,106,115,724
4955,J.D. Paige,2018,2019,Colorado State,MWC,54,1773,257,617,158,336,99,281,111,139,28,149,177,153,66,13,108,103,724
4956,Juwann James,2008,2009,James Madison,CAA,54,1492,289,500,286,493,3,7,142,247,135,156,291,55,72,40,113,159,723
4957,Johnathan Loyd,2011,2014,Oregon,Total,144,3021,229,615,156,372,73,243,192,258,26,215,241,458,152,10,229,302,723
4958,Malik Perry,2008,2011,Ball State,MAC,117,2921,267,535,267,534,0,1,189,344,272,339,611,86,78,40,204,378,723
4959,Trey Phills,2016,2019,Yale,Ivy,107,2370,244,523,195,360,49,163,186,255,85,235,320,156,86,54,142,196,723
4960,Shaq Thomas,2013,2016,Cincinnati,Total,129,2473,283,635,258,555,25,80,132,220,146,229,375,106,86,50,138,172,723
4961,Nick Weiler-Babb,2015,2019,Total,Total,118,2696,248,587,175,372,73,215,154,204,77,380,457,358,107,28,138,136,723
4962,Larry Wideman,2013,2016,Furman,Southern,127,2686,246,679,120,290,126,389,105,154,54,219,273,115,44,21,162,194,723
4963,Leroy Buchanan,2018,2019,Murray State,OVC,65,1978,279,577,211,367,68,210,96,137,60,205,265,92,110,30,82,120,722
4964,Antonio Green,2009,2012,Eastern Michigan,MAC,124,2937,226,687,99,273,127,414,143,194,85,222,307,171,113,21,148,213,722
4965,Jordan Hicks,2009,2013,Loyola (IL),Horizon,103,2255,275,593,188,353,87,240,85,125,132,234,366,110,69,38,129,159,722
4966,Tyrus McGee,2012,2013,Iowa State,Big 12,69,1516,237,510,91,176,146,334,102,123,71,164,235,68,56,19,49,115,722
4967,Kezie Okpala,2018,2019,Stanford,Pac-12,52,1604,246,559,206,440,40,119,190,282,61,190,251,99,52,28,140,143,722
4968,Jordan Richardson,2011,2014,Weber State,Big Sky,132,3058,231,624,79,217,152,407,108,139,25,193,218,300,61,7,160,196,722
4969,J.P. Tokoto,2013,2015,North Carolina,ACC,107,2383,285,617,264,538,21,79,131,241,153,316,469,293,128,36,180,210,722
4970,Lexus Williams,2014,2018,Total,Total,114,2479,243,600,136,295,107,305,129,162,35,192,227,228,117,9,160,216,722
4971,Bobby Ahearn,2015,2018,Binghamton,AEC,121,2291,282,559,251,473,31,86,126,181,165,289,454,63,38,30,150,315,721
4972,Corey Allen,2014,2015,South Florida,AAC,60,1923,249,587,187,402,62,185,161,204,43,165,208,159,86,15,138,128,721
4973,Antonio Anderson,2008,2009,Memphis,CUSA,77,2449,244,568,175,344,69,224,164,249,70,256,326,302,102,30,137,133,721
4974,Brendan Bald,2010,2012,Vermont,AEC,102,2081,262,720,179,457,83,263,114,173,56,123,179,72,53,13,124,154,721
4975,Kendal Brown-Surles,2010,2013,Southern Illinois,MVC,117,2882,238,623,112,243,126,380,119,160,50,167,217,281,105,11,193,242,721
4976,Luka Drca,2008,2010,Utah,MWC,94,2438,218,527,132,267,86,260,199,245,41,244,285,325,94,7,230,265,721
4977,Ed Drew,2014,2017,Presbyterian,Big South,124,2490,272,622,269,596,3,26,174,241,207,303,510,49,57,66,131,257,721
4978,Jay Harris,2012,2015,Tennessee State,OVC,119,2300,238,636,138,344,100,292,145,214,68,161,229,161,89,4,186,237,721
4979,Pe'Shon Howard,2011,2014,Total,Total,114,2833,230,631,138,326,92,305,169,223,35,252,287,410,107,8,252,167,721
4980,Remy Martin,2018,2019,Arizona State,Pac-12,64,1805,246,582,180,382,66,200,163,219,43,153,196,254,76,3,109,91,721
4981,Steve McClellan,2011,2015,Total,Total,112,2552,288,544,284,537,4,7,141,211,250,434,684,68,45,46,150,359,721
4982,Aziz N'Diaye,2011,2013,Washington,Total,102,2354,296,538,296,537,0,1,129,312,287,461,748,29,43,112,149,276,721
4983,Terell Parks,2012,2013,Western Illinois,Summit,59,1813,302,512,301,511,1,1,116,223,163,387,550,92,64,111,103,174,721
4984,Josh Piper,2012,2015,Eastern Illinois,OVC,124,2400,268,606,168,328,100,278,85,102,115,268,383,121,42,59,109,209,721
4985,Mike Poole,2011,2014,Total,Total,128,2597,297,721,270,608,27,113,100,136,133,310,443,165,142,59,163,295,721
4986,Tevin Bellinger,2016,2017,Prairie View,SWAC,63,1729,254,668,183,406,71,262,141,176,44,154,198,131,83,3,151,118,720
4987,Art Bernardi,2012,2013,Houston Baptist,GWC,53,1420,276,579,255,517,21,62,147,219,110,209,319,64,63,32,121,156,720
4988,Abdulai Bundu,2016,2019,Quinnipiac,MAAC,124,2570,268,511,268,509,0,2,184,305,307,379,686,45,40,61,141,251,720
4989,Victor Davila,2009,2012,Virginia Tech,ACC,126,2827,286,530,286,529,0,1,148,278,199,290,489,63,28,90,130,264,720
4990,Brian Johnson,2008,2011,Delaware,CAA,91,2786,232,559,134,309,98,250,158,227,39,169,208,380,77,2,181,224,720
4991,Kenneth Lowe,2014,2017,Green Bay,Horizon,132,2606,309,563,309,562,0,1,102,229,199,302,501,139,104,137,161,295,720
4992,Ryan Luther,2015,2019,Total,Total,118,2133,270,551,191,349,79,202,101,145,177,262,439,103,62,41,123,228,720
4993,Trevor Morris,2008,2011,Weber State,Big Sky,122,2301,271,467,271,461,0,6,178,248,144,275,419,50,23,89,139,347,720
4994,Jamal Murray,2016,2016,Kentucky,SEC,36,1267,244,538,131,261,113,277,119,152,53,133,186,79,35,11,84,75,720
4995,Rob Ukawuba,2014,2017,NJIT,Total,102,2085,251,532,196,370,55,162,163,249,98,253,351,144,57,21,116,216,720
4996,Fahro Alihodzic,2010,2014,Total,Total,95,2246,297,652,296,646,1,6,124,183,169,291,460,50,66,64,123,250,719
4997,Josh Bedwell,2008,2011,Samford,Total,113,2205,220,510,55,120,165,390,114,134,44,189,233,117,48,3,122,123,719
4998,Jenirro Bush,2011,2012,Jackson State,SWAC,49,1423,252,613,176,383,76,230,139,204,47,145,192,47,75,9,106,104,719
4999,Quinton Doggett,2010,2012,Southern,SWAC,84,2087,288,657,287,650,1,7,142,228,152,357,509,28,33,124,106,215,719
5000,Malik Fitts,2017,2019,Total,Total,61,1704,256,570,171,347,85,223,122,174,86,294,380,63,58,17,90,164,719
5001,Eshaunte Jones,2009,2013,Total,Total,87,1754,233,572,83,188,150,384,103,145,40,154,194,106,42,6,76,94,719
5002,Tanner Milson,2011,2014,North Carolina-Wilmington,CAA,123,2714,228,659,57,188,171,471,92,123,20,145,165,211,57,2,195,210,719
5003,Obinna Oleka,2016,2017,Arizona State,Pac-12,65,1877,245,591,194,410,51,181,178,240,161,361,522,60,54,44,106,148,719
5004,Ray Sanders,2015,2016,Albany (NY),AEC,66,1886,234,534,161,336,73,198,178,231,76,217,293,151,97,5,116,167,719
5005,Brandon Alston,2015,2019,Total,Total,120,2351,240,572,165,366,75,206,163,218,51,163,214,134,37,7,151,201,718
5006,Caleb Brown,2008,2011,Austin Peay,OVC,134,2764,228,627,160,419,68,208,194,272,41,201,242,391,139,8,223,219,718
5007,Jalen Crutcher,2018,2019,Dayton,A-10,64,2170,253,608,131,261,122,347,90,129,18,210,228,322,61,8,154,116,718
5008,De'Suan Dixon,2008,2011,Jackson State,SWAC,126,2075,255,650,214,475,41,175,167,287,186,303,489,143,101,42,146,207,718
5009,Lyonell Gaines,2012,2016,Total,Total,116,2419,296,572,285,526,11,46,115,181,233,262,495,101,52,13,103,187,718
5010,Rysheed Jordan,2014,2015,St. John's (NY),Big East,60,1713,243,569,183,390,60,179,172,261,68,137,205,183,90,11,158,168,718
5011,Christian Kirk,2012,2015,Missouri State,MVC,125,2292,301,570,301,569,0,1,116,195,163,263,426,64,40,40,123,290,718
5012,Phil Nelson,2009,2011,Portland State,Big Sky,69,1952,252,634,117,250,135,384,79,101,76,163,239,105,69,29,96,106,718
5013,Mack Smith,2018,2019,Eastern Illinois,OVC,57,1652,243,576,108,218,135,358,97,136,21,209,230,84,39,12,80,129,718
5014,Jake Thomas,2011,2014,Total,Total,86,2182,207,574,44,118,163,456,141,175,25,236,261,131,51,17,89,165,718
5015,Jake Barnett,2010,2014,Total,Total,118,2537,228,637,90,234,138,403,123,166,61,277,338,119,68,15,158,189,717
5016,Daniel Faris,2008,2009,New Mexico,MWC,67,1672,269,521,269,520,0,1,179,279,132,236,368,49,42,73,103,219,717
5017,Kevyn Green,2008,2009,Southeastern Louisiana,Southland,43,1304,240,551,117,249,123,302,114,155,39,138,177,47,27,12,85,79,717
5018,Tanner Krebs,2017,2019,Saint Mary's (CA),WCC,102,2432,243,576,99,206,144,370,87,102,56,306,362,70,47,20,69,165,717
5019,Eugene Omoruyi,2017,2019,Rutgers,Big Ten,93,1906,267,605,253,544,14,61,169,267,166,268,434,133,63,40,148,200,717
5020,Trevor Thompson,2014,2017,Total,Total,97,1851,259,502,259,502,0,0,199,280,188,423,611,26,31,118,131,284,717
5021,Dakarai Tucker,2013,2016,Utah,Pac-12,125,2234,247,557,102,185,145,372,78,98,42,208,250,79,49,32,72,143,717
5022,Ty-Shon Alexander,2018,2019,Creighton,Big East,67,1692,237,579,108,217,129,362,113,147,23,181,204,150,52,15,108,101,716
5023,Mike Cavataio,2008,2012,Total,Total,93,2177,274,629,252,538,22,91,146,184,130,284,414,160,53,36,126,143,716
5024,Jalen Coleman-Lands,2016,2019,Total,Total,78,2010,234,611,62,162,172,449,76,97,18,153,171,76,56,7,86,157,716
5025,Sherron Dorsey-Walker,2014,2017,Total,Total,92,2119,215,572,108,273,107,299,179,245,85,278,363,188,69,13,135,138,716
5026,Demonte Flannigan,2014,2017,Cleveland State,Horizon,106,1694,301,619,288,575,13,44,101,164,115,245,360,48,23,55,122,203,716
5027,Chris Kendrix,2015,2017,Missouri State,MVC,90,1956,200,503,110,236,90,267,226,284,88,251,339,66,64,40,129,172,716
5028,Terrance LeFlore,2014,2018,Alabama State,SWAC,130,2441,256,754,176,458,80,296,124,203,74,170,244,233,101,21,206,245,716
5029,John Petty,2018,2019,Alabama,SEC,70,1995,241,599,92,186,149,413,85,120,39,197,236,129,34,24,142,73,716
5030,Sidney Sanders,2013,2014,Fairleigh Dickinson,NEC,58,1675,242,603,203,484,39,119,193,262,40,126,166,273,96,3,128,148,716
5031,Andres Torres,2008,2012,Hartford,AEC,109,2788,223,571,130,264,93,307,177,256,43,186,229,331,144,4,258,279,716
5032,Thomas Bropleh,2011,2014,Boise State,Total,128,2038,238,567,124,265,114,302,125,175,83,254,337,84,50,11,91,192,715
5033,Rene Castro,2014,2018,Total,Total,90,1809,253,585,171,335,82,250,127,178,31,120,151,184,48,3,109,112,715
5034,Davonte Fitzgerald,2014,2019,Total,Total,110,1805,264,671,185,407,79,264,108,179,85,239,324,36,42,49,88,206,715
5035,Marko Gujanicic,2013,2016,George Mason,Total,121,2326,258,622,199,417,59,205,140,200,135,323,458,130,47,13,162,261,715
5036,Jason Holsinger,2008,2009,Evansville,MVC,58,2011,222,573,94,232,128,341,143,175,17,107,124,230,39,3,147,130,715
5037,Dominique Johnson,2009,2011,North Texas,Sun Belt,69,1907,220,503,124,269,96,234,179,212,32,139,171,234,66,2,144,117,715
5038,Camron Justice,2016,2019,Total,Total,66,1399,230,550,118,232,112,318,143,170,13,126,139,111,55,1,102,105,715
5039,Orlando Parker,2011,2014,Wagner,NEC,120,2417,290,591,290,585,0,6,135,209,199,374,573,54,79,85,113,361,715
5040,Malcolm Regisford,2016,2019,Colgate,Patriot,112,2148,286,512,285,508,1,4,142,250,168,413,581,74,32,74,141,217,715
5041,Mike Scott,2014,2015,Idaho,Total,64,1663,264,605,186,379,78,226,109,146,28,151,179,235,64,9,87,104,715
5042,Tyler Sharpe,2017,2019,Total,Total,73,1595,219,522,83,160,136,362,141,183,24,119,143,84,78,6,59,129,715
5043,Konner Veteto,2009,2013,Total,Total,106,1807,263,529,263,526,0,3,189,319,190,286,476,16,19,23,141,245,715
5044,Kale Abrahamson,2013,2017,Total,Total,118,2122,234,623,102,232,132,391,114,184,62,211,273,64,28,13,89,162,714
5045,Dwight Coleby,2014,2018,Total,Total,125,2035,270,478,270,477,0,1,174,248,201,364,565,34,34,125,105,262,714
5046,A.J. Hicks,2018,2019,Morehead State,OVC,62,1968,212,552,150,354,62,198,228,355,40,146,186,312,110,20,185,135,714
5047,Jamee Jackson,2010,2013,Quinnipiac,NEC,112,2396,277,577,277,577,0,0,160,332,241,296,537,39,45,100,142,291,714
5048,Chris Knight,2018,2019,Dartmouth,Ivy,55,1381,295,582,287,553,8,29,116,187,99,207,306,96,35,64,139,153,714
5049,Mason Peatling,2017,2019,Eastern Washington,Big Sky,87,1777,283,510,255,431,28,79,120,185,162,280,442,77,62,66,86,242,714
5050,Matt Ross,2013,2014,Chicago State,Total,65,2044,266,612,173,340,93,272,89,112,134,312,446,58,64,75,96,187,714
5051,Will Saunders,2014,2015,Charleston Southern,Big South,61,1498,220,532,51,116,169,416,105,141,82,251,333,54,33,12,72,153,714
5052,Javarris Barnett,2009,2012,Charlotte,A-10,108,2204,250,615,116,255,134,360,79,106,96,304,400,82,41,22,120,157,713
5053,Brett McClanahan,2009,2012,Akron,MAC,126,2290,247,667,86,202,161,465,58,78,70,209,279,130,74,5,108,171,713
5054,Luke Morrison,2015,2018,Army,Patriot,100,1591,256,634,84,181,172,453,29,43,79,254,333,64,41,13,90,173,713
5055,Jacoby Ross,2018,2019,Alabama State,SWAC,57,1625,231,622,117,295,114,327,137,168,28,102,130,131,45,1,122,83,713
5056,Gabe Taylor,2015,2017,Portland,WCC,94,2090,271,588,237,474,34,114,137,187,102,263,365,47,30,46,87,179,713
5057,Lesley Varner Jr.,2017,2019,Texas-Rio Grande Valley,WAC,102,1995,248,588,191,385,57,203,160,243,151,226,377,89,110,30,88,213,713
5058,Jacob Wiley,2013,2017,Total,Big Sky,54,1225,273,428,268,420,5,8,162,196,98,222,320,80,26,95,133,107,713
5059,Elijah Childs,2018,2019,Bradley,MVC,68,1723,297,616,277,536,20,80,98,164,141,335,476,55,51,96,112,162,712
5060,Paul Crosby,2011,2012,Mississippi Valley State,SWAC,56,1771,243,600,193,439,50,161,176,255,149,256,405,97,87,47,154,174,712
5061,Ben Johnson,2008,2010,Colgate,Patriot,88,2039,244,560,207,454,37,106,187,247,139,249,388,95,55,28,152,227,712
5062,Darin Johnson,2014,2017,Total,Total,87,1856,212,531,159,347,53,184,235,294,50,152,202,89,48,14,93,128,712
5063,Kenny Jones,2016,2017,Austin Peay,OVC,66,1821,289,512,283,493,6,19,128,244,121,302,423,72,59,47,125,162,712
5064,Ja'Rob McCallum,2010,2014,Total,Total,86,1883,245,618,119,281,126,337,96,130,27,161,188,77,61,1,121,138,712
5065,Tyrone Nash,2008,2011,Notre Dame,Big East,118,2345,235,460,234,457,1,3,241,384,220,305,525,177,51,42,117,237,712
5066,Malik Smith,2013,2014,Total,Total,68,1745,212,593,59,154,153,439,135,175,15,130,145,79,53,4,91,117,712
5067,Nino Williams,2011,2015,Kansas State,Big 12,111,1835,267,560,261,537,6,23,172,225,174,235,409,73,46,15,92,269,712
5068,Andrew Brown,2016,2019,Furman,Southern,116,2239,240,543,77,154,163,389,68,94,82,227,309,149,84,17,94,182,711
5069,Colin Nickerson,2010,2013,Fairfield,MAAC,138,2993,265,573,224,415,41,158,140,216,70,323,393,244,192,13,176,222,711
5070,Semi Ojeleye,2014,2017,Total,Total,58,1338,222,463,141,268,81,195,186,237,90,179,269,56,22,18,55,79,711
5071,Chuma Okeke,2018,2019,Auburn,SEC,72,1839,260,540,171,311,89,229,102,145,175,282,457,111,92,71,92,137,711
5072,Jeff Peterson,2008,2012,Total,Total,118,2738,238,599,176,407,62,192,173,236,30,208,238,329,95,2,287,218,711
5073,Daiquan Walker,2013,2016,Central Florida,Total,121,2619,250,657,136,347,114,310,97,128,39,216,255,268,75,16,184,153,711
5074,Austin Butler,2018,2019,Holy Cross,Patriot,63,1879,256,591,161,332,95,259,103,148,67,178,245,96,71,11,89,138,710
5075,Dadrian Collins,2010,2012,Howard,MEAC,83,2074,237,668,94,244,143,424,93,132,72,177,249,76,29,9,138,166,710
5076,Deon Edwin,2013,2017,Total,Total,98,1830,249,536,184,351,65,185,147,215,113,228,341,124,88,20,130,170,710
5077,Zach Gengler,2014,2017,Portland State,Big Sky,114,2235,261,559,176,324,85,235,103,124,37,186,223,203,120,12,96,259,710
5078,Demetrius Green,2008,2009,Middle Tennessee,Sun Belt,62,1851,253,533,208,402,45,131,159,244,85,176,261,108,65,9,124,136,710
5079,Secean Johnson,2016,2017,UC-Riverside,Big West,60,1757,213,550,163,390,50,160,234,310,88,252,340,105,61,17,143,183,710
5080,Rich Kelly,2018,2019,Quinnipiac,MAAC,59,2022,228,549,114,250,114,299,140,173,29,113,142,273,43,5,171,112,710
5081,Shaquielle McKissic,2014,2015,Arizona State,Pac-12,66,1978,238,528,174,337,64,191,170,255,81,250,331,142,97,7,77,140,710
5082,Cameron Neubauer,2015,2018,San Diego,WCC,103,2380,225,546,104,198,121,348,139,198,84,256,340,145,37,17,137,278,710
5083,Chris Barton,2016,2019,Niagara,MAAC,123,2477,219,544,155,345,64,199,207,276,77,193,270,121,27,2,152,241,709
5084,Kameron Chatman,2015,2018,Total,Total,89,1632,254,596,175,379,79,217,122,152,77,282,359,96,55,21,95,143,709
5085,Nedeljko Golubovic,2008,2011,Fresno State,WAC,129,2841,247,612,162,325,85,287,130,197,116,330,446,119,86,40,143,305,709
5086,Terrance Hill,2010,2011,Loyola (IL),Horizon,61,1852,245,639,147,395,98,244,121,158,74,192,266,116,49,21,133,150,709
5087,Kenny McGowan,2011,2012,Idaho State,Big Sky,59,1523,217,573,116,258,101,315,174,220,22,65,87,111,56,2,122,163,709
5088,Mezie Nwigwe,2008,2010,Robert Morris,NEC,103,2239,242,594,195,450,47,144,178,245,68,294,362,214,84,9,194,236,709
5089,Ron Patterson,2014,2018,Total,Total,101,2052,260,645,121,248,139,397,50,85,46,161,207,172,101,37,107,172,709
5090,Elijah Pittman,2013,2014,Marshall,CUSA,41,1281,234,484,141,234,93,250,148,233,63,112,175,54,33,29,90,85,709
5091,Brian Richardson,2011,2015,Total,Total,118,2244,238,645,117,275,121,370,112,159,49,168,217,118,58,33,117,199,709
5092,Robert Williams,2011,2014,Alabama-Birmingham,CUSA,123,2717,243,580,167,360,76,220,147,212,258,322,580,135,74,25,157,244,709
5093,Tre Bowman,2013,2014,Iona,MAAC,64,1757,244,483,144,233,100,250,120,143,60,205,265,66,50,12,55,92,708
5094,Thomas Bruce,2016,2018,Binghamton,AEC,85,2398,276,517,276,514,0,3,156,284,144,391,535,94,43,117,133,213,708
5095,Cameron Catlett,2010,2013,Texas-Arlington,Total,120,2415,269,609,258,570,11,39,159,291,120,213,333,291,119,7,220,241,708
5096,Jarryd Cole,2008,2011,Iowa,Big Ten,108,2436,277,466,275,458,2,8,152,243,198,319,517,40,57,33,137,296,708
5097,Calvin Godfrey,2011,2015,Total,Total,91,1855,267,506,267,505,0,1,174,268,193,348,541,52,61,100,99,231,708
5098,Hayden Koval,2018,2019,Central Arkansas,Southland,67,1812,248,531,175,320,73,211,139,190,102,286,388,64,27,177,114,206,708
5099,Devon Lamb,2011,2012,Lamar,Southland,65,1769,264,551,229,434,35,117,145,254,211,313,524,107,106,33,89,125,708
5100,Luka Mirkovic,2009,2012,Northwestern,Big Ten,112,2532,268,548,246,481,22,67,150,249,176,345,521,228,66,73,138,256,708
5101,Dwayne Morgan,2015,2019,Total,Total,94,1895,271,629,247,549,24,80,142,213,131,311,442,54,58,60,163,304,708
5102,David Skara,2015,2019,Total,Total,122,2777,253,555,180,330,73,225,129,178,125,286,411,164,69,47,149,252,708
5103,Chad Toppert,2008,2009,New Mexico,MWC,67,1660,212,479,45,99,167,380,117,144,45,169,214,86,18,9,50,98,708
5104,Darius Banks,2018,2019,James Madison,CAA,63,1933,239,537,175,366,64,171,165,209,60,227,287,122,104,21,150,178,707
5105,Keith Carter,2013,2016,Total,Total,85,2146,247,568,132,275,115,293,98,156,35,211,246,304,112,16,140,178,707
5106,Eric Davis Jr.,2016,2018,Texas,Big 12,92,2233,237,655,117,283,120,372,113,153,28,196,224,71,51,2,89,150,707
5107,Karonn Davis,2015,2018,Total,Total,89,2466,232,711,132,373,100,338,143,189,52,215,267,281,62,7,136,186,707
5108,Shawntrez Davis,2018,2019,Bethune-Cookman,MEAC,58,1495,274,547,232,423,42,124,117,201,131,304,435,77,33,60,118,185,707
5109,Bryce Douvier,2012,2016,Total,Total,103,1858,235,491,175,338,60,153,177,225,127,344,471,54,48,39,131,250,707
5110,P.J. Hairston,2012,2013,North Carolina,ACC,71,1286,220,567,93,203,127,364,140,175,93,135,228,74,57,20,66,118,707
5111,Demarcus Holland,2013,2016,Texas,Big 12,135,3033,257,606,201,429,56,177,137,228,138,241,379,212,92,18,194,201,707
5112,Logan Johnson,2008,2010,Coastal Carolina,Big South,93,2616,242,578,180,382,62,196,161,221,116,237,353,281,102,9,199,218,707
5113,Demetrius Pollard,2012,2016,Total,Total,107,2153,230,630,102,236,128,394,119,173,42,131,173,145,64,7,128,176,707
5114,Delano Spencer,2017,2018,Tennessee State,OVC,59,1625,231,542,88,194,143,348,102,121,26,124,150,59,50,2,84,114,707
5115,Rawle Alkins,2017,2018,Arizona,Pac-12,60,1760,242,538,165,327,77,211,145,199,100,193,293,134,62,34,126,131,706
5116,Francisco Cruz,2011,2012,Wyoming,MWC,64,2032,257,565,165,319,92,246,100,128,48,150,198,127,56,5,118,128,706
5117,Adam Folker,2009,2013,UC-Irvine,Big West,126,2370,302,567,302,566,0,1,102,244,257,355,612,70,43,32,146,294,706
5118,Kyle Fuller,2011,2014,Vanderbilt,SEC,116,2473,229,629,171,398,58,231,190,270,27,228,255,267,60,5,184,141,706
5119,Naji Hibbert,2010,2014,Total,Total,125,2572,242,657,137,341,105,316,117,175,48,222,270,168,84,14,113,169,706
5120,Jewuan Long,2008,2012,Murray State,OVC,133,2414,260,544,223,435,37,109,149,210,88,197,285,192,117,43,177,168,706
5121,Stephen Ugochukwu,2015,2018,McNeese State,Southland,108,1951,262,601,252,565,10,36,172,270,167,335,502,63,55,93,119,255,706
5122,Dennis Horner,2008,2010,North Carolina State,ACC,92,1956,241,529,177,337,64,192,159,207,95,199,294,100,56,52,93,158,705
5123,Jemerrio Jones,2017,2018,New Mexico State,WAC,68,1797,299,595,290,530,9,65,98,171,225,512,737,209,73,44,151,168,705
5124,E.J. Kusnyer,2009,2010,Mercer,A-Sun,65,1650,226,595,36,95,190,500,63,83,44,126,170,29,27,4,55,162,705
5125,Darius McNeill,2018,2019,University of California,Pac-12,63,2061,250,648,117,269,133,379,72,100,17,121,138,96,85,8,104,145,705
5126,Maxx Nakwaasah,2009,2011,Centenary (LA),Summit,86,1586,237,619,169,386,68,233,163,225,90,208,371,79,57,8,154,159,705
5127,Travis Nichols,2011,2013,St. Francis (NY),NEC,80,1397,250,557,144,270,106,287,99,117,115,202,317,17,33,6,71,182,705
5128,Jordan Poole,2018,2019,Michigan,Big Ten,75,1700,236,544,121,233,115,311,118,142,11,152,163,102,60,14,82,114,705
5129,A.J. Turner,2016,2019,Total,Total,91,2688,244,628,131,282,113,346,104,143,36,242,278,228,62,27,113,149,705
5130,Jaret Von Rosenberg,2008,2009,Hartford,AEC,64,2268,217,552,135,273,82,279,189,222,50,200,250,228,105,3,150,118,705
5131,Austin Witter,2010,2013,North Carolina A&T,MEAC,132,3269,268,686,160,316,108,370,61,123,117,486,603,221,102,181,220,260,705
5132,Solomon Alabi,2008,2010,Florida State,ACC,77,1692,270,506,270,505,0,1,164,220,162,253,415,28,39,159,128,158,704
5133,Deandre Ayton,2018,2018,Arizona,Pac-12,35,1172,276,451,264,416,12,35,140,191,118,287,405,57,20,66,69,81,704
5134,Sean Carter,2008,2012,Total,Total,128,2923,283,541,283,541,0,0,138,300,332,405,737,79,75,135,161,346,704
5135,Colin Chiverton,2012,2013,Eastern Washington,Big Sky,56,1121,237,625,104,273,133,352,97,129,27,88,115,27,36,24,66,124,704
5136,Benson Egemonye,2008,2009,Niagara,MAAC,64,1629,240,411,240,411,0,0,224,321,212,226,438,12,46,99,94,201,704
5137,Lorenzo McCloud,2012,2013,Pacific,Big West,63,1790,210,511,167,372,43,139,241,310,31,151,182,238,57,4,153,117,704
5138,Michael Neal,2012,2014,Appalachian State,Southern,79,2169,226,597,144,356,82,241,170,250,37,158,195,259,90,28,229,179,704
5139,Francisco Santiago,2016,2018,Youngstown State,Horizon,74,2237,268,631,206,436,62,195,106,141,55,263,318,306,98,21,153,135,704
5140,Ethan Stair,2016,2019,Mercer,Southern,85,2183,254,549,173,330,81,219,115,159,96,257,353,103,85,12,106,173,704
5141,Prince Williams,2013,2016,East Carolina,Total,111,2147,232,533,185,397,47,136,193,264,53,211,264,280,91,20,180,173,704
5142,Shawn Williams,2018,2019,East Carolina,AAC,56,1747,227,581,85,190,142,391,108,123,10,87,97,94,31,2,75,100,704
5143,Kevin Winford,2010,2013,Eastern Washington,Big Sky,113,2166,240,649,102,240,138,409,86,111,26,100,126,135,55,7,112,209,704
5144,Dwan Caldwell,2014,2015,Tennessee Tech,OVC,63,1611,275,541,268,522,7,19,146,217,148,193,341,33,39,48,115,185,703
5145,Orlando Coleman,2014,2016,Total,Total,95,2415,288,649,222,428,66,221,61,96,144,337,481,97,64,41,151,149,703
5146,John Dewey III,2017,2018,Sam Houston State,Southland,70,2035,218,564,142,350,76,214,191,241,49,183,232,326,83,1,217,174,703
5147,Kyle Dranginis,2013,2016,Gonzaga,WCC,143,2960,255,548,160,281,95,267,98,153,145,303,448,298,115,49,141,262,703
5148,Jalon Gates,2017,2019,Houston Baptist,Southland,80,1165,208,573,63,132,145,441,142,177,22,54,76,35,17,2,41,61,703
5149,Dominic Magee,2016,2019,Total,Total,78,1572,245,571,167,339,78,232,135,214,44,299,343,107,66,10,96,128,703
5150,Harold McBride,2015,2016,Gardner-Webb,Big South,68,1784,226,589,122,299,104,290,147,186,35,139,174,212,87,5,121,125,703
5151,Kellen McCoy,2008,2009,Weber State,Big Sky,61,1559,210,450,119,235,91,215,192,243,33,165,198,140,65,1,147,125,703
5152,Trey Norris,2012,2016,Total,Total,125,2961,243,560,178,379,65,181,152,201,36,173,209,379,112,5,188,251,703
5153,Kamil Svrdlik,2009,2011,Fairleigh Dickinson,NEC,88,2348,268,547,262,518,6,29,161,273,160,256,416,50,39,99,193,274,703
5154,Jeremie Tyler,2015,2018,Ball State,MAC,79,1737,254,606,131,286,123,320,72,92,22,121,143,80,68,27,94,129,703
5155,George Valentine,2008,2012,Winthrop,Big South,131,3045,294,521,294,521,0,0,115,229,258,418,676,80,132,97,140,281,703
5156,Terrell Allen,2016,2019,Total,Total,96,2973,234,566,180,416,54,150,180,233,44,246,290,330,135,3,169,249,702
5157,Andre Armstrong,2013,2014,Coppin State,MEAC,59,1451,181,541,51,151,130,390,210,256,30,56,86,35,37,3,74,142,702
5158,Demario Beck,2017,2018,Coastal Carolina,Sun Belt,71,1786,277,559,226,369,51,190,97,174,182,354,536,47,41,60,102,203,702
5159,Perrin Buford,2015,2016,Middle Tennessee,CUSA,70,1639,267,530,242,473,25,57,143,206,118,212,330,89,38,62,112,151,702
5160,Jacob Calloway,2017,2019,Southern Utah,Big Sky,95,1861,234,559,122,251,112,308,122,164,98,255,353,86,46,29,94,209,702
5161,Kerry Carter,2014,2015,Saint Mary's (CA),WCC,66,1970,222,541,80,182,142,359,116,165,36,235,271,76,74,11,101,189,702
5162,Steve Frankoski,2011,2015,Columbia,Ivy,95,1953,247,622,79,201,168,421,40,48,20,116,136,57,43,8,73,131,702
5163,Brandon Gibson,2009,2013,Louisiana Tech,WAC,108,2022,236,644,143,320,93,324,137,236,109,293,402,93,76,45,133,263,702
5164,Jordan Lauf,2014,2017,Toledo,MAC,133,3045,231,430,179,281,52,149,188,275,234,333,567,159,106,9,83,304,702
5165,Daequon Montreal,2010,2011,Boise State,WAC,67,1712,261,548,248,499,13,49,167,234,146,206,352,68,35,35,89,158,702
5166,Lamar Twitty,2008,2009,Florida A&M,MEAC,58,,243,627,160,373,83,254,133,206,96,221,317,69,44,17,106,151,702
5167,Kyle Vejraska,2008,2010,Campbell,A-Sun,90,1644,267,599,213,444,54,155,114,156,129,171,300,61,41,74,133,233,702
5168,Anthony Clemmons,2013,2016,Iowa,Big Ten,137,2654,235,567,163,358,72,209,159,237,48,208,256,344,88,19,180,226,701
5169,Dominique Elliott,2015,2016,Maryland-Eastern Shore,MEAC,64,1660,261,510,255,479,6,31,173,269,129,269,398,88,47,22,164,196,701
5170,Anthony Green,2016,2019,Northeastern,CAA,118,2012,290,441,290,441,0,0,121,238,163,291,454,46,32,96,126,238,701
5171,Anthony Hubbard,2013,2014,Morgan State,MEAC,63,1785,244,535,217,419,27,116,186,314,149,272,421,111,49,15,146,145,701
5172,David Imes,2010,2013,Hofstra,CAA,112,2796,272,648,232,498,40,150,117,174,188,368,556,79,86,86,118,223,701
5173,Jailyn Ingram,2017,2019,Florida Atlantic,CUSA,70,1806,280,626,249,526,31,100,110,157,93,243,336,105,42,28,151,162,701
5174,Michael Roll,2008,2010,UCLA,Pac-10,73,1836,258,555,123,254,135,301,50,69,13,132,145,179,52,12,92,111,701
5175,Caleb Daniels,2018,2019,Tulane,AAC,60,1568,234,531,166,342,68,189,164,228,62,164,226,143,30,19,120,168,700
5176,Flavien Davis,2013,2014,Montana State,Big Sky,59,1519,247,511,236,468,11,43,195,294,91,150,241,58,43,12,103,139,700
5177,Mario Edwards,2009,2010,Coastal Carolina,Big South,66,1910,249,581,144,305,105,276,97,141,53,209,262,167,48,11,150,111,700
5178,Demetrious Floyd,2015,2016,Stephen F. Austin,Southland,68,1329,259,566,108,207,151,359,31,49,12,75,87,96,47,3,63,77,700
5179,Alexander Aka Gorski,2015,2018,Wyoming,MWC,116,2176,219,585,73,140,146,445,116,162,38,174,212,116,39,2,98,193,700
5180,Hassani Gravett,2017,2019,South Carolina,SEC,97,2318,236,613,128,294,108,319,120,168,52,235,287,234,51,16,159,178,700
5181,Graham Hatch,2008,2011,Wichita State,MVC,119,2502,223,530,98,199,125,331,129,169,119,183,302,130,70,12,146,224,700
5182,Nate Hickman,2015,2018,Columbia,Ivy,104,1972,223,575,138,307,85,268,169,229,39,168,207,111,61,12,135,171,700
5183,K.J. Maura,2015,2018,Total,Total,83,2426,228,512,118,246,110,266,134,152,48,143,191,337,134,1,137,127,700
5184,Michael Nzei,2016,2019,Seton Hall,Big East,135,2597,278,454,278,454,0,0,144,236,233,305,538,63,33,58,110,279,700
5185,Janai Raynor Powell,2017,2019,South Carolina State,MEAC,97,2451,230,564,169,399,61,165,179,227,59,214,273,288,87,8,211,175,700
5186,Jeremy Robinson,2009,2013,Total,Total,78,1622,277,626,249,534,28,92,118,173,135,276,411,72,55,71,165,220,700
5187,Trey Stanton,2009,2011,Rice,CUSA,93,2140,265,616,215,465,50,151,120,176,107,312,419,94,32,54,137,225,700
5188,Diandre Wilson,2018,2019,NJIT,A-Sun,63,1744,219,534,127,281,92,253,170,228,22,140,162,96,63,18,105,128,700
5189,Shannon Behling,2009,2010,Mississippi Valley State,SWAC,64,1924,265,665,174,382,91,283,78,122,139,240,379,56,91,31,111,201,699
5190,Rakeem Buckles,2010,2014,Total,Total,90,1745,250,538,209,416,41,122,158,227,188,328,516,65,67,53,146,235,699
5191,Matt Coleman,2018,2019,Texas,Big 12,70,2259,245,614,176,390,69,224,140,178,40,121,161,258,66,4,136,196,699
5192,Filip Cvjeticanin,2012,2016,Florida Gulf Coast,A-Sun,131,2129,235,617,53,121,182,496,47,71,55,217,272,43,29,16,85,112,699
5193,La'Ryan Gary,2008,2011,Louisiana,Sun Belt,86,1837,241,516,219,425,22,91,195,253,124,170,294,61,60,46,136,209,699
5194,Jermaine Johnson,2008,2009,College of Charleston,Southern,68,2026,279,504,273,479,6,25,135,228,196,343,539,82,45,34,136,195,699
5195,Jerome Jones,2010,2013,Total,Total,74,1640,261,628,172,380,89,248,88,133,90,209,299,44,53,19,127,114,699
5196,Robert Mitchell,2009,2010,Seton Hall,Big East,61,1731,259,624,208,462,51,162,130,164,120,238,358,76,51,50,99,162,699
5197,Ike Okoye,2009,2010,Boise State,WAC,64,1497,293,549,293,545,0,4,113,162,98,333,431,58,40,106,91,148,699
5198,Malique Trent,2016,2018,Total,Total,65,1588,236,549,178,335,58,214,169,241,26,170,196,173,114,15,154,170,699
5199,Jaleel Williams,2012,2015,San Jose State,Total,89,1971,252,626,145,289,107,337,88,142,74,269,343,59,27,13,97,149,699
5200,Anthony Adger,2018,2019,Florida Atlantic,CUSA,64,1691,219,620,121,297,98,323,162,197,28,171,199,157,52,2,122,96,698
5201,Bryce Cartwright,2009,2012,Total,Total,97,2493,262,695,222,538,40,157,134,185,40,177,217,445,84,5,249,131,698
5202,Whitney Coleman,2008,2010,Monmouth,NEC,63,1957,246,642,151,344,95,298,111,131,39,181,220,141,95,14,153,144,698
5203,Brady Ellingson,2015,2019,Total,Total,127,2159,246,521,101,190,145,331,61,72,15,129,144,137,42,8,75,95,698
5204,Gary Forbes,2008,2008,Massachusetts,A-10,36,1214,233,572,176,377,57,195,175,243,65,205,270,109,41,25,113,87,698
5205,Javis Howard,2015,2018,Charleston Southern,Big South,117,2438,297,550,290,523,7,27,97,158,212,269,481,54,53,28,127,192,698
5206,Neiko Hunter,2013,2014,Middle Tennessee,Total,67,1541,264,541,230,441,34,100,136,196,117,142,259,43,47,32,102,161,698
5207,Marcus Lewis,2008,2009,Oral Roberts,Summit,64,1631,277,489,277,489,0,0,144,299,138,265,403,125,46,23,150,165,698
5208,Sam McBeath,2012,2015,Nicholls State,Southland,85,1988,240,577,149,288,91,289,127,202,114,322,436,138,65,47,165,242,698
5209,Herb McGee,2017,2019,South Alabama,Sun Belt,95,2401,217,547,98,207,119,340,145,204,21,225,246,226,63,7,191,236,698
5210,Aaron Menzies,2016,2018,Seattle,WAC,80,1741,281,494,281,494,0,0,136,226,194,349,543,39,20,109,104,215,698
5211,Omar Oraby,2011,2014,Total,Total,114,1644,267,444,267,444,0,0,164,256,137,320,457,33,16,177,132,261,698
5212,Darral Willis Jr.,2017,2018,Wichita State,Total,69,1190,250,477,232,429,18,48,180,256,123,260,383,56,23,43,106,144,698
5213,Ryan Anderson,2008,2008,University of California,Pac-10,33,1082,230,469,166,313,64,156,173,199,100,228,328,47,12,18,74,71,697
5214,Johnathan Bell,2016,2017,Nicholls State,Southland,65,1832,238,609,181,420,57,189,164,222,69,215,284,92,91,25,102,131,697
5215,Khalil Davis,2015,2016,Austin Peay,OVC,66,2034,219,557,161,356,58,201,201,309,111,180,291,174,70,20,162,173,697
5216,Johnny Hill,2012,2016,Total,Total,117,2225,231,468,213,400,18,68,217,290,102,238,340,271,108,16,183,219,697
5217,Walter Hodge,2008,2009,Florida,SEC,72,2128,255,545,141,241,114,304,73,93,46,84,130,187,97,3,89,159,697
5218,Isaiah McCray,2012,2015,Purdue-Fort Wayne,Summit,121,2672,222,596,131,328,91,268,162,328,78,348,426,247,131,55,161,271,697
5219,Ray Salnave,2018,2019,Monmouth,MAAC,64,1556,216,527,166,366,50,161,215,283,40,201,241,144,79,10,159,182,697
5220,James Scott,2017,2018,Kennesaw State,A-Sun,52,1277,253,611,176,389,77,222,114,151,27,77,104,91,61,8,110,85,697
5221,Jordan Baker,2012,2015,Total,Total,68,1991,251,653,176,423,75,230,119,178,54,191,245,202,70,19,213,168,696
5222,Bakari Evelyn,2016,2019,Total,Total,82,2006,238,606,131,285,107,321,113,145,20,163,183,165,62,6,160,146,696
5223,Malik Johnson,2017,2019,Canisius,MAAC,99,3152,233,605,152,339,81,266,149,209,34,299,333,455,138,8,190,240,696
5224,Terry Larrier,2015,2018,Total,Total,69,1759,242,628,155,358,87,270,125,170,77,189,266,53,38,14,115,104,696
5225,Tevin Mack,2016,2019,Total,Total,82,1608,245,624,129,279,116,345,90,151,70,181,251,51,26,33,87,121,696
5226,R.J. Mahurin,2011,2013,Indiana State,MVC,97,1631,230,541,130,252,100,289,136,197,67,198,265,39,42,45,73,187,696
5227,D.J. Rivera,2008,2009,Total,Total,45,1266,244,538,197,384,47,154,161,248,76,153,229,38,66,15,65,107,696
5228,Killian Tillie,2017,2019,Gonzaga,WCC,84,1597,262,472,192,323,70,149,102,134,99,278,377,103,64,57,89,191,696
5229,Jeremy Williams,2010,2011,Texas-El Paso,CUSA,68,1835,229,481,173,339,56,142,182,269,103,246,349,61,52,43,108,196,696
5230,David Carson,2008,2009,Purdue-Fort Wayne,Summit,52,1614,231,578,199,461,32,117,201,267,81,203,284,88,26,17,116,166,695
5231,Armani Cotton,2012,2015,Yale,Ivy,109,2379,214,549,127,283,87,266,180,237,140,398,538,95,74,20,118,172,695
5232,Leron Fisher,2014,2016,Longwood,Big South,77,2126,207,570,126,348,81,222,200,273,30,151,181,202,130,8,163,149,695
5233,Khy Kabellis,2016,2019,Total,Total,82,2303,231,591,131,307,100,284,133,201,23,184,207,172,65,10,150,124,695
5234,Matt Mitchell,2018,2019,San Diego State,MWC,67,1772,231,542,140,277,91,265,142,187,42,229,271,118,59,15,133,178,695
5235,Nick Rutherford,2016,2019,Total,Total,98,2534,219,603,190,493,29,110,228,319,58,317,375,326,149,35,233,193,695
5236,Shevon Thompson,2015,2016,George Mason,A-10,62,1635,271,480,271,479,0,1,153,259,257,423,680,23,21,65,157,143,695
5237,D'Mitrik Trice,2017,2019,Wisconsin,Big Ten,81,2095,238,622,112,296,126,326,93,123,15,168,183,176,56,5,95,129,695
5238,Brigham Waginger,2008,2010,Western Carolina,Southern,96,3032,236,616,94,188,142,428,81,145,81,285,366,322,240,5,193,208,695
5239,Stef Welsh,2008,2010,Arkansas,SEC,94,2134,237,655,124,291,113,364,108,169,41,143,184,203,77,5,181,181,695
5240,Reggie Williams,2008,2008,Virginia Military Institute,Big South,25,878,269,509,226,355,43,154,114,170,93,149,242,97,55,17,76,53,695
5241,Garvey Young,2009,2013,Total,Total,111,2565,229,595,168,394,61,201,176,255,138,242,380,131,83,13,160,270,695
5242,Bo Zeigler,2015,2018,Total,Total,124,2654,304,542,303,525,1,17,86,189,150,273,423,122,73,119,186,322,695
5243,Marvin Bagley III,2018,2018,Duke,ACC,33,1118,270,440,247,382,23,58,131,209,132,234,366,50,27,29,75,60,694
5244,Matt Hauser,2016,2018,Santa Clara,WCC,85,2458,244,623,131,308,113,315,93,127,19,151,170,277,66,1,115,117,694
5245,Yondarius Johnson,2011,2014,Total,SWAC,95,1879,243,576,168,343,75,233,133,223,46,159,205,70,44,10,109,172,694
5246,Chris Jones,2014,2015,Louisville,Total,59,1651,231,597,149,368,82,229,150,201,54,126,180,190,126,3,107,147,694
5247,Ryan Swan-Ford,2017,2019,Air Force,MWC,71,1558,251,493,199,360,52,133,140,196,141,229,370,100,46,30,108,151,694
5248,Jason Thompson,2008,2008,Rider,MAAC,34,1177,275,491,264,457,11,34,133,229,114,298,412,93,36,91,99,100,694
5249,Bryson Williams,2017,2018,Fresno State,MWC,65,1482,297,496,296,492,1,4,99,159,109,230,339,42,29,40,98,204,694
5250,Cody Benzel,2016,2019,Eastern Washington,Big Sky,135,2064,228,566,25,62,203,504,34,38,17,114,131,65,67,12,44,188,693
5251,Porter Braswell,2008,2011,Yale,Ivy,113,2449,211,553,132,295,79,258,192,249,36,210,246,214,91,1,183,195,693
5252,Joe Darger,2008,2009,Nevada-Las Vegas,MWC,67,1869,218,565,73,172,145,393,112,138,81,213,294,59,44,22,50,170,693
5253,Kuran Iverson,2014,2017,Total,Total,90,1935,267,565,224,429,43,136,116,212,150,350,500,126,53,86,154,212,693
5254,Rob Johnson,2010,2013,Total,Total,94,2185,254,697,197,472,57,225,128,193,63,298,361,111,62,22,146,193,693
5255,Dennis Jones,2018,2019,Prairie View,SWAC,66,1917,228,576,172,379,56,197,181,313,35,96,131,319,128,5,218,201,693
5256,Trevor Noack,2010,2013,Belmont,Total,123,1852,265,592,186,349,79,243,84,122,119,259,378,51,50,31,97,206,693
5257,Brad Redford,2009,2013,Xavier,A-10,132,1966,219,516,24,59,195,457,60,70,6,98,104,64,34,5,72,111,693
5258,Jamall Robinson,2014,2018,Total,Total,132,2839,241,676,130,328,111,348,100,155,133,225,358,109,63,22,90,216,693
5259,Jordan Swarbrick,2010,2011,Utah Valley,GWC,59,1739,215,492,138,302,77,190,186,223,65,233,298,165,67,25,100,111,693
5260,Andy Wicke,2008,2009,Belmont,A-Sun,66,1914,224,582,61,131,163,451,82,99,38,91,129,210,106,7,141,154,693
5261,Jordon Bronner,2011,2014,New Hampshire,AEC,117,3128,223,607,137,332,86,275,160,233,33,184,217,260,77,3,129,256,692
5262,Desure Buie,2016,2019,Hofstra,CAA,107,2368,230,570,161,353,69,217,163,193,24,160,184,348,134,6,140,155,692
5263,Obediah Church,2016,2019,Missouri State,MVC,106,2709,286,455,285,447,1,8,119,247,221,386,607,150,70,201,162,226,692
5264,Dodie Dunson,2009,2011,Bradley,MVC,68,2016,241,554,163,336,78,218,132,201,58,162,220,122,56,3,106,131,692
5265,James Farr,2013,2016,Xavier,Total,118,1740,278,554,243,443,35,111,101,155,196,414,610,40,52,88,103,215,692
5266,Nathan Hawkins,2008,2010,Texas-Rio Grande Valley,Total,89,1581,257,513,257,513,0,0,178,361,108,154,262,28,13,7,80,189,692
5267,Sek Henry,2008,2010,Nebraska,Big 12,97,2454,234,564,156,329,78,235,146,219,75,254,329,204,83,26,156,210,692
5268,Lanerryl Johnson,2013,2016,Total,Total,69,1433,232,607,137,346,95,261,133,168,23,83,106,100,41,3,130,110,692
5269,Chris Kaba,2009,2011,Northern Colorado,Big Sky,93,1791,210,495,116,275,94,220,178,235,123,229,352,89,57,38,142,198,692
5270,Nick Okorie,2009,2010,Texas Tech,Big 12,63,1612,230,560,161,376,69,184,163,220,43,139,182,108,68,7,114,187,692
5271,Dwight Thorne,2008,2010,Colorado,Big 12,90,2100,227,494,137,266,90,228,148,180,26,175,201,127,69,5,122,168,692
5272,Jordan Threloff,2012,2015,Total,Total,113,2013,231,443,231,443,0,0,230,335,220,362,582,47,42,68,122,198,692
5273,Johnathon Wilkins,2015,2018,New Mexico State,WAC,133,2489,289,542,261,467,28,75,86,150,183,210,393,136,29,75,152,307,692
5274,Dominique Buckley,2009,2013,Total,Total,116,2363,219,560,88,221,131,339,122,145,22,189,211,209,103,15,150,191,691
5275,Ade Dagunduro,2008,2009,Nebraska,Big 12,64,1543,253,499,226,423,27,76,158,239,101,152,253,99,69,25,120,180,691
5276,Shan Foster,2008,2008,Vanderbilt,SEC,34,1147,242,463,108,177,134,286,73,96,39,128,167,56,36,8,58,66,691
5277,Jordan Harks,2012,2014,Total,Total,86,1691,289,520,288,516,1,4,112,207,157,264,421,67,55,28,83,262,691
5278,Rickey Holden,2018,2019,Cal State Bakersfield,WAC,64,1954,229,574,150,346,79,228,154,182,35,126,161,211,74,4,133,132,691
5279,Quan Jackson,2018,2019,Georgia Southern,Sun Belt,64,1681,238,551,167,338,71,213,144,222,44,201,245,74,109,25,90,113,691
5280,Montel James,2015,2016,Loyola (IL),MVC,65,1529,256,527,253,511,3,16,176,258,112,249,361,35,40,53,102,106,691
5281,Alfred Jones,2009,2011,Tennessee Tech,OVC,95,1895,289,451,278,418,11,33,102,154,163,225,388,49,58,43,81,227,691
5282,Trent Meacham,2008,2009,Illinois,Big Ten,68,2051,223,535,80,186,143,349,102,129,17,149,166,171,55,7,86,161,691
5283,Darian Norris,2009,2012,Total,Total,96,2225,230,583,147,324,83,259,148,197,35,155,190,186,99,3,153,142,691
5284,Marcus Owens,2014,2017,Lamar,Southland,120,2183,230,618,99,239,131,379,100,140,129,241,370,76,64,13,88,254,691
5285,Rob Robinson,2009,2010,Robert Morris,NEC,66,1679,295,577,295,573,0,4,101,227,110,255,365,107,55,57,132,213,691
5286,Warrell Span,2008,2009,Southeastern Louisiana,Southland,60,1772,293,581,282,548,11,33,94,149,119,245,364,81,49,10,125,138,691
5287,Dennis Tinnon,2012,2013,Marshall,CUSA,67,2003,274,532,259,488,15,44,128,187,248,393,641,78,52,19,116,185,691
5288,Ekpe Udoh,2008,2010,Total,Total,68,2096,267,564,254,522,13,42,144,218,199,312,511,126,56,225,123,164,691
5289,Tahj Eaddy,2017,2019,Total,Total,61,1765,226,577,110,283,116,294,122,145,20,131,151,166,52,1,96,93,690
5290,Jeremy Hence,2008,2011,Army,Patriot,94,1857,253,523,200,359,53,164,131,210,132,186,318,92,44,25,130,140,690
5291,Mike Rodriguez,2016,2017,Southern Illinois,MVC,65,1993,209,516,163,366,46,150,226,322,21,120,141,226,85,8,120,143,690
5292,Fatts Russell,2018,2019,Rhode Island,A-10,66,1698,231,674,152,364,79,310,149,198,34,109,143,170,83,11,101,151,690
5293,Dion Waiters,2011,2012,Syracuse,Big East,71,1445,248,547,179,349,69,198,125,166,30,108,138,142,105,16,78,115,690
5294,Will Weathers,2009,2012,Total,Total,76,2154,233,641,176,448,57,193,167,221,54,187,241,351,93,6,216,153,690
5295,Jeff Xavier,2008,2009,Providence,Big East,64,1789,235,616,102,211,133,405,87,111,68,144,212,138,116,12,120,139,690
5296,Jose Alvarado,2018,2019,Georgia Tech,ACC,56,1934,231,558,147,296,84,262,143,186,36,178,214,182,99,5,122,139,689
5297,Raymone Andrews,2010,2014,Total,Total,110,2911,200,554,122,320,78,234,211,299,42,200,242,285,112,29,175,307,689
5298,Chris Cunningham,2010,2014,Total,Total,105,2235,235,516,229,496,6,20,213,290,227,338,565,71,35,50,189,310,689
5299,Percy Gibson,2012,2016,Total,Total,109,1545,283,522,282,517,1,5,122,187,131,244,375,32,35,73,78,189,689
5300,Alfonzo McKinnie,2011,2015,Total,Total,96,1811,271,536,244,459,27,77,120,193,182,313,495,23,47,50,121,264,689
5301,Tosin Mehinti,2014,2017,Alabama-Birmingham,CUSA,130,2417,271,531,271,531,0,0,147,241,214,339,553,97,46,169,189,331,689
5302,Orlando Mendez-Valdez,2008,2009,Western Kentucky,Sun Belt,70,1823,226,514,88,179,138,335,99,126,58,142,200,219,76,14,136,146,689
5303,Gerardo Suero,2012,2012,Albany (NY),AEC,32,1015,220,479,191,398,29,81,220,265,68,116,184,100,42,11,134,82,689
5304,Ryan Betley,2017,2019,Pennsylvania,Ivy,52,1616,226,516,106,211,120,305,116,145,41,208,249,57,47,23,72,102,688
5305,Damarcus Croaker,2014,2017,Total,Total,95,2022,269,615,204,396,65,219,85,135,94,203,297,100,52,13,128,137,688
5306,Brandon Evans,2008,2011,Total,Total,84,1484,204,490,135,315,69,175,211,275,101,177,278,77,58,4,135,121,688
5307,Dynile Forbes,2009,2010,Louisiana-Monroe,Sun Belt,59,1574,207,508,104,225,103,283,171,222,36,154,190,52,62,8,84,103,688
5308,George Hill,2008,2008,IUPUI,Summit,32,1179,220,404,171,295,49,109,199,245,49,167,216,137,57,13,94,89,688
5309,Justin Moss ,2014,2015,Buffalo,MAC,62,1255,244,462,244,458,0,4,200,290,125,270,395,24,38,29,92,151,688
5310,Joe Ragland,2011,2012,Wichita State,MVC,69,1655,236,458,147,245,89,213,127,151,25,132,157,209,51,12,103,143,688
5311,Jahlil Tripp,2018,2019,Pacific,WCC,64,2074,248,524,213,413,35,111,157,233,122,312,434,243,98,10,168,196,688
5312,Isiah Deas,2017,2019,La Salle,A-10,76,1661,230,635,125,310,105,325,122,172,34,190,224,100,58,14,122,124,687
5313,DeJuan Marrero,2014,2017,Total,Total,91,1882,277,630,277,630,0,0,133,229,213,355,568,94,74,46,158,218,687
5314,Jalan McCloud,2017,2018,Total,Total,68,1611,237,518,179,348,58,170,155,194,35,144,179,155,69,16,107,119,687
5315,Jamal Smith,2008,2009,Wagner,NEC,60,1987,266,631,218,469,48,162,107,184,112,206,318,99,70,13,103,138,687
5316,Jake Wiegand,2013,2016,Illinois-Chicago,Horizon,119,1871,239,535,230,488,9,47,200,278,196,261,457,27,36,8,115,268,687
5317,Deilvez Yearby,2009,2010,Purdue-Fort Wayne,Summit,60,1441,257,568,244,533,13,35,160,255,157,294,451,49,31,130,142,153,687
5318,Will Barrett,2010,2014,Princeton,Ivy,112,2028,222,517,93,196,129,321,113,152,72,246,318,114,76,59,113,195,686
5319,Jaylen Fornes,2017,2019,North Carolina-Wilmington,CAA,92,1699,226,544,127,275,99,269,135,179,90,143,233,104,36,10,113,161,686
5320,Andrew Gonzalez,2011,2011,Houston Baptist,GWC,30,1111,204,491,146,342,58,149,220,270,47,119,166,67,47,14,104,70,686
5321,Garrett Jackson,2011,2015,Total,Total,120,2037,267,581,218,435,49,146,103,153,151,223,374,80,57,45,110,231,686
5322,Raekwon Miller,2015,2018,North Carolina-Asheville,Big South,92,1906,210,512,82,173,128,339,138,186,37,207,244,179,93,14,152,175,686
5323,Patrick Mitchell,2011,2012,North Dakota,GWC,65,1705,235,553,121,244,114,309,102,154,76,257,333,69,35,97,84,222,686
5324,Jacquan Nobles,2010,2014,Tennessee State,OVC,85,1730,237,556,91,193,146,363,66,80,45,110,155,63,54,3,109,148,686
5325,Keenan Palmore,2013,2015,Old Dominion,Total,100,2159,257,556,256,537,1,19,171,277,102,215,317,219,115,11,173,234,686
5326,Aaron Pogue,2010,2012,Cleveland State,Horizon,101,2307,252,503,251,502,1,1,181,343,213,330,543,86,60,62,180,374,686
5327,Antravious Simmons,2015,2018,Total,Total,104,1637,286,512,285,510,1,2,113,173,162,297,459,71,40,24,103,266,686
5328,Zavier Simpson,2017,2019,Michigan,Big Ten,116,2669,259,584,198,377,61,207,107,179,39,303,342,431,126,6,154,173,686
5329,Jacob Van,2015,2018,Air Force,MWC,99,1840,214,499,135,296,79,203,179,215,19,135,154,157,51,3,118,90,686
5330,Sir Washington,2015,2018,Eastern Washington,Big Sky,123,2432,224,559,170,383,54,176,184,268,90,247,337,154,66,17,119,280,686
5331,Taylor Danaher,2013,2016,Mount St. Mary's,NEC,128,2375,263,482,256,451,7,31,152,206,185,299,484,47,53,127,120,326,685
5332,Jahvaughn Powell,2017,2018,Nicholls State,Southland,63,1905,228,556,90,191,138,365,91,110,18,171,189,242,136,3,177,186,685
5333,Stanley Pringle,2008,2009,Penn State,Big Ten,68,1816,242,573,134,326,108,247,93,129,38,154,192,174,78,10,121,133,685
5334,Manny Quezada,2008,2009,San Francisco,WCC,55,1581,232,545,165,349,67,196,154,189,39,127,166,214,64,4,183,113,685
5335,Eddie Rios,2008,2012,Total,Total,100,1839,232,612,118,296,114,316,107,157,31,130,161,201,80,4,166,138,685
5336,Austen Awosika,2017,2019,Cal State Fullerton,Big West,98,2492,248,543,218,448,30,95,158,249,58,307,365,262,105,30,160,150,684
5337,Daveon Boardingham,2013,2014,Southern Mississippi,CUSA,72,1542,242,421,242,420,0,1,200,299,156,160,316,36,50,81,100,207,684
5338,Levance Fields,2008,2009,Pittsburgh,Big East,61,1938,228,585,153,346,75,239,153,215,43,146,189,403,56,2,116,84,684
5339,Josh Gray,2013,2016,Total,Total,94,2094,262,668,225,497,37,171,123,189,42,166,208,275,123,4,228,191,684
5340,Reid Koenen,2011,2014,Texas State,Total,114,2007,228,550,134,260,94,290,134,172,85,178,263,69,51,25,123,220,684
5341,Andrew Lovedale,2008,2009,Davidson,Southern,71,1838,291,563,291,563,0,0,102,167,165,335,500,41,56,84,85,195,684
5342,Alex Marcotullio,2010,2013,Northwestern,Big Ten,128,2497,222,540,65,115,157,425,83,112,57,194,251,213,116,14,117,266,684
5343,O.J. Mayo,2008,2008,Southern California,Pac-10,33,1216,237,536,149,321,88,215,122,152,35,115,150,109,51,13,117,80,684
5344,Divaldo Mbunga,2008,2009,Montana State,Big Sky,61,1672,260,474,259,471,1,3,163,234,174,214,388,51,28,93,104,159,684
5345,B.J. Miller,2016,2019,Troy,Sun Belt,130,2662,251,525,207,369,44,156,138,182,56,217,273,264,116,20,170,229,684
5346,Austin Nichols,2014,2017,Total,Total,62,1586,294,547,292,536,2,11,94,161,97,216,313,43,33,135,72,101,684
5347,Norense Odiase,2015,2019,Texas Tech,Big 12,126,2223,264,502,263,500,1,2,155,275,231,348,579,80,51,82,158,322,684
5348,Ryan Oliver,2013,2016,Siena,MAAC,119,2410,236,583,100,215,136,368,76,112,73,234,307,125,64,8,98,205,684
5349,Rico Pickett,2008,2010,Total,Total,58,1526,260,623,192,422,68,201,96,146,36,113,149,126,60,16,122,99,684
5350,Jordan Prosser,2011,2014,Bradley,MVC,124,2598,279,566,279,566,0,0,126,213,211,369,580,37,41,21,113,237,684
5351,Jaqawn Raymond,2012,2016,Total,Total,115,2641,214,557,92,223,122,334,134,181,39,222,261,181,85,16,158,228,684
5352,Anthony Allison,2010,2011,Southeast Missouri State,OVC,62,1887,239,615,169,438,70,177,135,191,21,108,129,90,30,6,119,161,683
5353,Boris Bojanovsky,2013,2016,Florida State,ACC,136,2257,244,423,244,419,0,4,195,282,185,284,469,60,66,195,127,281,683
5354,Javon Borum,2009,2011,UC-Riverside,Big West,60,1874,214,552,101,264,113,288,142,175,25,112,137,157,78,7,131,148,683
5355,Darian Bryant,2015,2019,Total,Total,128,3079,267,626,201,412,66,214,83,144,67,232,299,191,63,26,162,196,683
5356,Marcus Capers,2009,2012,Washington State,Total,135,3447,251,485,249,465,2,20,179,278,168,369,537,232,83,82,157,312,683
5357,Justin Castleberry,2008,2009,Bucknell,Patriot,61,1825,215,570,110,274,105,296,148,201,20,191,211,117,71,5,122,127,683
5358,Jaevin Cumberland,2016,2019,Oakland,Horizon,96,1628,204,494,75,167,129,327,146,177,25,105,130,136,47,7,79,112,683
5359,Brian Gilmore,2008,2009,American,Patriot,64,1756,232,457,153,251,79,206,140,190,90,207,297,121,52,10,116,148,683
5360,Jay Greene,2008,2009,Maryland-Baltimore County,AEC,64,2454,215,516,84,164,131,352,122,157,25,157,182,423,74,3,140,133,683
5361,Daylen Harrison,2010,2014,Total,Total,126,2524,239,597,178,405,61,192,144,180,122,301,423,129,103,44,146,194,683
5362,Vance Jackson,2017,2019,Total,Total,64,1723,217,529,109,231,108,298,141,213,64,283,347,129,45,9,122,134,683
5363,Andrew McCarthy,2010,2012,Brown,Ivy,88,1890,279,523,275,505,4,18,121,202,144,331,475,54,22,99,102,171,683
5364,Isaiah White,2016,2019,Total,Total,56,1701,257,613,168,333,89,280,80,111,45,178,223,70,72,52,97,121,683
5365,Kevin Zabo,2015,2018,Total,Total,86,1805,238,598,160,354,78,244,129,171,32,142,174,149,64,3,122,194,683
5366,Tyler Bey,2018,2019,Colorado,Pac-12,68,1577,256,484,251,456,5,28,165,220,125,394,519,39,49,66,108,167,682
5367,Zjori Bosha,2015,2018,Lamar,Southland,116,2426,227,581,124,235,103,346,125,205,129,250,379,106,135,26,89,230,682
5368,Courtney Jackson,2009,2012,Little Rock,Sun Belt,120,2403,282,585,274,555,8,30,110,234,170,382,552,83,41,36,153,252,682
5369,Taylor Johnson,2015,2018,Dartmouth,Ivy,100,1804,237,483,160,282,77,201,131,163,58,166,224,156,57,5,185,169,682
5370,Maurice Miller,2008,2011,Georgia Tech,ACC,115,2279,201,530,132,305,69,225,211,268,52,190,242,342,130,7,232,223,682
5371,Willie Reed,2009,2010,Saint Louis,A-10,67,1657,273,476,273,476,0,0,136,272,143,281,424,33,33,113,97,163,682
5372,Aubrey Williams,2014,2017,Total,Total,88,1777,243,433,243,431,0,2,196,284,187,371,558,70,49,39,89,200,682
5373,Devaugntah Williams,2015,2016,Texas Tech,Big 12,64,1622,226,573,137,322,89,251,141,182,58,134,192,103,56,10,111,109,682
5374,Ryan Woods,2012,2013,NJIT,GWC,57,1627,218,532,80,201,138,331,108,133,48,188,236,78,52,27,67,101,682
5375,John Bowman,2009,2012,Texas State,Southland,120,2394,253,604,200,428,53,176,122,208,84,136,220,163,71,13,205,207,681
5376,DK Eldridge,2014,2015,New Mexico State,WAC,70,1875,246,570,167,339,79,231,110,172,81,171,252,146,57,16,122,140,681
5377,Brandon Holcomb,2013,2016,Radford,Big South,132,2566,273,517,273,517,0,0,135,208,203,356,559,86,60,149,176,280,681
5378,Brandon Kamga,2016,2019,Total,Total,67,1571,248,578,187,414,61,164,124,179,63,175,238,98,54,21,101,152,681
5379,Kevin Love,2008,2008,UCLA,Pac-10,39,1156,227,406,198,324,29,82,198,258,142,273,415,75,27,56,78,73,681
5380,Jaquori McLaughlin,2017,2019,Total,Total,70,2271,221,601,115,293,106,308,133,174,25,151,176,229,61,18,143,177,681
5381,Titus Robinson,2009,2012,Buffalo,MAC,125,2006,220,447,213,428,7,19,234,355,176,187,363,79,53,61,195,297,681
5382,Dante Taylor,2010,2013,Pittsburgh,Big East,136,2170,271,464,271,463,0,1,139,227,286,295,581,50,42,80,92,273,681
5383,J.T. Thompson,2008,2013,Total,Total,112,2128,267,532,263,511,4,21,143,212,158,276,434,67,78,39,107,251,681
5384,Chris Wray,2015,2018,Mount St. Mary's,NEC,108,2449,304,517,304,513,0,4,73,228,243,306,549,163,138,141,126,210,681
5385,Tre Burnette,2015,2016,South Dakota,Summit,65,1422,282,649,222,453,60,196,56,115,112,295,407,74,69,49,97,183,680
5386,Maik Kotsar,2017,2019,South Carolina,SEC,100,2462,288,641,279,608,9,33,95,199,181,292,473,100,87,57,137,295,680
5387,Aaron Mitchell,2010,2011,Longwood,Ind,61,1844,245,543,222,462,23,81,167,229,111,170,281,214,58,18,166,147,680
5388,Roland Nyama,2015,2017,Stony Brook,AEC,98,2047,232,564,146,311,86,253,130,186,90,224,314,112,58,44,113,211,680
5389,Mantoris Robinson,2008,2010,Winthrop,Big South,95,2626,220,547,181,385,39,162,201,295,161,350,511,121,120,79,179,249,680
5390,Jaren Sina,2014,2017,Total,Total,92,2750,197,578,58,186,139,392,147,183,42,156,198,247,50,0,133,114,680
5391,Ramel Thompkins,2015,2018,South Carolina Upstate,A-Sun,94,2155,231,558,90,166,141,392,77,107,89,307,396,100,51,59,77,137,680
5392,Michael Weathers,2017,2019,Total,Total,48,1234,230,531,207,427,23,104,197,265,34,144,178,188,77,52,193,145,680
5393,Robert Williams,2017,2018,Texas A&M,SEC,61,1570,293,496,291,466,2,30,92,170,165,365,530,87,45,155,106,123,680
5394,Albert Almanza,2016,2019,Sam Houston State,Southland,123,2279,228,583,78,181,150,402,73,93,88,250,338,90,60,22,64,284,679
5395,Stan Brown,2010,2013,Lamar,Southland,115,2085,252,544,252,540,0,4,175,273,150,365,515,38,33,72,120,186,679
5396,Preston Dodson,2008,2011,Campbell,A-Sun,117,2175,244,493,244,492,0,1,191,295,167,241,408,75,65,38,120,249,679
5397,Gideon Gamble,2010,2013,Winthrop,Big South,124,2068,259,699,158,362,101,337,60,88,53,225,278,99,52,51,122,217,679
5398,Brandon Goode,2011,2014,Norfolk State,MEAC,116,1825,274,459,274,458,0,1,131,225,167,291,458,27,30,160,116,245,679
5399,Carl Hall,2012,2013,Wichita State,MVC,65,1652,252,454,252,452,0,2,175,263,173,210,383,44,31,81,70,157,679
5400,Darien Johnson,2011,2013,Quinnipiac,NEC,92,2422,204,577,153,429,51,148,220,286,76,206,282,340,73,9,194,237,679
5401,Tom Lacey,2015,2018,Navy,Patriot,111,2384,231,450,230,444,1,6,216,341,225,386,611,125,63,27,152,258,679
5402,John Mooney,2017,2019,Notre Dame,ACC,81,1577,247,532,180,363,67,169,118,168,140,390,530,64,41,42,57,126,679
5403,Casey Oliverson,2014,2016,Southern Utah,Big Sky,88,2045,297,524,295,517,2,7,83,150,145,249,394,45,39,41,96,224,679
5404,Preston Purifoy,2011,2014,Alabama-Birmingham,CUSA,119,2086,210,508,95,201,115,307,144,172,79,150,229,69,45,25,89,236,679
5405,Niko Scott,2008,2010,Columbia,Ivy,81,2104,213,530,106,242,107,288,146,206,54,126,180,134,65,2,135,186,679
5406,Mark Veazey,2008,2011,Navy,Patriot,114,2107,272,546,272,546,0,0,135,182,162,280,442,39,39,111,123,266,679
5407,Gary Wallace,2008,2011,Robert Morris,NEC,134,2724,222,519,146,312,76,207,159,230,81,227,308,180,96,14,178,321,679
5408,LaRon Armstead,2009,2012,Loyola Marymount,WCC,109,2162,207,526,146,340,61,186,203,250,68,236,304,89,58,25,126,160,678
5409,Ethan Chargois,2018,2019,Southern Methodist,AAC,63,1585,234,524,154,290,80,234,130,200,111,222,333,94,53,44,104,175,678
5410,Daniel Hackett,2008,2009,Southern California,Pac-10,64,2200,208,466,144,296,64,170,198,258,25,233,258,260,82,12,179,164,678
5411,Stephen Hurt,2013,2016,Total,Total,92,1748,250,527,229,454,21,73,157,222,143,319,462,63,35,35,153,225,678
5412,Jalen Love,2013,2015,Denver,Total,87,2530,246,565,145,282,101,283,85,125,37,121,158,169,92,9,97,259,678
5413,Jesse Perry,2011,2012,Arizona,Total,73,1806,237,494,219,429,18,65,186,266,147,283,430,72,22,36,93,125,678
5414,Ty Proffitt,2008,2012,Total,Total,99,2499,217,546,93,223,124,323,120,148,38,127,165,160,58,2,108,144,678
5415,Ryan Schneider,2008,2009,Marist,MAAC,64,1601,205,557,83,221,122,336,146,180,61,286,347,56,57,32,95,87,678
5416,Zak Showalter,2013,2017,Wisconsin,Big Ten,129,2599,231,494,141,240,90,254,126,155,86,223,309,169,110,22,102,257,678
5417,Kendall Toney,2008,2010,North Carolina-Greensboro,Southern,92,2018,244,649,92,191,152,458,38,60,61,208,269,117,50,5,104,139,678
5418,Johnny Wolf,2009,2010,North Carolina-Wilmington,CAA,62,1812,214,532,112,245,102,287,148,177,35,146,181,151,33,7,113,58,678
5419,Octavius Brown,2014,2016,Alcorn State,SWAC,51,1643,243,496,186,346,57,150,134,195,87,254,341,42,38,57,80,120,677
5420,J.C. Fuller,2015,2016,Western Illinois,Summit,55,1546,247,611,180,413,67,198,116,141,32,182,214,114,28,18,108,88,677
5421,Jordan Goodwin,2018,2019,Saint Louis,A-10,62,2098,248,636,204,460,44,176,137,235,194,270,464,226,119,28,144,166,677
5422,Robert Johnson,2008,2010,North Carolina A&T,MEAC,83,1845,266,568,212,394,54,174,91,118,107,176,283,78,55,33,126,97,677
5423,Brandis Raley-Ross,2008,2010,South Carolina,SEC,85,2122,236,555,115,242,121,313,84,125,71,164,235,108,56,12,105,150,677
5424,Jerome Segura,2015,2018,Fairfield,MAAC,122,3083,271,691,221,526,50,165,85,153,51,197,248,417,96,3,260,214,677
5425,Dakarai Allen,2014,2017,San Diego State,MWC,133,2476,235,529,194,374,41,155,165,256,97,235,332,116,120,66,128,278,676
5426,Dusty Baker,2016,2018,Weber State,Big Sky,99,2052,195,427,80,183,115,244,171,203,37,248,285,230,57,8,123,139,676
5427,Leyton Hammonds,2014,2017,Oklahoma State,Big 12,120,2043,244,594,144,289,100,305,88,120,108,261,369,60,52,25,96,297,676
5428,Ebuka Izundu,2016,2019,Miami (FL),ACC,110,1843,282,442,281,439,1,3,111,174,226,276,502,50,50,87,104,268,676
5429,A.J. Lawson,2017,2018,North Texas,CUSA,67,1629,259,605,232,493,27,112,131,228,91,221,312,109,60,17,123,187,676
5430,Rashaun McLemore,2008,2011,Total,Total,75,1526,230,531,177,350,53,181,163,250,60,134,194,78,43,10,137,158,676
5431,DeMarcus Robinson,2014,2015,Alabama State,SWAC,61,1769,233,590,137,302,96,288,114,149,42,102,144,114,58,5,75,82,676
5432,Kyle Thomas,2014,2017,Morgan State,MEAC,111,1847,245,705,158,402,87,303,99,151,76,215,291,53,44,43,107,192,676
5433,Armani Chaney,2016,2019,Tennessee State,OVC,107,2341,229,599,143,342,86,257,131,167,34,186,220,265,113,5,209,206,675
5434,Anthony Durham,2015,2019,Rider,MAAC,123,2314,235,534,168,341,67,193,138,180,92,204,296,187,71,9,104,199,675
5435,John Emezie,2016,2019,Army,Patriot,125,2050,225,545,139,296,86,249,139,207,66,167,233,121,85,41,144,208,675
5436,Jalen James,2014,2018,San Jose State,MWC,117,2560,226,639,146,372,80,267,143,188,36,299,335,274,56,18,232,222,675
5437,Branden Johnson,2008,2010,Montana State,Big Sky,90,2010,204,520,101,216,103,304,164,202,124,233,357,77,37,41,92,200,675
5438,Solomon Mangham,2014,2017,Howard,MEAC,104,2249,240,687,137,358,103,329,92,147,152,301,453,40,41,31,95,215,675
5439,Ade Murkey,2017,2019,Denver,Summit,87,1762,246,536,229,478,17,58,166,227,92,183,275,169,59,25,143,170,675
5440,D'Angelo Russell,2015,2015,Ohio State,Big Ten,35,1188,231,515,136,284,95,231,118,156,35,163,198,175,55,11,102,74,675
5441,Nate Tomlinson,2009,2012,Colorado,Total,129,3540,216,486,91,178,125,308,118,163,30,251,281,405,111,2,241,269,675
5442,Benny Valentine,2009,2010,Eastern Washington,Big Sky,57,1450,233,604,142,335,91,269,118,161,17,114,131,166,68,0,131,144,675
5443,Darius Carter,2014,2015,Wichita State,MVC,70,1389,254,485,250,478,4,7,162,252,115,231,346,31,25,49,53,150,674
5444,Donovan Jackson,2017,2018,Iowa State,Big 12,65,1620,216,538,77,204,139,334,103,121,10,86,96,105,33,2,67,106,674
5445,Rob Keefer,2008,2011,Lehigh,Patriot,119,2058,251,618,189,458,62,160,110,137,49,188,237,69,29,9,125,124,674
5446,Scott Rodgers,2008,2009,Drexel,CAA,60,2042,210,626,152,432,58,194,196,286,53,204,257,172,69,13,207,170,674
5447,Hakeem Rogers,2016,2017,Tennessee Tech,OVC,62,1274,213,544,88,195,125,349,123,157,18,133,151,53,48,4,78,92,674
5448,Brandon Sampson,2016,2018,Louisiana State,SEC,85,1720,226,511,141,249,85,262,137,184,46,152,198,86,52,19,107,117,674
5449,D.J. Shelton,2012,2014,Washington State,Pac-12,98,2314,231,541,178,350,53,191,159,233,152,437,589,116,52,47,147,195,674
5450,Allen Smith,2008,2011,Arkansas-Pine Bluff,SWAC,95,2437,214,607,78,215,136,392,110,160,35,119,154,200,63,4,154,169,674
5451,Tracey Worley,2008,2009,New Orleans,Sun Belt,60,1504,225,541,144,301,81,240,143,187,46,126,172,54,43,2,100,87,674
5452,Joel Awich,2013,2016,Cal Poly,Big West,114,2280,248,625,191,434,57,191,120,164,124,303,427,66,48,111,118,238,673
5453,Noah Blackwell,2016,2019,Total,Total,91,2236,243,598,96,218,147,380,40,52,37,170,207,234,60,11,113,158,673
5454,Norbertas Giga,2017,2018,Jacksonville State,OVC,69,1883,258,557,227,455,31,102,126,171,128,367,495,108,39,59,158,168,673
5455,Mattias Markusson,2017,2019,Loyola Marymount,WCC,90,1829,277,469,276,463,1,6,118,166,146,303,449,52,35,76,94,196,673
5456,Dinero Mercurius,2015,2019,Total,Total,92,1799,217,513,95,183,122,330,117,146,47,124,171,86,74,4,83,168,673
5457,Marcel Pettway,2016,2017,Bryant,NEC,62,1882,291,494,291,494,0,0,91,173,146,273,419,103,64,32,112,149,673
5458,Otis Polk,2008,2010,Bowling Green State,MAC,93,2138,252,486,252,486,0,0,169,273,255,268,523,57,45,128,146,325,673
5459,Jordan Reed,2015,2019,Total,Total,100,2627,223,657,77,201,146,456,81,99,45,179,224,149,60,7,143,189,673
5460,Zac Seljaas,2016,2019,Brigham Young,WCC,102,2118,229,500,94,168,135,332,80,105,60,215,275,132,57,38,78,188,673
5461,Jay-R Strowbridge,2008,2011,Total,Total,83,1924,225,596,118,290,107,306,116,148,49,119,168,120,48,4,92,154,673
5462,Julian Welch,2010,2013,Total,Total,98,1847,223,522,139,302,84,220,143,196,31,160,191,191,73,12,154,173,673
5463,Cole Gentry,2017,2019,Total,Total,70,2093,225,531,128,254,97,277,125,145,21,155,176,195,83,1,91,111,672
5464,Treshawn Hagood,2012,2015,Total,Total,85,2200,237,596,214,501,23,95,175,286,74,208,282,303,131,4,215,160,672
5465,Spencer Haldeman,2017,2019,Northern Iowa,MVC,95,1964,197,529,54,127,143,402,135,165,12,164,176,95,64,6,87,166,672
5466,Tim Pierce,2008,2009,San Jose State,WAC,59,1551,229,604,116,260,113,344,101,160,65,200,265,44,46,13,90,107,672
5467,Ishaq Pitt,2012,2015,Maryland-Eastern Shore,MEAC,117,2686,230,543,226,518,4,25,208,366,134,319,453,306,104,17,245,215,672
5468,Derrell Taylor,2012,2015,Jackson State,SWAC,116,2464,236,461,236,459,0,2,200,274,217,307,524,67,77,47,135,266,672
5469,Michael Turner,2008,2009,Hartford,AEC,67,2212,209,489,120,254,89,235,165,226,88,305,393,200,125,8,165,232,672
5470,Chancellor Barnard,2015,2019,Total,Total,124,2906,262,464,258,445,4,19,143,248,194,310,504,83,49,112,138,290,671
5471,Aksel Bolin,2011,2014,Northern Illinois,MAC,114,2633,223,516,149,293,74,223,151,216,157,303,460,123,71,26,160,225,671
5472,Derrick Caracter,2008,2010,Total,Total,62,1313,259,462,254,446,5,16,148,227,144,232,376,46,48,54,140,189,671
5473,LaRon Dendy,2010,2012,Total,Total,58,1327,244,445,232,404,12,41,171,320,110,220,330,80,37,80,99,136,671
5474,Reggie Hearn,2010,2013,Northwestern,Big Ten,95,1923,221,484,144,266,77,218,152,202,66,200,266,95,59,22,110,184,671
5475,Bernard James ,2011,2012,Florida State,ACC,69,1698,274,437,274,437,0,0,123,233,181,303,484,24,55,164,123,124,671
5476,Michael Kibiloski,2011,2014,Purdue-Fort Wayne,Summit,113,1967,234,538,94,180,140,358,63,85,109,203,312,73,48,16,88,246,671
5477,Mathiang Muo,2010,2013,Total,Total,88,1915,217,550,75,209,142,341,95,123,93,210,303,55,50,15,103,180,671
5478,Jared Nickens,2015,2018,Maryland,Big Ten,136,2219,224,598,45,119,179,479,44,59,39,151,190,49,29,21,59,134,671
5479,Jaysean Paige,2015,2016,West Virginia,Big 12,69,1238,239,544,161,320,78,224,115,159,91,95,186,65,90,13,85,177,671
5480,Ray Reese,2008,2009,Tulsa,CUSA,75,1976,226,549,115,257,111,292,108,145,87,193,280,144,62,15,133,159,671
5481,Dustin Scott,2008,2009,College of Charleston,Southern,68,1922,270,514,226,386,44,128,87,145,127,350,477,143,93,89,146,223,671
5482,C.J. Bobbitt,2016,2019,Total,Total,89,1833,246,534,189,360,57,174,121,182,90,233,323,102,40,14,130,226,670
5483,Julius Cheeks,2009,2010,Mississippi Valley State,SWAC,59,1702,214,573,102,252,112,321,130,174,32,155,187,128,68,2,132,140,670
5484,Adam Constantine,2008,2010,Elon,Southern,88,2027,265,448,265,446,0,2,140,252,171,377,548,48,45,78,113,213,670
5485,Tevin Galvin,2009,2012,Jacksonville,A-Sun,118,2511,232,616,159,349,73,267,133,214,214,293,507,133,104,25,153,233,670
5486,Grandy Glaze,2012,2016,Total,Total,101,1639,289,521,289,510,0,11,92,154,140,373,513,52,46,13,96,126,670
5487,Paris Gulley,2012,2013,Milwaukee,Horizon,60,1904,223,614,112,314,111,300,113,150,47,131,178,67,35,2,88,101,670
5488,T.J. Hall,2011,2014,Ohio,MAC,139,2126,232,631,141,302,91,329,115,170,107,220,327,135,77,24,151,333,670
5489,Shawn Occeus,2017,2019,Northeastern,CAA,79,2004,225,525,118,217,107,308,113,165,30,152,182,115,110,34,112,164,670
5490,Ty Outlaw,2014,2019,Total,Total,98,2056,226,502,73,159,153,343,65,85,73,266,339,58,48,36,57,180,670
5491,Jabari Parker,2014,2014,Duke,ACC,35,1074,236,499,198,393,38,106,160,214,105,201,306,41,37,43,81,83,670
5492,KJ Robinson,2017,2019,Omaha,Summit,88,1975,242,597,144,337,98,260,88,108,16,123,139,191,60,5,123,99,670
5493,Josh Southern,2008,2011,Boston College,ACC,118,2189,247,474,247,474,0,0,176,260,158,307,465,113,40,61,127,303,670
5494,A.J. Tyler,2009,2011,Central Florida,CUSA,86,1939,258,546,221,417,37,129,117,152,121,237,358,52,37,38,88,182,670
5495,John Wilkins,2011,2013,Illinois State,MVC,94,2053,219,500,135,257,84,243,148,192,118,242,360,61,32,65,95,242,670
5496,Eric Gordon,2008,2008,Indiana,Big Ten,32,1110,184,425,114,217,70,208,231,277,23,81,104,78,42,20,115,69,669
5497,Brandon Jackson,2017,2019,Southern Illinois-Edwardsville,OVC,91,1757,273,544,262,498,11,46,112,177,149,195,344,21,30,26,127,209,669
5498,Tyler Lewis,2013,2017,Total,Total,133,2435,207,507,144,298,63,209,192,241,32,143,175,402,56,3,116,188,669
5499,Danny Piepoli,2009,2011,Montana State,Big Sky,88,1973,217,542,67,152,150,390,85,101,40,147,187,71,31,6,80,92,669
5500,Jeffrey Solarin,2014,2015,Idaho State,Big Sky,58,1795,292,507,292,506,0,1,85,148,219,288,507,54,36,35,96,130,669
5501,Dantez Walton,2017,2019,Northern Kentucky,Horizon,96,1818,254,586,158,258,96,328,65,102,137,232,369,141,63,42,101,195,669
5502,Sheldon Cooley,2010,2013,East Tennessee State,A-Sun,99,2134,238,577,209,474,29,103,163,229,80,194,274,177,133,4,165,161,668
5503,Brennan Cougill,2010,2013,Total,Total,91,1902,249,525,192,343,57,182,113,146,135,325,460,123,44,51,158,162,668
5504,Darius Cox,2008,2010,Tennessee State,OVC,81,1943,277,529,262,472,15,57,99,151,181,274,455,93,66,75,107,215,668
5505,Andrew Ferry,2009,2012,Total,Total,78,1834,224,562,57,126,167,436,53,72,19,141,160,76,48,3,67,78,668
5506,Melvin Goins,2008,2011,Total,Total,94,2252,226,625,166,431,60,194,156,210,60,191,251,219,141,8,173,194,668
5507,Marshall Harris,2012,2015,Citadel,Southern,119,2895,186,472,97,219,89,253,207,266,28,186,214,438,116,5,257,242,668
5508,Nate Linhart,2008,2009,Akron,MAC,71,2091,229,521,143,277,86,244,124,164,113,273,386,106,119,35,110,189,668
5509,David McFarland,2018,2019,Southern Illinois-Edwardsville,OVC,60,1608,226,577,137,275,89,302,127,164,45,169,214,94,81,15,86,154,668
5510,Rashad Reed,2009,2010,Indiana State,MVC,64,2058,215,594,97,247,118,347,120,159,35,193,228,150,70,4,149,136,668
5511,Matt Spadafora,2008,2010,Maryland-Baltimore County,AEC,95,2818,244,629,188,467,56,162,124,197,85,263,348,138,69,25,82,251,668
5512,Marquis Sullivan,2008,2009,Loyola (MD),MAAC,60,1230,225,533,68,151,157,382,61,73,21,90,111,24,40,10,63,78,668
5513,Tommie Sykes,2010,2011,Louisiana-Monroe,Sun Belt,61,1597,196,389,196,388,0,1,276,430,174,180,354,51,63,12,131,208,668
5514,Julius Thomas,2008,2010,Portland State,Big Sky,90,1933,274,410,274,409,0,1,120,253,171,262,433,132,88,50,109,211,668
5515,Faisal Aden,2011,2012,Washington State,Total,50,1250,254,579,183,366,71,213,88,106,34,124,158,66,67,10,115,71,667
5516,Miles Bowman,2013,2017,Total,Total,77,1427,226,448,183,338,43,110,172,205,129,287,416,35,28,30,76,122,667
5517,Octavius Ellis,2012,2016,Cincinnati,Total,70,1835,241,438,241,437,0,1,185,278,188,310,498,83,56,119,151,187,667
5518,Ali Farokhmanesh,2009,2010,Northern Iowa,MVC,69,2052,215,546,63,141,152,405,85,105,12,104,116,93,40,1,67,136,667
5519,Leon Gilmore,2015,2018,Total,Total,75,1653,246,499,232,429,14,70,161,245,116,256,372,97,62,26,130,153,667
5520,Jack Houpt,2011,2013,Western Illinois,Summit,94,2927,222,546,71,160,151,386,72,83,41,271,312,121,45,40,102,188,667
5521,Wally Judge,2010,2014,Total,Total,115,2073,256,533,256,531,0,2,155,298,206,329,535,81,39,78,169,339,667
5522,Jonathan Mills,2012,2013,Southern Mississippi,CUSA,71,1862,246,486,246,486,0,0,175,278,228,276,504,77,58,23,125,203,667
5523,Gary Patterson,2008,2009,IUPUI,Summit,58,2014,217,531,77,208,140,323,93,108,21,96,117,155,65,1,73,95,667
5524,Patrick Saunders,2009,2012,Princeton,Ivy,118,2505,246,526,147,259,99,267,76,93,76,265,341,98,43,49,109,262,667
5525,Brandon Spearman,2011,2014,Total,Total,91,1925,233,562,148,316,85,246,116,181,105,144,249,91,63,12,86,161,667
5526,Greg Washington,2008,2011,Hofstra,CAA,123,2727,284,619,284,617,0,2,99,155,232,397,629,71,83,275,114,345,667
5527,Yosef Yacob,2014,2018,Binghamton,AEC,91,2126,198,557,94,245,104,312,167,227,19,98,117,145,56,2,174,146,667
5528,Demetrece Young,2010,2011,Pacific,Big West,66,2157,214,523,88,192,126,331,113,140,18,116,134,212,44,0,103,80,667
5529,Ivan Canete,2017,2018,Stephen F. Austin,Southland,66,1559,219,488,123,249,96,239,132,168,37,155,192,156,99,16,138,217,666
5530,Robert Cartwright,2015,2019,Total,Total,131,2464,224,611,138,335,86,276,132,171,32,187,219,283,94,8,146,187,666
5531,Gary Chivichyan,2016,2019,Idaho State,Big Sky,86,1572,223,533,48,100,175,433,45,64,13,143,156,30,23,10,47,85,666
5532,Marcus Kitts,2008,2011,William & Mary,CAA,109,1995,277,476,277,476,0,0,112,256,200,304,504,98,43,110,151,233,666
5533,Darius Morris,2010,2011,Michigan,Big Ten,67,1996,253,539,230,436,23,103,137,197,45,152,197,319,56,6,154,135,666
5534,Neal Pitt,2009,2010,Maryland-Eastern Shore,MEAC,55,1509,241,524,220,449,21,75,163,265,143,247,390,37,37,20,131,159,666
5535,Kinu Rochford,2012,2013,Fairleigh Dickinson,NEC,56,1521,282,488,282,487,0,1,102,172,177,262,439,81,42,62,121,206,666
5536,Larry Toomey,2013,2016,Army,Patriot,125,2554,225,587,137,307,88,280,128,187,145,394,539,197,65,44,156,267,666
5537,Demetrius Williamson,2008,2010,Niagara,MAAC,96,2057,230,624,111,243,119,381,87,157,112,211,323,55,57,48,81,195,666
5538,Prince Ali,2016,2019,UCLA,Pac-12,88,1738,231,541,146,292,85,249,118,185,48,155,203,95,69,13,112,141,665
5539,Sim Bhullar,2013,2014,New Mexico State,WAC,65,1643,264,417,264,417,0,0,137,276,169,299,468,68,7,186,107,156,665
5540,Ryan Butler,2008,2010,Richmond,A-10,100,2466,228,527,104,191,124,336,85,118,49,242,291,183,155,25,143,263,665
5541,Mark Hall,2008,2011,Mercer,A-Sun,127,2561,186,526,56,170,130,356,163,212,65,147,212,191,91,3,169,286,665
5542,Emmanuel Jones,2008,2009,Texas-Rio Grande Valley,Ind,48,1215,259,467,258,461,1,6,146,220,97,202,299,47,33,40,90,100,665
5543,Dexter Kernich-Drew,2012,2015,Washington State,Pac-12,123,2252,227,559,100,214,127,345,84,117,42,155,197,94,28,19,106,207,665
5544,Brian McKenzie,2008,2010,Providence,Big East,94,2182,239,584,121,252,118,332,69,106,110,207,317,125,71,6,130,217,665
5545,Byron Mulkey,2008,2011,Buffalo,MAC,74,1817,226,550,153,349,73,201,140,177,18,172,190,233,117,1,150,128,665
5546,Morris Smith,2009,2010,Texas-San Antonio,Southland,62,1591,236,593,112,256,124,337,69,90,40,193,233,45,53,15,80,76,665
5547,Jeremiah Bowman,2011,2012,Longwood,Ind,52,1690,223,436,199,371,24,65,194,273,61,127,188,261,66,5,137,145,664
5548,Charles Brown III,2018,2019,Incarnate Word,Southland,55,1431,245,483,201,373,44,110,130,156,54,159,213,55,38,7,121,128,664
5549,Miguel Dicent,2015,2017,Morehead State,OVC,94,2022,231,578,123,271,108,307,94,125,38,148,186,197,60,19,126,239,664
5550,Jaylen Fisher,2017,2019,Texas Christian,Big 12,61,1714,226,532,113,256,113,276,99,125,23,93,116,255,64,8,134,131,664
5551,Evan Gilyard,2018,2019,Texas-El Paso,CUSA,59,1540,208,551,127,307,81,244,167,215,30,116,146,99,46,1,129,133,664
5552,Rafriel Guthrie,2013,2014,Towson,CAA,67,1557,214,507,166,364,48,143,188,297,67,119,186,63,52,7,108,159,664
5553,Terrell Kennedy,2009,2013,Arkansas-Pine Bluff,SWAC,89,1727,240,552,205,445,35,107,149,210,97,196,293,113,57,30,122,222,664
5554,John Marshall,2014,2017,Southern Utah,Big Sky,120,2624,190,471,156,371,34,100,250,337,64,217,281,285,110,10,161,266,664
5555,Will Martell,2008,2011,Rhode Island,A-10,117,2181,273,497,273,494,0,3,118,187,173,306,479,69,36,87,118,267,664
5556,Rene Rougeau,2008,2009,Nevada-Las Vegas,MWC,67,1886,278,521,276,509,2,12,106,151,158,275,433,103,121,103,104,189,664
5557,Tyrone Shelley,2008,2010,Total,Total,62,1381,234,568,170,347,64,221,132,192,90,201,291,54,89,30,127,149,664
5558,Deonte Alexander,2012,2013,Lipscomb,A-Sun,60,1675,246,592,131,270,115,322,56,80,30,169,199,105,73,12,86,130,663
5559,Wajid Aminu,2018,2019,North Florida,A-Sun,61,1565,252,506,240,452,12,54,147,222,136,264,400,94,53,97,107,181,663
5560,Rodney Foster,2008,2009,Rice,CUSA,57,1857,202,584,85,238,117,346,142,175,23,142,165,224,73,6,166,137,663
5561,John Green,2012,2016,UC-Santa Barbara,Big West,62,1441,252,573,197,418,55,155,104,153,79,191,270,89,38,11,103,185,663
5562,Kramer Knutson,2008,2011,Portland,WCC,122,2691,263,480,263,478,0,2,137,257,187,271,458,108,57,80,124,327,663
5563,Louis Munks,2012,2014,Prairie View,SWAC,69,1466,222,587,142,336,80,251,139,187,42,171,213,47,50,13,106,130,663
5564,Payten Ricks,2017,2019,Abilene Christian,Southland,88,2058,206,512,89,202,117,310,134,172,15,155,170,142,97,2,116,151,663
5565,Edmond Sumner,2015,2017,Xavier,Big East,58,1541,205,478,168,348,37,130,216,296,30,172,202,223,68,22,128,132,663
5566,Dorrian Williams,2013,2016,Missouri State,MVC,112,3102,231,656,165,421,66,235,135,196,38,339,377,373,111,6,207,219,663
5567,Jamaal Womack,2008,2009,St. Francis (NY),NEC,59,1957,226,670,97,260,129,410,82,115,36,126,162,183,77,0,123,135,663
5568,Mark Yelovich,2011,2013,Southern Illinois-Edwardsville,Total,49,1376,249,550,227,473,22,77,143,210,73,225,298,63,47,22,99,107,663
5569,Charlie Jones,2014,2017,American,Patriot,120,3113,231,456,165,286,66,170,134,189,76,377,453,199,124,56,116,222,662
5570,Terry Martin,2008,2011,Wofford,Southern,130,1794,226,455,225,451,1,4,209,283,165,245,410,63,51,24,141,317,662
5571,Donley Minor,2010,2013,Lamar,Southland,125,2388,226,636,133,352,93,284,117,148,63,162,225,211,74,12,180,196,662
5572,Marin Mornar,2013,2016,Loyola Marymount,WCC,115,2176,245,504,191,346,54,158,118,162,146,283,429,60,27,131,93,217,662
5573,Jeff Smith,2010,2011,Mercer,A-Sun,52,1692,216,515,142,301,74,214,156,229,32,109,141,187,47,3,173,125,662
5574,Vitto Brown,2014,2017,Wisconsin,Big Ten,120,1918,251,593,169,360,82,233,77,108,119,253,372,76,45,44,110,205,661
5575,Junior Cadougan,2010,2013,Marquette,Big East,117,2713,231,567,206,452,25,115,174,256,41,205,246,435,98,11,238,197,661
5576,Phil Gaetano,2012,2015,Sacred Heart,NEC,123,3781,198,558,63,175,135,383,130,150,34,289,323,730,109,8,355,228,661
5577,Alex Galindo,2008,2009,Florida International,Sun Belt,48,1520,223,519,130,243,93,276,122,171,59,226,285,86,36,15,129,132,661
5578,Reggie Larry,2008,2008,Boise State,WAC,34,1169,244,455,207,369,37,86,136,213,84,229,313,62,48,35,90,67,661
5579,Javante McCoy,2018,2019,Boston University,Patriot,63,1741,237,544,143,312,94,232,93,126,34,145,179,125,60,10,106,111,661
5580,Mathias Seilund,2011,2014,Fairleigh Dickinson,NEC,113,2331,234,574,153,363,81,211,112,135,121,205,326,71,62,82,132,276,661
5581,David Stockton,2011,2014,Gonzaga,WCC,138,2741,223,526,153,297,70,229,145,207,20,205,225,423,167,11,202,230,661
5582,Jalin Thomas,2010,2011,Central Michigan,MAC,56,1676,206,534,135,324,71,210,178,231,119,168,287,26,35,2,84,112,661
5583,Brison White,2013,2014,Northwestern State,Southland,63,1399,263,575,223,418,40,157,95,145,40,111,151,133,93,13,84,108,661
5584,Thomas Capuano,2016,2019,Manhattan,MAAC,126,3054,242,594,120,269,122,325,54,89,40,215,255,195,122,3,132,244,660
5585,Nat Dixon,2017,2019,Total,Total,92,2355,215,521,112,241,103,280,127,181,72,183,255,126,70,17,106,146,660
5586,Sean Gardner,2015,2016,Arkansas State,Sun Belt,59,1869,235,615,143,333,92,282,98,124,74,129,203,86,60,15,95,130,660
5587,T.J. Henderson,2016,2018,IUPUI,Total,94,1809,211,509,119,258,92,251,146,191,32,150,182,150,92,13,155,162,660
5588,Elijah Hughes,2017,2019,Total,Total,59,1623,213,534,102,211,111,323,123,172,34,171,205,82,56,38,87,118,660
5589,Luther Page,2012,2015,Alabama State,SWAC,124,2624,227,502,227,499,0,3,206,381,249,310,559,89,88,66,205,280,660
5590,Delvon Roe,2009,2011,Michigan State,Big Ten,109,2248,235,440,235,440,0,0,190,324,210,343,553,127,74,106,130,281,660
5591,Goran Suton,2008,2009,Michigan State,Big Ten,68,1814,259,483,236,423,23,60,119,146,195,369,564,116,74,49,118,181,660
5592,Sama Taku,2013,2014,Pacific,Total,69,1834,241,612,199,473,42,139,136,178,38,221,259,141,52,1,117,152,660
5593,Amir Williams,2012,2015,Ohio State,Big Ten,134,2254,236,392,236,392,0,0,188,317,224,338,562,27,53,187,123,274,660
5594,Myo Baxter-Bell,2017,2019,Liberty,Total,107,1634,252,526,250,499,2,27,153,205,97,187,284,121,77,18,135,237,659
5595,Lewis Clinch,2008,2009,Georgia Tech,ACC,56,1585,233,610,118,268,115,342,78,117,36,110,146,114,35,8,125,120,659
5596,Will Holland,2008,2010,Mount St. Mary's,NEC,90,1982,220,599,91,236,129,363,90,130,61,251,312,74,65,14,119,143,659
5597,Eric Jacobsen,2013,2016,Arizona State,Pac-12,130,2258,239,415,238,413,1,2,180,305,205,275,480,65,31,88,125,330,659
5598,Durand Johnson,2013,2016,Total,Total,79,1572,222,573,119,272,103,301,112,149,43,168,211,92,61,17,90,159,659
5599,Marcelus Kemp,2008,2008,Nevada,WAC,33,1058,222,494,152,310,70,184,145,168,43,136,179,109,23,10,81,63,659
5600,Lloyd Phillips,2009,2010,Illinois State,MVC,64,2086,210,537,110,266,100,271,139,187,22,120,142,249,95,8,158,101,659
5601,Jose Rodriguez,2014,2016,Texas Southern,SWAC,65,1496,226,486,173,358,53,128,154,228,76,218,294,96,27,9,112,182,659
5602,Chris Thomas,2015,2018,Southern,SWAC,120,2190,236,606,205,468,31,138,156,271,138,274,412,64,49,38,115,252,659
5603,Devin Wilson,2014,2018,Virginia Tech,ACC,129,3298,195,470,164,362,31,108,238,368,41,276,317,414,93,10,204,273,659
5604,Randy Berry,2008,2010,Green Bay,Horizon,92,2456,205,385,205,382,0,3,248,321,233,357,590,62,36,68,126,292,658
5605,Gabe Blair,2008,2011,Total,Total,97,2051,257,523,257,522,0,1,144,209,179,396,575,83,95,79,101,250,658
5606,Carlton Brundidge,2012,2016,Total,Total,111,1726,230,534,197,416,33,118,165,240,84,169,253,153,77,8,117,152,658
5607,Eric Buckner,2011,2012,Georgia State,CAA,65,1798,262,447,262,447,0,0,134,249,161,256,417,24,40,167,102,195,658
5608,Alex Garcia-Mendoza,2010,2011,Little Rock,Sun Belt,66,1796,218,493,172,377,46,116,176,229,89,160,249,68,43,7,90,176,658
5609,Derrik Jamerson Jr.,2018,2019,Norfolk State,MEAC,69,1814,223,484,56,111,167,373,45,51,83,159,242,32,50,26,41,166,658
5610,Andre Murray,2008,2009,Portland State,Big Sky,65,1710,244,522,163,299,81,223,89,133,73,174,247,137,69,19,136,125,658
5611,Michael Porrini,2011,2012,Kent State,MAC,69,2131,226,574,172,402,54,172,152,230,96,236,332,311,118,28,196,171,658
5612,Ty Taylor II,2016,2019,Total,Total,85,1578,230,630,142,350,88,280,110,153,43,187,230,107,47,10,101,109,658
5613,Deontay Twyman,2008,2011,Total,Total,80,1701,223,551,142,319,81,232,131,165,43,176,219,184,46,9,120,154,658
5614,Marcel Boyd,2014,2017,Howard,MEAC,123,2767,226,487,226,486,0,1,205,365,282,478,760,63,37,126,207,355,657
5615,Nate Buss,2012,2015,Northern Iowa,MVC,90,1427,241,483,149,275,92,208,83,103,70,196,266,20,16,30,52,144,657
5616,Kurt Cunningham,2008,2010,Boise State,WAC,97,1453,270,425,269,421,1,4,116,173,110,199,309,105,34,17,134,211,657
5617,Trency Jackson,2013,2015,Total,Total,68,1836,210,544,127,317,83,227,154,238,51,135,186,143,70,3,123,150,657
5618,Brandon Knight,2011,2011,Kentucky,SEC,38,1363,217,513,130,282,87,231,136,171,25,128,153,159,25,8,120,83,657
5619,Jahlil Okafor,2015,2015,Duke,ACC,38,1143,279,420,279,420,0,0,99,194,134,188,322,49,29,54,95,81,657
5620,Quincy Roberts,2009,2012,Total,Total,61,1457,215,544,158,356,57,188,170,213,48,161,209,72,40,8,127,85,657
5621,Christian Siakam,2009,2012,IUPUI,Summit,111,1757,279,474,273,465,6,9,93,123,214,249,463,47,49,43,104,266,657
5622,Jared Swopshire,2009,2013,Total,Total,133,2313,220,545,162,361,58,184,159,212,154,357,511,121,59,37,114,164,657
5623,Tomas Vazquez-Simmons,2008,2011,Canisius,MAAC,124,3172,238,525,177,346,61,179,120,179,283,414,697,90,51,273,133,307,657
5624,O.J. Avworo,2009,2011,Navy,Patriot,90,2730,190,476,175,388,15,88,261,421,37,228,265,388,87,8,243,236,656
5625,Ryan Ayers,2008,2009,Notre Dame,Big East,69,1977,223,501,74,160,149,341,61,79,52,179,231,90,54,40,45,118,656
5626,Bryson Barnes,2009,2012,Furman,Southern,92,1640,222,515,186,405,36,110,176,249,132,296,428,50,41,87,132,219,656
5627,Remi Barry,2012,2015,New Mexico State,WAC,89,1696,224,504,165,346,59,158,149,200,83,191,274,56,24,13,94,124,656
5628,Justin Bassey,2017,2019,Harvard,Ivy,85,2526,214,431,130,213,84,218,144,200,103,381,484,171,82,16,161,178,656
5629,Jeff Early,2012,2013,Southern Illinois,MVC,61,1612,259,533,247,475,12,58,126,186,132,204,336,58,87,15,107,159,656
5630,Ryan Frazier,2013,2016,Bucknell,Patriot,128,2677,190,520,116,286,74,234,202,266,32,152,184,174,63,6,111,242,656
5631,Taylor Funk,2018,2019,Saint Joseph's,A-10,65,1823,229,570,91,180,138,390,60,75,69,266,335,87,45,30,68,145,656
5632,Dijuan Harris,2008,2010,Charlotte,A-10,96,2910,190,450,139,311,51,139,225,321,47,213,260,474,117,9,181,248,656
5633,Abayomi Iyiola,2018,2019,Stetson,A-Sun,63,1324,274,547,273,536,1,11,107,151,162,272,434,19,46,58,75,185,656
5634,Loren Jackson,2017,2019,Total,Total,67,1684,203,548,114,262,89,286,161,208,31,102,133,153,51,5,106,120,656
5635,Isiah Jones,2013,2016,Total,Total,80,1833,221,587,88,209,133,378,81,118,34,170,204,172,84,6,137,162,656
5636,Taylor Montgomery,2008,2011,Northern Colorado,Big Sky,120,2622,216,553,196,502,20,51,204,321,211,302,513,60,63,31,139,292,656
5637,LaShay Page,2011,2013,Total,Total,69,1923,216,590,94,235,122,355,102,131,27,170,197,51,31,6,73,115,656
5638,K.C. Ross-Miller,2013,2015,Total,Total,95,2390,181,476,127,300,54,176,240,302,31,166,197,256,110,3,199,229,656
5639,Nathan Walkup,2008,2011,Texas A&M,Big 12,128,1971,230,501,149,253,81,248,115,170,132,271,403,98,58,12,93,213,656
5640,Jeff White,2013,2016,Loyola (IL),Total,126,2954,242,579,197,444,45,135,127,168,39,245,284,312,107,9,202,224,656
5641,Jaylen Allen,2014,2017,Wofford,Southern,130,1954,231,582,114,269,117,313,76,121,48,173,221,94,113,8,120,233,655
5642,Corey Henderson,2015,2018,Total,Total,91,1783,206,573,70,188,136,385,107,136,17,95,112,82,40,3,69,98,655
5643,Jacob Iati,2009,2013,Total,Total,112,2029,201,501,48,119,153,382,100,124,24,115,139,116,63,0,88,129,655
5644,Denzel Keyes,2014,2018,North Carolina A&T,MEAC,104,2138,246,532,208,383,38,149,125,213,201,267,468,66,61,23,95,195,655
5645,Reggie Smith,2011,2015,Total,Total,85,1670,197,500,129,290,68,210,193,272,26,148,174,155,66,7,150,125,655
5646,Kyle Steward,2014,2017,Total,Total,83,1678,227,517,146,311,81,206,120,172,100,228,328,56,46,32,96,181,655
5647,Tom Vodanovich,2014,2017,James Madison,CAA,120,2674,250,520,217,382,33,138,122,195,132,356,488,86,56,34,181,330,655
5648,Craig Bowman,2015,2018,Florida A&M,MEAC,99,1986,206,622,139,371,67,251,175,268,34,176,210,154,95,4,179,181,654
5649,Brandon Costner,2008,2009,North Carolina State,ACC,60,1597,208,495,134,271,74,224,164,211,70,249,319,132,27,49,160,144,654
5650,Konner Frey,2015,2018,Total,Total,66,1374,223,490,159,311,64,179,144,198,114,262,376,58,39,14,92,181,654
5651,Justin Holiday,2008,2011,Washington,Pac-10,123,2414,252,569,194,400,58,169,92,125,160,288,448,188,94,62,128,199,654
5652,Dee Oldham,2013,2016,Total,Total,101,2119,210,538,125,287,85,251,149,192,90,277,367,145,101,13,100,150,654
5653,Dwayne Polee,2011,2015,Total,Total,112,1737,234,541,167,341,67,200,119,173,75,215,290,52,86,42,87,164,654
5654,Marcus Rouse,2010,2013,Stony Brook,AEC,122,2179,243,606,148,328,95,278,73,88,46,132,178,105,87,5,76,161,654
5655,Vernon Taylor,2010,2011,Troy,Sun Belt,60,1460,223,524,178,359,45,165,163,217,76,163,239,82,50,6,114,114,654
5656,Josh Thompson,2010,2013,Wagner,NEC,120,2568,234,584,213,511,21,73,165,234,150,253,403,149,108,51,169,295,654
5657,Kai Williams,2009,2010,South Dakota State,Summit,63,1900,237,528,174,326,63,202,117,160,138,286,424,66,30,12,82,131,654
5658,Christian Wood,2014,2015,Nevada-Las Vegas,MWC,63,1468,235,493,199,355,36,138,148,198,120,306,426,53,21,119,95,132,654
5659,Gibson Johnson,2017,2018,Hawaii,Big West,60,1441,241,460,228,411,13,49,158,235,115,169,284,84,36,37,97,167,653
5660,Izayah Mauriohooho-Le'afa,2017,2019,Sacramento State,Big Sky,89,2597,232,632,103,255,129,377,60,83,27,228,255,242,98,8,138,163,653
5661,John Murry,2016,2017,Austin Peay,OVC,57,1201,208,441,154,284,54,157,183,231,25,101,126,58,32,3,98,72,653
5662,Sean Singletary,2008,2008,Virginia,ACC,33,1122,203,476,145,318,58,158,189,222,26,101,127,202,60,1,128,88,653
5663,Greg Sprink,2008,2008,Navy,Patriot,30,1036,189,523,113,269,76,254,199,232,44,146,190,86,39,5,103,105,653
5664,Dirk Williams,2016,2017,Alabama-Birmingham,CUSA,66,1573,229,522,120,219,109,303,86,102,52,188,240,97,28,26,83,102,653
5665,Javier Carter,2010,2013,South Alabama,Sun Belt,116,2294,252,525,251,521,1,4,147,207,203,344,547,52,72,204,125,229,652
5666,Josh Crittle,2009,2013,Total,Total,116,2082,228,513,228,508,0,5,196,286,158,246,404,96,62,55,159,336,652
5667,Chris Martin,2012,2016,Total,Total,97,1831,219,620,100,240,119,380,95,134,16,160,176,99,55,2,101,117,652
5668,Maurice McNeil,2010,2011,Houston,CUSA,62,1617,243,489,243,489,0,0,166,276,179,285,464,30,38,80,109,141,652
5669,Amos Olatayo,2011,2014,Total,Total,61,1312,238,517,182,334,56,183,120,198,82,169,251,40,60,22,100,97,652
5670,James Padgett,2010,2013,Maryland,ACC,126,1834,246,470,246,470,0,0,160,303,214,237,451,42,26,33,98,151,652
5671,Edvinas Ruzgas,2009,2010,Texas Christian,MWC,63,1980,221,479,102,161,119,318,91,120,50,133,183,47,29,4,50,102,652
5672,Jamaal Samuel,2014,2016,Total,Total,98,1891,268,615,195,389,73,226,43,75,86,274,360,40,32,85,85,198,652
5673,Marlon Stewart,2016,2019,Total,Total,64,1545,214,513,151,309,63,204,161,210,16,129,145,167,58,3,121,129,652
5674,Darien Walker,2015,2016,Valparaiso,Horizon,70,1649,232,598,138,329,94,269,94,137,61,223,284,97,46,13,95,109,652
5675,Michael Weisner,2012,2015,Montana,Big Sky,112,2197,213,474,83,163,130,311,96,110,44,200,244,93,53,36,108,226,652
5676,Sekou Wiggs,2014,2015,Idaho,Total,61,1514,205,445,192,404,13,41,229,330,60,173,233,122,33,7,110,126,652
5677,Gerard Anderson,2009,2010,Cal State Fullerton,Big West,62,1750,231,448,224,413,7,35,182,281,83,285,368,138,72,33,173,177,651
5678,Max Hooper,2012,2016,Total,Total,95,1709,208,490,6,11,202,479,33,38,9,111,120,33,24,4,38,82,651
5679,Lazabian Jackson,2012,2013,Arkansas-Pine Bluff,SWAC,60,1838,219,600,101,234,118,366,95,137,50,174,224,146,109,8,120,129,651
5680,Charles McRoy,2011,2014,North Florida,A-Sun,127,2249,230,563,178,375,52,188,139,200,126,228,354,101,57,13,149,207,651
5681,K.J. Riley,2018,2019,Evansville,MVC,64,1820,179,425,169,363,10,62,283,383,42,227,269,187,71,19,167,167,651
5682,TJ Starks,2018,2019,Texas A&M,SEC,59,1422,240,637,177,404,63,233,108,168,21,102,123,166,45,3,188,116,651
5683,Sultan Toles-Bey,2010,2011,Sacramento State,Big Sky,58,1881,196,584,108,324,88,260,171,205,31,142,173,234,89,7,182,115,651
5684,Frank Toohey,2015,2018,Air Force,MWC,96,1629,205,416,162,308,43,108,198,257,140,173,313,93,31,24,112,242,651
5685,Kashif Watson,2009,2010,Idaho,WAC,62,1838,216,475,208,439,8,36,211,306,57,144,201,147,60,6,130,148,651
5686,Lawrence Borha,2008,2009,Utah,MWC,67,1916,214,461,113,215,101,246,121,146,37,164,201,120,46,14,125,161,650
5687,Jordan Daniels,2012,2015,Total,Total,85,1987,227,562,128,304,99,258,97,116,19,119,138,181,54,7,135,147,650
5688,Tre Drye,2012,2015,Tulane,Total,130,3072,234,480,225,444,9,36,173,300,254,440,694,73,84,30,153,293,650
5689,Marvelle Harris,2011,2014,Campbell,Total,112,2443,266,539,265,534,1,5,117,215,219,395,614,77,78,117,147,300,650
5690,Andre Kennedy,2018,2019,Alabama A&M,SWAC,61,1663,272,555,271,538,1,17,105,167,126,234,360,49,37,36,128,135,650
5691,Sagaba Konate,2017,2019,West Virginia,Big 12,81,1511,254,499,245,476,9,23,133,176,152,291,443,45,35,191,95,209,650
5692,Eddie Miller,2008,2012,Total,Total,70,1562,233,552,162,356,71,196,113,162,57,201,258,88,48,11,115,143,650
5693,Obadiah Noel,2018,2019,Massachusetts-Lowell,AEC,61,1446,218,454,175,328,43,126,171,241,66,118,184,96,59,22,102,143,650
5694,Miles Plumlee,2009,2012,Duke,ACC,135,2133,262,470,261,469,1,1,125,200,248,402,650,45,62,87,138,306,650
5695,Jesus Verdejo,2008,2009,South Florida,Big East,57,1780,230,576,138,305,92,271,98,133,35,130,165,132,30,2,103,85,650
5696,Curtis White,2008,2010,Howard,MEAC,95,2588,203,546,72,167,131,379,113,143,45,231,276,192,71,7,168,124,650
5697,D'Andre Williams,2011,2012,Little Rock,Sun Belt,67,2006,221,548,163,388,58,160,150,197,34,206,240,231,95,4,141,177,650
5698,Devon Begley,2015,2018,Northeastern,CAA,123,2392,213,570,111,273,102,297,121,167,45,237,282,200,108,17,167,209,649
5699,Demetric Bennett,2008,2008,South Alabama,Sun Belt,33,1147,213,443,123,221,90,222,133,159,44,148,192,84,42,2,81,41,649
5700,Elijah Davis,2017,2019,Wagner,NEC,82,1742,223,544,161,335,62,209,141,179,103,192,295,71,46,24,126,154,649
5701,Darnell Harris,2015,2016,Middle Tennessee,CUSA,71,1572,224,532,134,300,90,232,111,164,87,173,260,65,27,33,77,157,649
5702,Dan Jennings,2010,2014,Total,Total,100,1876,265,476,265,476,0,0,119,259,221,321,542,42,31,83,122,223,649
5703,Godwin Okonji,2011,2015,Loyola Marymount,WCC,126,2879,243,491,243,489,0,2,163,267,277,330,607,83,104,96,141,384,649
5704,Artem Tavakalyan,2015,2018,Delaware State,MEAC,106,1769,229,546,153,338,76,208,115,174,73,243,316,103,56,18,119,177,649
5705,Konner Tucker,2010,2013,Total,Total,63,1810,207,547,83,198,124,349,111,139,23,131,154,70,30,0,98,122,649
5706,Tony Wills,2014,2017,Illinois State,MVC,132,2897,224,549,146,296,78,253,123,170,81,238,319,162,118,46,111,302,649
5707,Jubril Adekoya,2014,2017,Valparaiso,Horizon,112,2227,234,468,203,391,31,77,149,226,126,322,448,105,73,27,144,264,648
5708,Max Boudreau,2008,2010,Buffalo,MAC,93,1611,250,518,250,517,0,1,148,206,143,183,326,42,40,33,108,212,648
5709,Daejon Davis,2018,2019,Stanford,Pac-12,59,1799,215,479,162,335,53,144,165,233,39,183,222,274,79,13,214,152,648
5710,Matt Humphrey,2009,2013,Total,Total,100,1941,214,605,89,228,125,377,95,165,66,169,235,97,88,32,107,172,648
5711,Chris Jones,2012,2014,North Texas,Total,66,1769,237,573,211,473,26,100,148,216,43,219,262,282,127,4,180,149,648
5712,Ed Jones,2008,2009,North Carolina A&T,MEAC,63,1537,232,534,160,322,72,212,112,162,74,175,249,51,63,18,111,119,648
5713,Andre Nation,2013,2015,James Madison,CAA,61,1756,222,517,175,340,47,177,157,236,62,150,212,98,100,65,89,149,648
5714,De'Sean Parsons,2016,2017,Portland State,Big Sky,61,1419,243,496,223,419,20,77,142,255,78,199,277,119,62,31,117,116,648
5715,DeAngelo Priar,2014,2015,Mississippi Valley State,SWAC,63,1762,218,582,149,351,69,231,143,236,85,176,261,111,74,10,129,132,648
5716,Camyn Boone,2015,2016,Missouri State,MVC,62,1485,244,461,244,461,0,0,159,232,122,249,371,60,21,40,86,167,647
5717,Jonathan Galloway,2016,2019,UC-Irvine,Big West,146,3260,240,461,240,461,0,0,167,281,336,633,969,85,46,149,133,344,647
5718,Savon Goodman,2013,2016,Total,Total,80,1486,257,470,257,462,0,8,133,256,154,279,433,41,43,30,113,185,647
5719,Aleek Pauline,2009,2011,Norfolk State,MEAC,86,2957,198,500,160,397,38,103,213,327,67,261,328,377,164,4,290,237,647
5720,D.D. Scarver,2013,2014,Total,Total,53,1511,211,593,104,247,107,346,118,153,22,116,138,80,36,9,86,96,647
5721,Kelvin Bright,2009,2010,Youngstown State,Horizon,60,1650,228,537,196,416,32,121,158,258,68,62,130,97,35,10,109,106,646
5722,Robert Crawford,2012,2013,Central Arkansas,Southland,57,1316,214,478,92,196,122,282,96,142,67,133,200,78,54,24,91,100,646
5723,Josh Daniel,2008,2011,Eastern Kentucky,OVC,94,1812,213,486,117,210,96,276,124,161,39,128,167,92,65,8,73,116,646
5724,Tony Freeman,2008,2010,Total,Total,51,1641,211,522,72,173,139,349,85,121,24,131,155,130,49,8,121,92,646
5725,Charles Funches,2010,2011,Hampton,MEAC,65,1931,202,460,192,432,10,28,232,328,149,328,477,75,77,83,142,215,646
5726,Tyler Hagedorn,2016,2018,South Dakota,Summit,87,1473,217,523,139,311,78,212,134,169,75,244,319,74,41,53,77,180,646
5727,Demetris Morant,2014,2017,Total,Total,103,1971,279,419,279,419,0,0,88,163,210,333,543,34,22,128,100,272,646
5728,Michael Ojo,2008,2011,Lehigh,Patriot,93,1772,195,489,93,220,102,269,154,200,60,224,284,67,64,13,113,202,646
5729,Julion Pearre,2015,2018,Utah State,MWC,111,2221,226,566,116,247,110,319,84,119,16,185,201,140,60,11,118,199,646
5730,Spencer Perrin,2010,2011,Eastern Kentucky,OVC,62,1723,254,494,229,418,25,76,113,164,83,237,320,142,53,48,89,148,646
5731,Ed Tyson,2008,2008,Maryland-Eastern Shore,MEAC,32,1176,219,585,146,359,73,226,135,177,57,49,106,46,54,1,102,92,646
5732,Anthony Cordova,2009,2010,South Dakota State,Summit,62,1614,276,548,276,548,0,0,93,192,131,232,363,75,19,6,121,132,645
5733,Deng Geu,2017,2019,North Dakota State,Summit,97,1386,248,457,225,380,23,77,126,189,103,232,335,42,19,57,113,180,645
5734,Emil Jones,2012,2013,Troy,Sun Belt,61,1934,251,590,216,475,35,115,108,151,112,236,348,154,96,25,91,155,645
5735,Jamail Jones,2011,2015,Total,Total,104,2050,240,596,177,381,63,215,102,160,86,293,379,78,45,8,120,145,645
5736,Jito Kok,2013,2016,San Diego,WCC,129,2935,234,475,234,473,0,2,177,312,193,315,508,52,33,268,188,319,645
5737,Majok Majok,2013,2014,Ball State,MAC,59,1799,229,442,229,442,0,0,187,338,204,380,584,52,28,48,143,148,645
5738,Corbin Moore,2009,2012,Pepperdine,WCC,125,2580,252,521,225,462,27,59,114,175,256,373,629,65,39,71,114,265,645
5739,Ty Patterson,2009,2010,Chattanooga,Southern,60,1672,218,527,95,184,123,343,86,135,67,165,232,107,56,14,79,65,645
5740,Fred Sturdivant,2012,2013,Texas Southern,SWAC,64,1686,256,458,253,447,3,11,130,268,148,290,438,36,65,145,107,141,645
5741,Jalen Tate,2017,2019,Northern Kentucky,Horizon,71,1719,244,480,213,383,31,97,126,215,43,181,224,206,88,42,123,218,645
5742,Jay Tunnell,2008,2009,Indiana State,MVC,63,1606,222,456,155,286,67,170,134,178,108,236,344,64,32,18,94,189,645
5743,Isaiah Wilkins,2015,2018,Virginia,ACC,132,2866,264,520,255,490,9,30,108,161,222,409,631,156,106,141,105,236,645
5744,C.J. Anderson,2015,2018,Massachusetts,A-10,126,2920,224,532,162,354,62,178,134,176,80,341,421,324,86,11,161,223,644
5745,Michael Gruner,2008,2010,Lafayette,Patriot,86,2385,211,513,141,289,70,224,152,200,71,180,251,221,126,15,147,182,644
5746,Marcus Hooten,2012,2013,Arkansas State,Sun Belt,65,1690,220,581,157,397,63,184,141,208,35,115,150,88,35,2,108,113,644
5747,Geron Johnson,2013,2014,Memphis,Total,67,1897,239,560,173,347,66,213,100,154,99,220,319,237,104,29,178,182,644
5748,Dominique Lacey,2008,2010,North Carolina-Wilmington,CAA,93,1766,237,540,191,401,46,139,124,196,139,228,367,66,42,37,194,294,644
5749,Ross Morin,2008,2009,Yale,Ivy,54,1443,248,479,229,422,19,57,129,190,85,220,305,53,24,18,97,126,644
5750,Brian Moten,2008,2009,Bowling Green State,MAC,63,1740,222,518,112,222,110,296,90,115,31,108,139,48,29,16,60,81,644
5751,Adam Nigon,2008,2011,Colorado State,MWC,122,2599,220,523,96,203,124,320,80,117,52,237,289,163,121,18,163,219,644
5752,Sollie Norwood,2008,2009,Texas Southern,SWAC,55,1664,205,550,87,208,118,342,116,150,36,122,158,65,55,1,95,94,644
5753,Aaron Ware,2009,2012,George Washington,A-10,121,2233,222,551,214,516,8,35,192,258,137,229,366,101,46,7,130,135,644
5754,Jack Williams,2015,2018,Total,Total,96,2177,225,602,122,319,103,283,91,135,135,335,470,66,31,22,81,171,644
5755,Obij Aget,2014,2017,New Mexico,MWC,122,2268,262,438,262,438,0,0,119,178,186,328,514,34,38,129,113,270,643
5756,Udoka Azubuike,2017,2019,Kansas,Big 12,56,1174,288,387,288,387,0,0,67,170,120,241,361,31,26,92,96,165,643
5757,Louis Bell,2011,2014,Maryland-Eastern Shore,MEAC,113,2329,219,646,70,187,149,459,56,82,46,106,152,120,48,7,118,192,643
5758,Kedar Edwards,2016,2017,Tennessee-Martin,OVC,63,1741,242,563,188,367,54,196,105,167,161,260,421,187,98,34,166,127,643
5759,James Fields,2009,2012,Georgia State,CAA,124,2683,227,551,209,483,18,68,171,280,82,210,292,244,139,8,195,273,643
5760,Matt Halvorsen,2018,2019,Western Carolina,Southern,64,1800,175,487,39,94,136,393,157,183,13,128,141,120,30,2,113,95,643
5761,Bryant Irwin,2009,2013,Total,Total,121,2141,231,641,134,308,97,333,84,132,108,197,305,46,32,35,92,167,643
5762,Anthony Johnson,2012,2015,Total,Total,95,1756,237,593,180,409,57,184,112,180,57,169,226,101,33,2,91,146,643
5763,Makuach Maluach,2018,2019,New Mexico,MWC,66,1515,222,485,149,288,73,197,126,168,69,142,211,93,40,24,103,153,643
5764,Josh McSwiggan,2018,2019,Portland,WCC,64,1949,216,544,100,239,116,305,95,116,42,197,239,88,35,12,90,106,643
5765,Jalen Pendleton,2013,2015,Southern Illinois,MVC,95,1771,227,510,211,447,16,63,173,283,100,171,271,121,78,4,113,181,643
5766,David Tairu,2010,2011,Texas Tech,Big 12,67,1488,220,486,156,335,64,151,139,190,81,111,192,49,31,14,67,131,643
5767,Isaiah Hart,2018,2019,Loyola (MD),Patriot,63,1753,239,526,211,434,28,92,136,190,21,101,122,187,68,8,145,147,642
5768,Jordan Heath,2013,2014,Canisius,MAAC,65,1779,243,456,170,272,73,184,83,167,133,239,372,53,65,125,63,193,642
5769,Aaron Jordan,2016,2019,Illinois,Big Ten,119,2047,197,509,66,188,131,321,117,148,95,210,305,90,76,24,65,213,642
5770,Laurynas Motuzis,2018,2019,American,Patriot,60,1896,229,530,140,260,89,270,95,148,44,201,245,77,69,22,88,155,642
5771,Greg Nero,2008,2011,Fairfield,MAAC,66,1528,223,452,204,404,19,48,177,287,131,218,349,66,43,47,117,152,642
5772,Doug Taylor,2016,2019,Ohio,MAC,122,2089,257,449,254,439,3,10,125,221,227,406,633,46,57,146,117,288,642
5773,Shirmane Thomas,2014,2018,Total,Total,119,2519,212,584,157,407,55,177,163,262,73,289,362,231,85,42,213,259,642
5774,Josh Watkins,2011,2012,Utah,Total,43,1319,221,542,193,422,28,120,172,248,25,91,116,177,42,3,160,124,642
5775,Austin Ajukwa,2014,2018,Total,Total,105,1919,219,543,148,345,71,198,132,168,53,225,278,56,77,31,127,203,641
5776,Drew Brandon,2014,2015,Eastern Washington,Big Sky,64,2141,215,546,162,361,53,185,158,200,124,305,429,312,90,15,136,162,641
5777,Tom Fow,2008,2011,Air Force,MWC,70,1361,219,486,99,198,120,288,83,103,29,167,196,51,34,8,46,101,641
5778,Stephan Gilling,2009,2010,Long Beach State,Big West,63,1738,213,590,47,136,166,454,49,67,19,104,123,53,42,4,73,140,641
5779,Lindsey Hughey,2010,2011,Weber State,Big Sky,63,1641,216,511,133,284,83,227,126,180,42,207,249,145,75,5,145,123,641
5780,Timmy Knipp,2012,2015,Eastern Kentucky,OVC,117,1896,213,519,75,136,138,383,77,101,56,179,235,93,52,73,93,196,641
5781,Hamady N'Diaye,2008,2010,Rutgers,Big East,95,2357,239,439,239,437,0,2,163,269,188,408,596,43,39,309,144,276,641
5782,Nate Pierre-Louis,2018,2019,Temple,AAC,60,1589,228,496,183,355,45,141,140,218,73,200,273,84,78,18,76,108,641
5783,Justin Safford,2008,2011,Missouri,Big 12,124,1717,242,554,200,452,42,102,115,169,110,256,366,105,53,39,117,209,641
5784,Jyles Smith,2011,2014,Savannah State,Total,129,2984,249,499,249,492,0,7,143,258,257,539,796,76,104,320,200,411,641
5785,Corban Wroe,2012,2015,Hartford,AEC,125,2772,228,475,146,254,82,221,103,137,81,253,334,181,102,9,153,284,641
5786,Carlos Emory,2012,2013,Oregon,Pac-12,71,1581,221,481,171,319,50,162,148,200,102,190,292,70,49,18,116,135,640
5787,Niels Giffey,2011,2014,Connecticut,Total,139,2328,216,454,128,245,88,209,120,152,114,240,354,79,73,37,102,223,640
5788,Tony Gill,2013,2014,Pacific,Total,69,1491,237,456,177,304,60,152,106,148,98,217,315,64,40,12,85,184,640
5789,Dominic Green,2016,2019,Washington,Pac-12,128,2458,212,615,66,187,146,428,70,103,65,195,260,72,47,41,78,167,640
5790,William Jackson II,2016,2019,Georgia,SEC,130,2556,210,612,84,219,126,393,94,124,38,148,186,238,68,25,147,182,640
5791,Nate Lubick,2011,2014,Georgetown,Big East,130,3009,260,460,253,428,7,32,113,196,168,425,593,252,64,69,169,336,640
5792,Chretien Lukusa,2008,2011,Binghamton,AEC,116,3065,227,635,171,420,56,215,130,227,132,243,375,170,92,6,177,254,640
5793,Bryce Moore,2016,2018,Western Michigan,MAC,94,2408,203,535,83,211,120,324,114,166,28,178,206,129,76,6,101,205,640
5794,Eric Moreland,2011,2014,Oregon State,Total,89,2227,238,445,230,421,8,24,156,294,211,551,762,116,70,184,161,211,640
5795,Jacob Rigoni,2018,2019,Quinnipiac,MAAC,64,1694,205,472,64,134,141,338,89,106,46,196,242,75,38,18,85,105,640
5796,Tarique Thompson,2014,2017,High Point,Big South,109,1774,259,498,249,470,10,28,112,150,144,217,361,63,56,32,88,179,640
5797,Dalonte Brown,2018,2019,Miami (OH),MAC,66,1555,228,535,148,296,80,239,103,147,82,262,344,27,33,30,84,149,639
5798,Mark Gasperini,2017,2019,American,Patriot,58,1548,278,562,265,508,13,54,70,124,85,174,259,110,36,29,112,180,639
5799,Devonte Green,2017,2019,Indiana,Big Ten,91,1886,215,545,110,275,105,270,104,146,24,189,213,195,93,25,162,96,639
5800,Marreon Jackson,2018,2019,Toledo,MAC,65,1912,210,502,88,188,122,314,97,127,39,181,220,223,70,7,133,126,639
5801,Jorden Kaufman,2013,2017,Total,Total,107,1612,280,516,280,516,0,0,79,144,165,290,455,67,22,32,87,231,639
5802,Charles Oliver,2014,2016,Total,Total,72,1385,188,484,94,199,94,285,169,205,30,101,131,47,23,3,69,132,639
5803,Julian Vaughn,2008,2011,Total,Total,126,2177,249,474,246,451,3,23,138,218,186,272,458,125,31,147,172,277,639
5804,Tony Bishop,2010,2011,Texas State,Southland,62,1355,238,448,236,443,2,5,160,251,141,261,402,50,61,58,95,159,638
5805,Erik Buggs,2009,2013,Valparaiso,Horizon,138,3428,250,544,221,412,29,132,109,234,72,264,336,425,157,20,316,420,638
5806,Devonte Campbell,2017,2019,Albany (NY),AEC,89,2501,199,480,152,319,47,161,193,255,136,255,391,112,60,30,105,174,638
5807,Mark Donnal,2015,2018,Total,Total,135,1857,235,417,189,305,46,112,122,166,137,182,319,30,32,57,62,246,638
5808,Thomas Dziagwa,2017,2019,Oklahoma State,Big 12,94,1568,209,539,34,112,175,427,45,51,17,141,158,79,34,1,74,114,638
5809,Jamal Fenton,2010,2013,New Mexico,MWC,133,1985,213,543,117,246,96,297,116,180,42,133,175,225,117,1,144,169,638
5810,Josiah Heath,2012,2015,Canisius,MAAC,131,2442,252,520,252,514,0,6,134,218,231,368,599,80,69,81,97,315,638
5811,Dundrecous Massey,2011,2013,Total,Total,66,1147,196,532,108,241,88,291,158,224,23,85,108,106,63,12,128,137,638
5812,Antoine Myers,2013,2014,Troy,Sun Belt,64,1885,212,442,211,433,1,9,213,332,60,201,261,167,60,4,135,121,638
5813,Mike Rowley,2014,2017,Albany (NY),AEC,128,3039,235,473,230,450,5,23,163,221,226,368,594,114,91,25,144,316,638
5814,Corey Schaefer,2012,2015,Lehigh,Patriot,125,2825,224,528,146,317,78,211,112,136,18,245,263,228,65,8,110,122,638
5815,Mitchell Solomon,2015,2018,Oklahoma State,Big 12,132,2437,231,451,220,395,11,56,165,213,311,306,617,104,69,111,153,420,638
5816,Jonathan Wills,2008,2012,Total,Total,129,2272,215,530,165,369,50,161,158,209,99,174,273,155,58,13,135,257,638
5817,J.R. Cadot,2011,2012,Texas Christian,MWC,65,1809,231,408,210,341,21,67,154,240,176,248,424,79,82,30,79,160,637
5818,Dontay Caruthers,2017,2019,Buffalo,MAC,93,1957,219,409,175,286,44,123,155,214,66,184,250,221,130,7,144,295,637
5819,Steven Davis,2013,2017,Wright State,Horizon,69,1390,222,472,160,286,62,186,131,176,80,137,217,54,38,23,106,173,637
5820,Kevin Larkin,2017,2019,Total,Total,76,1495,240,638,172,401,68,237,89,112,97,272,369,69,66,11,71,97,637
5821,Robinson Louisme,2008,2009,Tulane,CUSA,63,1499,256,463,255,461,1,2,124,212,143,244,387,33,44,77,87,180,637
5822,Dorian McDaniel,2008,2010,Prairie View,SWAC,90,1928,254,646,176,405,78,241,51,80,149,252,401,35,50,15,88,218,637
5823,Isaac McGlone,2014,2017,Eastern Kentucky,OVC,125,3098,209,523,65,130,144,393,75,101,24,185,209,238,154,8,110,258,637
5824,Logan McIntosh,2017,2018,Maryland-Eastern Shore,MEAC,63,2052,214,538,172,399,42,139,167,239,40,189,229,281,60,5,161,123,637
5825,James Milliken,2015,2016,Creighton,Big East,66,1732,204,498,109,239,95,259,134,181,19,136,155,118,27,2,59,98,637
5826,Davion Mintz,2017,2019,Creighton,Big East,97,2061,210,515,139,312,71,203,146,198,27,213,240,259,69,11,145,149,637
5827,Jorden Page,2010,2013,Saint Mary's (CA),WCC,105,2085,211,515,100,196,111,319,104,128,16,117,133,175,62,11,126,111,637
5828,Brett Prahl,2015,2018,Milwaukee,Horizon,117,1948,261,409,257,388,4,21,111,172,129,206,335,66,40,82,117,191,637
5829,Justin Seymour,2013,2017,Total,Total,104,1962,217,543,103,234,114,309,89,125,39,205,244,124,63,15,120,190,637
5830,Chad Sherwood,2015,2018,Idaho,Big Sky,104,2264,202,520,40,116,162,404,71,83,29,147,176,157,39,15,115,219,637
5831,Troy Taylor,2010,2013,Evansville,MVC,129,3020,224,498,221,492,3,6,186,295,144,448,592,416,141,9,229,304,637
5832,Jonathan Boyd,2009,2010,Alcorn State,SWAC,62,1641,211,558,78,209,133,349,81,102,36,118,154,61,86,5,112,111,636
5833,Jordan Burgess,2014,2017,Virginia Commonwealth,A-10,129,2812,225,625,134,311,91,314,95,175,118,355,473,131,88,47,118,275,636
5834,Kyle Cassity,2009,2012,Saint Louis,A-10,131,3259,234,599,121,244,113,355,55,84,17,247,264,320,92,20,148,172,636
5835,DeAndre Coleman,2008,2009,South Alabama,Sun Belt,66,1710,235,447,223,413,12,34,154,229,135,396,531,121,38,49,134,172,636
5836,Shavon Coleman,2013,2014,Louisiana State,SEC,65,1730,224,517,167,351,57,166,131,181,112,219,331,90,93,39,108,143,636
5837,Andrew Drone,2014,2017,Rice,CUSA,124,1891,255,425,255,425,0,0,126,205,143,257,400,37,25,66,120,234,636
5838,Lee Fisher,2009,2012,Total,Total,113,2336,219,523,189,432,30,91,168,277,187,343,530,109,76,34,163,226,636
5839,Terry Harris Jr,2016,2017,Coppin State,MEAC,59,1681,207,588,174,442,33,146,189,251,109,263,372,57,41,43,106,152,636
5840,Derek Johnson,2008,2009,Prairie View,SWAC,61,2037,210,473,176,355,34,118,182,282,89,193,282,186,118,4,175,133,636
5841,De'Edrick Petty,2017,2018,Alabama A&M,SWAC,58,1558,179,526,111,258,68,268,210,277,22,127,149,86,28,9,132,108,636
5842,Isaiah Ross,2017,2018,Missouri-Kansas City,WAC,66,1389,207,521,73,156,134,365,88,110,33,130,163,51,33,1,76,129,636
5843,Matt Sauey,2010,2012,North Florida,A-Sun,93,2084,256,437,253,427,3,10,121,194,124,247,371,64,63,115,120,225,636
5844,James Bolden,2017,2019,West Virginia,Big 12,82,1178,210,492,89,189,121,303,94,118,53,85,138,92,61,12,84,143,635
5845,Caleb Crayton,2013,2016,Houston Baptist,Total,110,2082,225,546,176,363,49,183,136,204,120,250,370,102,47,12,172,254,635
5846,Courtney Fells,2008,2009,North Carolina State,ACC,58,1706,227,488,130,240,97,248,84,101,32,151,183,77,54,41,97,131,635
5847,Lennard Freeman,2014,2018,North Carolina State,ACC,136,2700,244,448,244,448,0,0,147,268,261,443,704,77,66,49,88,250,635
5848,Jalen Perry,2018,2019,Alabama-Birmingham,CUSA,68,1801,215,527,119,257,96,270,109,166,45,210,255,112,50,2,90,99,635
5849,Jure Span,2016,2019,South Carolina Upstate,Total,127,3054,225,627,103,249,122,378,63,105,51,225,276,418,98,26,212,305,635
5850,Jeron Belin,2010,2011,Saint Peter's,MAAC,63,1486,219,536,178,389,41,147,155,272,132,169,301,45,50,35,119,154,634
5851,Evan Cooper,2013,2016,Hartford,AEC,93,2020,199,486,88,189,111,297,125,162,41,126,167,135,87,3,116,199,634
5852,Mario Dunn,2014,2017,Montana,Big Sky,109,2471,222,462,160,297,62,165,128,198,46,236,282,225,107,32,161,230,634
5853,Leemire Goldwire,2008,2008,Charlotte,A-10,34,1130,194,520,66,149,128,371,118,146,37,111,148,58,70,3,83,91,634
5854,Chris Kramer,2008,2010,Purdue,Big Ten,103,2876,226,464,200,365,26,99,156,220,35,276,311,262,210,45,147,235,634
5855,Richard Lee,2015,2019,Total,Total,117,1818,225,543,82,181,143,362,41,59,26,118,144,60,35,4,66,122,634
5856,Anfernee McLemore,2017,2019,Auburn,SEC,98,1740,241,459,186,302,55,157,97,151,141,293,434,29,61,152,82,263,634
5857,Nate Watson,2018,2019,Providence,Big East,69,1282,239,404,239,403,0,1,156,234,106,140,246,18,17,50,73,151,634
5858,Reggie Agbeko,2014,2017,Saint Louis,A-10,114,2150,249,449,248,448,1,1,134,234,169,387,556,39,36,29,164,231,633
5859,Collin Dennis,2008,2009,North Texas,Sun Belt,60,1301,198,516,114,293,84,223,153,200,41,121,162,84,46,5,100,184,633
5860,Kevin Foster,2010,2013,Total,Total,88,1669,224,546,190,446,34,100,151,223,149,296,445,12,45,59,126,226,633
5861,Caleb Green,2018,2019,Holy Cross,Patriot,64,2213,239,566,168,345,71,221,84,109,26,146,172,196,64,2,115,99,633
5862,Donald Johnson,2008,2009,Delaware State,MEAC,57,1664,224,542,96,218,128,324,57,68,53,114,167,47,44,9,59,88,633
5863,Carlos Monroe,2008,2009,Florida Atlantic,Sun Belt,44,1225,235,463,230,449,5,14,158,271,76,309,385,43,52,10,100,127,633
5864,Josh Oglesby,2012,2015,Iowa,Big Ten,126,2289,211,615,65,165,146,450,65,84,40,162,202,154,40,8,65,108,633
5865,Chris Ortiz,2013,2016,Kent State,MAC,122,2274,215,534,167,359,48,175,155,236,143,340,483,54,49,48,117,211,633
5866,Brad Reese,2010,2011,Texas Tech,Big 12,67,1624,226,575,162,396,64,179,117,158,70,178,248,86,73,62,103,168,633
5867,Maurice Rivers,2015,2018,Total,Total,71,1524,227,540,210,476,17,64,162,237,125,222,347,60,40,45,113,213,633
5868,Bryson Robinson,2017,2019,New Orleans,Southland,74,1597,204,511,87,182,117,329,108,139,40,109,149,163,62,9,127,108,633
5869,Sai'Quon Stone,2008,2011,Southern Mississippi,CUSA,106,2525,163,368,160,358,3,10,304,426,174,252,426,144,80,17,165,270,633
5870,Brian Williams,2008,2011,Tennessee,SEC,126,2179,262,497,257,483,5,14,104,201,300,415,715,103,56,70,124,318,633
5871,Jordan Baker,2014,2017,Old Dominion,CUSA,138,3293,205,590,53,131,152,459,70,110,49,269,318,242,127,7,149,281,632
5872,Devonte Boykins,2015,2018,Total,Total,121,2499,205,530,105,222,100,308,122,175,36,209,245,179,67,7,116,189,632
5873,Henry Brooks,2012,2016,Total,Total,123,2160,287,627,287,625,0,2,58,95,136,220,356,57,77,69,156,416,632
5874,Stanley Davis,2017,2019,Morgan State,MEAC,82,1610,241,565,226,490,15,75,135,184,101,233,334,119,64,11,151,153,632
5875,Anthony Duruji,2018,2019,Louisiana Tech,CUSA,65,1670,226,490,157,298,69,192,111,172,84,250,334,57,43,85,93,160,632
5876,Tyreke Evans,2009,2009,Memphis,CUSA,37,1072,230,505,196,381,34,124,138,194,47,151,198,143,77,29,133,89,632
5877,Maurius Hill,2014,2017,Little Rock,Sun Belt,121,2032,238,544,211,457,27,87,129,192,138,289,427,109,69,27,146,174,632
5878,Landen Lucas,2014,2017,Kansas,Big 12,125,2151,240,392,240,391,0,1,152,239,248,454,702,70,45,86,136,299,632
5879,Jalen Nesbitt,2014,2015,North Florida,A-Sun,66,1890,183,397,131,252,52,145,214,287,96,234,330,194,83,35,146,121,632
5880,Jervon Pressley,2012,2016,Total,Total,112,2207,229,535,229,533,0,2,174,322,192,331,523,62,29,130,210,354,632
5881,Collin Sexton,2018,2018,Alabama,SEC,33,987,196,438,152,307,44,131,196,252,34,90,124,119,28,3,92,81,632
5882,Ben Simmons,2016,2016,Louisiana State,SEC,33,1151,216,386,215,383,1,3,199,297,103,285,388,158,65,27,111,92,632
5883,Jerrell Thompson,2008,2011,Sacred Heart,NEC,102,2229,219,550,148,345,71,205,123,154,46,163,209,295,91,5,183,149,632
5884,Brandon Conley,2013,2016,Oral Roberts,Total,127,2243,249,432,249,432,0,0,133,219,197,304,501,74,43,94,167,391,631
5885,Stanley Elliott,2009,2012,Bethune-Cookman,MEAC,127,2705,225,557,198,440,27,117,154,247,145,186,331,125,116,44,136,294,631
5886,John Fields,2008,2011,Total,Total,89,1706,236,429,236,429,0,0,159,306,198,274,472,26,36,156,117,252,631
5887,Anthony Ford,2008,2009,Alcorn State,SWAC,57,1679,232,608,151,395,81,213,86,112,79,165,244,83,48,14,99,145,631
5888,Hasahn French,2018,2019,Saint Louis,A-10,68,2066,277,543,277,542,0,1,77,216,194,335,529,102,59,122,138,225,631
5889,Javaris Jenkins,2014,2018,Savannah State,MEAC,85,1656,216,576,112,241,104,335,95,125,81,200,281,69,63,33,75,153,631
5890,Malik Marquetti,2015,2019,Total,Total,106,2140,212,520,107,251,105,269,102,133,97,196,293,128,75,20,102,165,631
5891,Elijah Olaniyi,2018,2019,Stony Brook,AEC,63,1678,227,519,172,345,55,174,122,187,97,209,306,74,58,15,124,125,631
5892,Drazen Zlovaric,2009,2013,Total,Total,107,1914,282,564,280,543,2,21,65,120,127,254,381,47,27,18,107,170,631
5893,Quinton Campbell,2016,2017,Southern Mississippi,CUSA,60,1694,209,535,110,227,99,308,113,150,48,240,288,67,33,14,77,89,630
5894,Darnell Gant,2009,2012,Washington,Total,140,2557,245,587,203,467,42,120,98,142,207,315,522,81,42,50,93,317,630
5895,Devon Goodman,2017,2019,Pennsylvania,Ivy,80,1819,234,531,155,290,79,241,83,131,39,135,174,149,84,11,119,150,630
5896,Jordan Green,2012,2015,Texas A&M,Total,129,2553,224,507,177,342,47,165,135,195,51,188,239,184,73,10,140,201,630
5897,Jamall Gregory,2016,2019,Total,Total,87,1636,235,521,191,374,44,147,116,170,47,216,263,176,121,50,154,175,630
5898,Nick Harris,2016,2019,College of Charleston,CAA,129,2847,248,443,248,442,0,1,134,216,201,457,658,41,49,121,112,337,630
5899,Malik Hines,2016,2019,Total,Total,101,1903,259,425,257,420,2,5,110,176,165,267,432,73,36,69,136,236,630
5900,Terrence Jennings,2009,2011,Louisville,Big East,99,1610,257,453,257,453,0,0,116,194,188,191,379,43,58,158,79,191,630
5901,Tyson Johnson,2008,2009,Wyoming,MWC,61,1561,212,435,206,417,6,18,200,249,88,266,354,77,21,26,119,127,630
5902,Rashard Kelly,2015,2018,Wichita State,Total,139,2448,232,494,210,425,22,69,144,248,260,393,653,167,68,44,143,230,630
5903,Matt Lawrence,2008,2009,Missouri,Big 12,70,1626,215,519,61,111,154,408,46,60,34,143,177,65,59,9,45,101,630
5904,Jameel McKay,2015,2016,Iowa State,Big 12,57,1654,245,411,245,411,0,0,140,246,172,300,472,42,35,114,77,129,630
5905,Matt Pilgrim,2008,2011,Total,Total,90,1742,254,473,238,407,16,66,106,209,159,371,530,67,102,70,155,285,630
5906,Jimmie Taylor,2014,2017,Alabama,SEC,133,2649,248,422,248,422,0,0,134,305,189,364,553,55,46,205,134,337,630
5907,Dwaun Anderson,2013,2016,Wagner,NEC,96,2108,247,631,211,451,36,180,99,149,85,242,327,98,84,60,148,181,629
5908,John Dawson,2014,2017,Total,Total,81,1923,217,531,118,246,99,285,96,127,18,267,285,189,61,13,155,199,629
5909,Anton Dickerson,2010,2013,Howard,MEAC,94,1626,209,608,89,234,120,374,91,129,45,117,162,60,47,5,104,149,629
5910,Lindsey Drew,2016,2018,Nevada,MWC,99,2977,216,502,152,325,64,177,133,193,97,353,450,384,124,85,165,273,629
5911,Darryl Evans,2008,2011,Furman,Southern,100,2549,207,493,135,270,72,223,143,237,42,197,239,268,94,10,181,179,629
5912,Tony Freeland,2010,2013,Total,Total,79,1686,234,472,234,471,0,1,161,275,146,180,326,68,51,26,122,219,629
5913,LaDarien Griffin,2016,2019,St. Bonaventure,A-10,98,2165,238,484,234,463,4,21,149,217,153,275,428,87,70,77,104,194,629
5914,Mikael Hopkins,2012,2015,Georgetown,Big East,128,2268,213,503,210,491,3,12,200,313,185,297,482,129,84,148,196,345,629
5915,Justin Jenifer,2016,2019,Cincinnati,AAC,132,2270,206,504,89,210,117,294,100,137,24,125,149,291,69,0,82,135,629
5916,Khalil Kelley,2011,2014,Pacific,Total,123,2044,252,507,252,506,0,1,125,301,198,257,455,57,25,50,139,310,629
5917,Colin McIntosh,2008,2009,Vermont,AEC,64,1428,246,525,217,447,29,78,108,149,78,192,270,56,36,63,106,155,629
5918,Billy Pettiford,2008,2010,IUPUI,Summit,98,2937,233,509,221,474,12,35,151,208,150,397,547,300,152,76,235,328,629
5919,Alejo Rodriguez,2009,2011,Iona,MAAC,96,1562,264,411,264,411,0,0,101,211,249,336,585,65,66,84,109,270,629
5920,Antonio Ballard,2008,2011,Miami (OH),MAC,74,2101,224,457,186,333,38,124,142,201,141,286,427,100,50,25,118,145,628
5921,Mitchell Ballock,2018,2019,Creighton,Big East,68,1863,218,495,79,133,139,362,53,68,38,212,250,173,51,14,82,124,628
5922,Stefan Jovanovic,2014,2017,Total,Total,108,1763,250,493,250,484,0,9,128,175,145,267,412,47,31,92,111,250,628
5923,Wendell Lewis,2010,2015,Total,Total,127,2127,264,487,264,486,0,1,100,166,190,276,466,53,45,95,122,209,628
5924,Bobby Maze,2009,2010,Tennessee,SEC,71,1774,222,537,166,339,56,198,128,166,43,129,172,227,62,9,106,123,628
5925,Will Miller,2014,2017,Mount St. Mary's,NEC,127,2111,200,573,18,53,182,520,46,61,26,156,182,54,33,4,44,104,628
5926,Javan Mitchell,2010,2014,Total,Total,120,1893,236,504,236,503,0,1,156,251,149,220,369,54,31,73,130,291,628
5927,Raemond Robinson,2013,2017,Total,Total,106,2003,205,539,36,112,169,427,49,69,26,206,232,153,68,5,117,188,628
5928,Nych Smith,2016,2019,Total,Total,61,1227,220,506,157,314,63,192,125,169,12,98,110,151,39,3,96,86,628
5929,Ryne Smith,2009,2012,Purdue,Big Ten,118,2293,202,481,33,67,169,414,55,65,27,179,206,123,67,11,49,165,628
5930,Wellington Smith,2008,2010,West Virginia,Big East,110,2382,233,546,168,336,65,210,97,165,213,215,428,130,74,151,123,337,628
5931,Brandon Tunnell,2008,2011,Hampton,MEAC,122,2377,189,456,158,343,31,113,219,309,62,163,225,303,86,3,217,163,628
5932,Dallas Cameron,2014,2017,Stephen F. Austin,Southland,135,2672,192,503,111,246,81,257,162,221,45,118,163,243,66,17,138,210,627
5933,Matt Dorr,2009,2011,San Diego,WCC,90,2735,207,514,88,219,119,295,94,130,43,224,267,196,57,7,162,187,627
5934,Alex Harris,2008,2008,UC-Santa Barbara,Big West,31,1005,186,433,112,258,74,175,181,223,31,84,115,53,35,5,81,67,627
5935,Matt MacDonald,2014,2018,Total,Total,101,2353,198,505,91,185,107,320,124,165,88,210,298,95,73,4,85,191,627
5936,Auryn MacMillan,2008,2010,Gardner-Webb,Total,88,1832,258,453,258,453,0,0,111,200,186,212,398,49,50,113,115,219,627
5937,Shane McLaughlin,2013,2016,Bryant,NEC,125,3313,216,526,157,361,59,165,136,207,34,281,315,436,99,2,249,201,627
5938,Jamelle McMillan,2008,2011,Arizona State,Pac-10,122,2713,225,545,102,215,123,330,54,91,40,246,286,321,117,11,153,252,627
5939,Terrence Phillips,2016,2018,Missouri,SEC,83,1931,196,519,107,260,89,259,146,190,34,242,276,286,89,7,172,260,627
5940,Brian Roberts,2008,2008,Dayton,A-10,34,1179,208,437,108,217,100,220,111,129,8,88,96,117,12,4,94,60,627
5941,Andy Robinson,2008,2009,Buffalo,MAC,60,1452,210,535,133,295,77,240,130,184,64,107,171,74,97,21,95,122,627
5942,Jorge Rosa,2015,2019,Total,Total,86,1603,208,562,79,200,129,362,82,116,39,120,159,63,44,6,80,89,627
5943,Bishop Mency,2015,2018,Rice,CUSA,115,2733,207,590,67,138,140,452,72,124,101,249,350,92,48,27,115,201,626
5944,Kenny Moore,2011,2012,Tennessee State,OVC,56,1379,194,445,141,303,53,142,185,243,96,188,284,90,64,16,123,147,626
5945,Scott Vandermeer,2008,2009,Illinois-Chicago,Horizon,64,1904,254,602,254,601,0,1,118,174,167,356,523,76,44,162,72,169,626
5946,Greg Alexander,2014,2018,Total,Total,81,1848,214,498,66,106,148,392,49,71,21,151,172,39,40,24,43,113,625
5947,Cor-J Cox,2010,2012,Mississippi Valley State,SWAC,94,1611,243,497,207,360,36,137,103,170,124,227,351,63,59,19,105,154,625
5948,Erik Durham,2016,2017,Jacksonville State,OVC,56,1783,217,458,92,174,125,284,66,100,72,182,254,85,41,9,57,99,625
5949,John Galvin,2008,2011,Fairleigh Dickinson,NEC,101,2267,225,473,223,467,2,6,173,255,224,326,550,59,37,88,120,219,625
5950,Michael Harthun,2009,2013,Total,Total,98,2063,227,501,137,281,90,220,81,106,33,131,164,112,25,4,89,120,625
5951,Demetrius Nelson,2008,2009,Citadel,Southern,40,1107,213,375,213,375,0,0,199,258,80,175,255,31,16,18,80,108,625
5952,DeShawn Patterson,2009,2012,Southeastern Louisiana,Southland,119,2958,213,553,185,432,28,121,171,276,90,324,414,381,175,35,237,302,625
5953,D'walyn Roberts,2008,2011,Texas Tech,Big 12,115,2230,255,468,255,459,0,9,115,178,204,308,512,67,64,97,105,256,625
5954,Bruce Stevens,2018,2019,Mississippi,SEC,65,1388,228,447,187,313,41,134,128,162,102,213,315,63,35,29,70,178,625
5955,Tremaine Townsend,2008,2009,Cal State Northridge,Big West,59,1670,264,517,254,480,10,37,87,143,156,381,537,59,69,66,101,182,625
5956,Phil Turner,2008,2010,Mississippi State,SEC,102,2112,204,529,109,235,95,294,122,162,111,325,436,131,113,40,115,171,625
5957,Ryan Amoroso,2008,2009,San Diego State,MWC,66,1743,244,537,216,451,28,86,108,168,124,240,364,50,28,24,101,147,624
5958,Justin Cousin,2014,2018,Radford,Big South,127,1950,211,589,71,181,140,408,62,91,33,135,168,111,36,3,108,128,624
5959,Brandon Ingram,2016,2016,Duke,ACC,36,1246,214,484,134,289,80,195,116,170,67,177,244,72,41,49,72,74,624
5960,Marvin Jean-Pierre,2017,2018,Louisiana-Monroe,Sun Belt,63,1659,241,503,193,351,48,152,94,137,103,169,272,115,63,20,108,152,624
5961,Reggie Jones,2017,2018,Western Michigan,MAC,64,1493,224,543,150,325,74,218,102,132,39,196,235,140,67,19,123,120,624
5962,Tyler Larson,2014,2015,South Dakota,Summit,63,1633,205,472,160,351,45,121,169,229,97,255,352,130,39,9,104,121,624
5963,Gino Littles,2015,2018,Total,Total,107,2992,212,558,138,335,74,223,126,202,47,255,302,258,90,2,161,163,624
5964,Kendal Manuel,2017,2019,Total,Total,96,1907,203,505,80,198,123,307,95,122,27,159,186,104,56,6,114,137,624
5965,Davaris McGowens,2017,2018,North Carolina A&T,MEAC,62,1494,241,449,241,448,0,1,142,215,122,255,377,66,42,31,93,149,624
5966,Durann Neil,2008,2012,Longwood,Ind,93,2056,202,583,95,247,107,336,113,193,36,117,153,248,80,4,160,209,624
5967,Tony Washington,2015,2018,La Salle,A-10,104,2018,267,438,267,438,0,0,90,157,181,364,545,54,29,76,136,300,624
5968,Devonta Abron,2012,2016,Total,Total,118,1732,204,440,204,439,0,1,215,351,215,269,484,50,65,42,102,282,623
5969,Kyle Alexander,2016,2019,Tennessee,SEC,135,2408,243,414,238,400,5,14,132,207,288,378,666,37,47,185,99,290,623
5970,Braxton Beverly,2018,2019,North Carolina State,ACC,66,2037,204,543,68,168,136,375,79,103,26,107,133,209,60,1,78,151,623
5971,Shawn Deadwiler,2008,2011,Total,Total,84,1173,175,502,92,252,83,250,190,242,36,177,213,160,50,7,147,135,623
5972,David Jackson,2010,2011,Penn State,Big Ten,64,1983,214,470,150,293,64,177,131,160,100,188,288,56,33,17,71,160,623
5973,Deandre Jones,2018,2019,Central Arkansas,Southland,68,2104,186,442,94,199,92,243,159,193,39,221,260,321,125,12,181,174,623
5974,Nelson Kirksey,2013,2014,Missouri-Kansas City,Total,61,1513,221,452,175,323,46,129,135,199,69,187,256,89,68,7,134,164,623
5975,De'Antae McMurray,2017,2018,Drake,MVC,65,1850,212,586,114,295,98,291,101,133,16,201,217,181,73,4,120,127,623
5976,Pablo Rivas,2017,2018,North Carolina Central,MEAC,67,1504,249,456,196,308,53,148,72,98,110,272,382,45,40,59,61,179,623
5977,Olaf Schaftenaar,2013,2016,Oregon State,Pac-12,122,2335,201,537,69,164,132,373,89,110,56,214,270,130,38,28,95,178,623
5978,Kendrick Harris,2010,2011,Lamar,Southland,59,1661,197,494,144,326,53,168,175,256,33,107,140,170,64,8,158,161,622
5979,Andrew Hooper,2009,2011,Denver,Sun Belt,80,1671,208,443,67,123,141,320,65,91,22,142,164,90,29,36,97,220,622
5980,Lance Jeter,2010,2011,Nebraska,Big 12,65,1991,220,494,163,340,57,154,125,175,39,225,264,279,86,8,135,169,622
5981,Rob Lewis,2013,2014,Houston Baptist,Total,59,1363,199,473,158,351,41,122,183,253,28,123,151,126,47,3,136,108,622
5982,Jalen Steele,2011,2013,Mississippi State,SEC,78,1747,200,542,75,197,125,345,97,113,44,110,154,72,34,5,94,76,622
5983,Xzavier Taylor,2014,2018,Total,Total,127,1954,239,463,234,450,5,13,139,238,171,206,377,52,24,68,127,369,622
5984,Justin Brownlee,2010,2011,St. John's (NY),Big East,65,1592,253,530,224,425,29,105,86,124,103,214,317,93,60,50,92,133,621
5985,C.J. Collins,2008,2011,McNeese State,Southland,118,2828,204,600,121,347,83,253,130,181,39,182,221,321,103,1,199,159,621
5986,Trian Iliadis,2009,2012,Old Dominion,CAA,122,1879,214,581,96,197,118,384,75,105,36,146,182,156,97,11,104,111,621
5987,Laval Lucas-Perry,2008,2012,Total,Total,99,2032,176,487,81,168,95,319,174,257,50,189,239,137,63,13,108,164,621
5988,Tre'Darius McCallum,2017,2018,DePaul,Big East,63,1902,254,565,206,395,48,170,65,93,93,302,395,72,90,39,97,173,621
5989,Terrence Smith,2013,2016,NJIT,Total,69,1613,275,469,275,469,0,0,71,111,140,220,360,44,33,31,77,175,621
5990,Thomas Staton,2010,2013,Total,Total,86,1849,231,557,178,407,53,150,106,153,55,167,222,145,102,25,145,154,621
5991,Kyle Swanston,2008,2009,James Madison,CAA,58,1695,198,489,56,137,142,352,83,107,54,152,206,59,30,16,59,90,621
5992,Romello White,2018,2019,Arizona State,Pac-12,65,1602,233,373,233,373,0,0,155,275,156,241,397,24,21,47,89,206,621
5993,Will Artino,2012,2015,Creighton,Total,135,1498,256,416,256,416,0,0,108,193,149,273,422,47,45,43,81,226,620
5994,Devon Daniels,2017,2019,Total,Total,65,1625,241,511,190,357,51,154,87,126,55,235,290,134,57,35,123,146,620
5995,Tyree Evans,2009,2010,Kent State,MAC,59,1621,213,582,89,224,124,358,70,93,36,106,142,22,54,7,64,123,620
5996,Bamba Fall,2008,2009,Southern Methodist,CUSA,60,1640,223,391,223,391,0,0,174,250,120,265,385,38,22,130,132,168,620
5997,Darien Fernandez,2016,2017,Jacksonville,A-Sun,65,1716,193,513,104,264,89,249,145,202,55,198,253,209,133,3,127,206,620
5998,Jordan Giles,2017,2019,Missouri-Kansas City,WAC,89,1583,198,435,162,301,36,134,188,250,67,170,237,81,43,32,157,217,620
5999,Paul Gombwer,2012,2015,Charleston Southern,Big South,125,2770,229,515,183,380,46,135,116,177,297,478,775,88,84,9,157,326,620
6000,Donte Greene,2008,2008,Syracuse,Big East,35,1253,218,521,128,260,90,261,94,133,60,191,251,71,45,57,91,101,620
6001,Joshua Howard,2017,2019,Brown,Ivy,82,1561,229,443,189,327,40,116,122,181,107,206,313,44,79,46,100,185,620
6002,Karamo Jawara,2012,2015,North Carolina Central,MEAC,120,2841,222,479,179,337,43,142,133,191,105,375,480,213,90,56,131,299,620
6003,Shawn Kemp,2012,2015,Washington,Pac-12,114,1892,259,455,259,455,0,0,102,163,118,136,254,13,15,58,86,226,620
6004,Malcoln Kirkland,2009,2012,Total,Total,89,1757,241,449,241,449,0,0,138,211,148,222,370,31,26,64,125,198,620
6005,Steven Moore,2008,2009,Little Rock,Sun Belt,54,1425,180,404,110,233,70,171,190,251,23,118,141,182,46,1,148,91,620
6006,Tremayne Russell,2008,2011,Florida International,Sun Belt,108,1960,206,464,169,354,37,110,171,265,54,156,210,150,95,15,225,268,620
6007,Jordan Sims,2011,2014,Texas-San Antonio,Total,118,2426,204,549,47,87,157,462,55,97,97,205,302,79,85,7,71,193,620
6008,Jon Smith,2010,2014,Total,Total,140,2599,257,414,257,414,0,0,106,161,263,328,591,74,95,177,99,321,620
6009,Marcus Weathers,2017,2019,Total,Total,63,1625,209,418,182,325,27,93,175,264,138,251,389,48,45,45,99,157,620
6010,Nick Weatherspoon,2018,2019,Mississippi State,SEC,60,1687,238,498,192,357,46,141,98,136,15,158,173,130,63,10,70,111,620
6011,Josh Castellanos,2011,2014,Total,Total,114,2814,173,541,104,311,69,230,204,280,29,154,183,369,90,5,258,229,619
6012,Trey Landers,2017,2019,Dayton,A-10,70,1765,239,448,210,346,29,102,112,162,126,263,389,118,54,24,111,168,619
6013,Kyle Mallers,2017,2019,Ball State,MAC,99,2237,196,493,99,190,97,303,130,154,126,236,362,92,52,35,123,200,619
6014,Ikenna Ndugba,2017,2018,Bryant,NEC,63,2017,204,544,132,311,72,233,139,186,32,224,256,275,99,1,173,190,619
6015,Khari Price,2013,2017,Total,Total,95,2288,185,478,78,184,107,294,142,167,33,162,195,251,72,9,134,213,619
6016,E.J. Reed,2013,2014,Long Island University,NEC,63,1410,208,446,180,352,28,94,175,272,95,203,298,23,23,64,115,222,619
6017,Terry Rose,2013,2014,Grambling,SWAC,51,1601,217,546,77,170,140,376,48,63,26,112,138,46,22,0,93,67,619
6018,Tanner Rubio,2017,2019,Jacksonville,A-Sun,93,1806,203,532,56,133,147,399,66,95,23,97,120,158,48,2,142,115,619
6019,Bryan Sekunda,2015,2018,Stony Brook,AEC,116,2162,208,595,44,141,164,454,39,49,63,129,192,130,40,19,69,128,619
6020,Ibrahima Thomas,2008,2011,Total,Total,103,1894,234,502,210,402,24,100,127,228,183,316,499,39,42,64,99,302,619
6021,Matt Vest,2011,2014,Wright State,Horizon,123,2627,226,461,160,274,66,187,101,168,59,281,340,206,102,16,111,145,619
6022,Ryann Abraham,2008,2010,Appalachian State,Southern,85,1742,200,457,105,216,95,241,123,166,17,119,136,205,93,9,164,179,618
6023,Bryant Barr,2008,2010,Davidson,Southern,102,1745,203,562,43,128,160,434,52,77,49,134,183,64,28,5,62,122,618
6024,Shaquille Cleare,2013,2017,Total,Total,135,1997,257,458,257,457,0,1,104,161,147,279,426,32,22,44,105,278,618
6025,Aaron Epps,2015,2018,Louisiana State,SEC,105,1631,243,478,186,315,57,163,75,103,146,237,383,36,27,54,85,228,618
6026,Johnathan Gray,2010,2013,Cornell,Ivy,83,1591,207,526,109,242,98,284,106,153,72,152,224,76,42,12,104,137,618
6027,Dominique McKoy,2012,2015,Total,A-10,90,2008,264,477,264,465,0,12,90,178,141,326,467,78,53,54,98,160,618
6028,Geoff Payne,2008,2008,Southern Utah,Summit,30,1070,219,386,219,382,0,4,180,261,81,123,204,70,54,13,91,80,618
6029,Chris Prescott,2009,2013,Total,Total,121,2025,206,627,83,226,123,401,83,114,19,125,144,97,36,10,142,145,618
6030,Jermaine Ruttley,2015,2016,Total,Total,64,1598,221,510,181,363,40,147,136,195,57,239,296,116,65,3,93,152,618
6031,JoJo Walker,2018,2019,Portland,WCC,64,1794,186,480,101,242,85,238,161,228,20,145,165,184,59,1,130,134,618
6032,Karl Ziegler,2013,2014,Longwood,Big South,65,1711,222,445,221,437,1,8,173,230,84,172,256,74,40,9,113,153,618
6033,DeAndre Abram,2016,2019,Total,Total,72,1743,224,604,131,296,93,308,76,103,66,260,326,40,29,38,73,118,617
6034,Kadeem Allen,2016,2017,Arizona,Pac-12,68,1868,207,451,157,326,50,125,153,211,20,223,243,222,88,48,133,165,617
6035,Marcus Bartley,2015,2019,Total,Total,122,2560,200,516,53,142,147,374,70,95,11,164,175,261,68,15,167,303,617
6036,Joe Crisman,2012,2015,Loyola (IL),Total,121,3044,226,536,164,344,62,192,103,158,65,277,342,192,105,27,144,184,617
6037,Kenny Harris,2011,2012,Evansville,MVC,63,1715,188,443,167,370,21,73,220,306,97,230,327,94,91,33,115,180,617
6038,Jaron Jones,2011,2012,Eastern Kentucky,OVC,61,1384,216,405,189,334,27,71,158,208,67,134,201,69,59,14,72,129,617
6039,Stefan Kenic,2018,2019,Cleveland State,Horizon,66,1538,203,479,114,225,89,254,122,161,56,185,241,62,27,20,110,153,617
6040,Marquise Simmons,2010,2014,St. Bonaventure,A-10,114,2019,249,457,248,454,1,3,118,196,181,307,488,46,45,17,105,233,617
6041,James Thomas,2013,2014,Sam Houston State,Southland,68,1858,227,463,227,462,0,1,163,268,160,160,320,63,36,10,95,153,617
6042,Joe Thomasson,2015,2016,Wright State,Horizon,63,1916,199,437,149,287,50,150,169,211,48,290,338,207,53,41,127,180,617
6043,Devin Davis,2014,2018,Total,Total,84,1580,250,517,248,506,2,11,114,177,114,284,398,65,42,47,89,209,616
6044,Larry Davis,2008,2011,Cincinnati,Big East,132,2059,225,621,111,258,114,363,52,75,65,97,162,122,56,7,112,180,616
6045,Louis Ellis,2011,2012,Northwestern State,Southland,62,1425,210,542,96,207,114,335,82,123,58,114,172,127,82,16,124,109,616
6046,Justin Fry,2008,2011,Maryland-Baltimore County,AEC,88,2216,232,526,223,487,9,39,143,198,138,252,390,102,51,52,119,223,616
6047,Michael Karena,2015,2016,Wright State,Horizon,65,1356,253,475,253,475,0,0,110,181,99,141,240,27,26,19,108,221,616
6048,V.J. King,2017,2019,Louisville,ACC,101,1795,210,525,166,377,44,148,152,197,65,219,284,67,34,11,98,132,616
6049,Shawn Taggart,2008,2009,Memphis,CUSA,76,1593,228,451,214,400,14,51,146,204,178,265,443,28,43,88,64,179,616
6050,Demetrius Walker,2010,2014,Total,Total,90,1461,181,479,107,267,74,212,180,244,13,184,197,115,40,10,126,150,616
6051,John Wall,2010,2010,Kentucky,SEC,37,1288,202,438,165,324,37,114,175,232,30,129,159,241,66,19,149,72,616
6052,Terry Whisnant,2012,2015,Total,Total,88,1750,202,510,82,172,120,338,92,116,41,100,141,90,53,6,59,97,616
6053,Corey Wilford,2012,2013,Southeast Missouri State,OVC,57,1288,217,495,103,215,114,280,68,92,34,113,147,90,31,11,75,103,616
6054,Melvin Baker,2011,2012,Austin Peay,OVC,66,1494,240,494,225,443,15,51,120,171,103,225,328,54,49,52,120,202,615
6055,Chris Cooper,2009,2012,Old Dominion,CAA,123,2058,238,550,238,549,0,1,139,251,272,355,627,64,40,82,122,270,615
6056,Will Daniels,2008,2008,Rhode Island,A-10,33,941,228,455,183,330,45,125,114,165,68,148,216,36,32,31,80,101,615
6057,Brian Green,2010,2011,Utah State,WAC,68,1454,212,442,83,174,129,268,62,80,14,117,131,104,37,1,47,74,615
6058,Jonathan Han,2008,2009,Fairfield,MAAC,51,1899,193,440,93,201,100,239,129,175,16,122,138,298,77,4,176,110,615
6059,Sean McDermott,2017,2019,Butler,Big East,94,1983,211,455,76,124,135,331,58,74,75,218,293,56,43,18,60,183,615
6060,Chris Otule,2009,2014,Marquette,Big East,124,2075,240,409,240,409,0,0,135,256,205,240,445,19,30,145,128,254,615
6061,Austin Ramljak,2013,2014,Rice,CUSA,60,1737,193,493,32,75,161,418,68,95,19,115,134,62,35,6,55,145,615
6062,Travis Weatherington,2018,2019,Hartford,AEC,66,1926,213,452,81,140,132,312,57,68,40,190,230,79,62,6,88,115,615
6063,Derrick White,2017,2017,Colorado,Pac-12,34,1116,205,404,148,260,57,144,148,182,35,104,139,148,42,49,81,72,615
6064,Pat Benzan,2016,2019,Holy Cross,Patriot,118,2637,224,502,202,425,22,77,144,203,63,203,266,230,117,0,109,164,614
6065,Kion Brown,2013,2016,Radford,Big South,128,1908,245,495,245,495,0,0,124,227,135,210,345,39,18,21,146,252,614
6066,Jordan Clarke,2009,2013,Total,Total,105,2199,223,458,216,431,7,27,161,324,237,384,621,98,119,38,137,272,614
6067,Willie Galick,2009,2010,Cal State Northridge,Big West,63,1583,199,381,196,369,3,12,213,328,134,192,326,75,50,27,167,223,614
6068,Torian Graham,2017,2017,Arizona State,Pac-12,33,1147,230,513,122,234,108,279,46,56,19,120,139,39,31,11,44,51,614
6069,Billy Humphrey,2008,2010,Total,Total,45,1417,192,469,99,217,93,252,137,160,28,138,166,87,63,17,90,77,614
6070,Rashad Lindsey,2017,2018,Arkansas State,Sun Belt,64,2033,215,504,145,312,70,192,114,149,30,130,160,159,49,2,107,101,614
6071,Kendrick McDonald,2011,2012,Alcorn State,SWAC,59,1611,219,561,186,449,33,112,143,199,33,133,166,90,66,3,137,98,614
6072,E. Victor Nickerson,2012,2016,Total,Total,125,2291,195,550,162,401,33,149,191,287,82,199,281,162,81,17,197,236,614
6073,David Andoh,2013,2017,Total,Total,85,1677,238,561,225,509,13,52,124,177,113,213,326,34,25,23,134,161,613
6074,Hauns Brereton,2010,2013,Total,Total,91,1580,225,519,151,299,74,220,89,115,91,151,242,57,26,10,82,134,613
6075,Malcolm Brooks,2014,2016,Total,Total,56,1427,209,474,124,252,85,222,110,139,26,85,111,77,22,4,63,110,613
6076,Gerald Brown,2008,2008,Loyola (MD),MAAC,33,1037,178,453,111,262,67,191,190,240,48,111,159,63,52,5,96,117,613
6077,Michael Cobbins,2011,2015,Oklahoma State,Big 12,105,2669,251,469,251,467,0,2,111,178,170,418,588,57,68,163,108,265,613
6078,Carson Desrosiers,2011,2015,Total,Total,128,2742,225,518,201,446,24,72,139,203,145,393,538,92,47,273,104,326,613
6079,Travis Fulton,2012,2013,Pacific,Big West,65,1723,224,511,149,302,75,209,90,118,101,223,324,115,47,8,78,87,613
6080,Austin Johnson,2008,2009,Oklahoma,Big 12,71,2222,204,499,111,227,93,272,112,148,32,171,203,235,86,43,104,133,613
6081,Chad Lott,2017,2019,Total,Total,62,1539,241,487,223,444,18,43,113,170,70,183,253,121,53,31,132,129,613
6082,Bruce Moore,2017,2019,Bucknell,Patriot,98,1943,190,423,130,247,60,176,173,231,99,182,281,52,28,51,89,245,613
6083,Langston Morris-Walker,2013,2016,Oregon State,Pac-12,118,2259,201,547,111,275,90,272,121,178,76,226,302,86,63,4,80,167,613
6084,Cory Osetkowski,2012,2015,Columbia,Ivy,114,2142,229,498,206,419,23,79,132,211,151,268,419,145,41,90,124,228,613
6085,AJ Sumbry,2014,2019,Total,Total,121,2015,224,484,224,481,0,3,165,289,221,330,551,34,25,147,142,360,613
6086,Iziahiah Sweeney,2015,2018,Total,Total,81,1734,232,590,190,431,42,159,107,158,83,143,226,87,69,29,112,151,613
6087,Matt Townsend,2012,2015,Yale,Ivy,110,2218,240,474,239,466,1,8,132,191,153,198,351,102,37,22,122,212,613
6088,Brett Winkelman,2009,2009,North Dakota State,Summit,33,1088,220,438,178,332,42,106,131,162,71,178,249,58,48,12,60,62,613
6089,Antoine Agudio,2008,2008,Hofstra,CAA,27,1056,207,480,123,275,84,205,114,147,15,91,106,77,31,0,96,49,612
6090,Vashil Fernandez,2013,2016,Valparaiso,Horizon,131,2596,242,442,242,442,0,0,128,264,240,433,673,38,46,288,131,336,612
6091,Kevin Ford,2009,2010,Oral Roberts,Summit,56,1501,233,440,233,437,0,3,146,235,167,251,418,61,47,73,101,167,612
6092,Chris Freeman,2012,2015,Austin Peay,OVC,114,1740,246,439,246,438,0,1,120,177,126,254,380,46,32,62,117,220,612
6093,Steve Harris,2016,2019,Austin Peay,OVC,92,1711,245,524,231,482,14,42,108,158,64,112,176,121,53,30,134,138,612
6094,Paul McCoy,2009,2014,Total,Total,94,1963,220,510,176,370,44,140,128,198,54,186,240,161,86,4,156,141,612
6095,Rhon Mitchell,2013,2014,Lamar,Southland,60,1594,245,606,243,584,2,22,120,156,72,173,245,70,21,37,149,87,612
6096,Gabriel Olaseni,2012,2015,Iowa,Big Ten,122,1672,208,407,208,407,0,0,196,269,206,239,445,40,30,141,89,234,612
6097,Dylan Royer,2010,2013,Cal Poly,Big West,93,1722,201,478,32,98,169,380,41,47,35,119,154,59,49,6,56,118,612
6098,Matt Rum,2010,2013,William & Mary,CAA,127,2814,197,536,87,204,110,332,108,131,50,332,382,227,71,6,166,213,612
6099,Jarquez Smith,2014,2017,Florida State,ACC,136,1879,239,468,222,398,17,70,117,172,125,238,363,39,32,123,130,269,612
6100,Khem Birch,2012,2014,Total,Total,69,1755,208,392,208,392,0,0,195,292,212,324,536,55,41,211,82,149,611
6101,Ar'Mond Davis,2017,2019,Total,Total,64,1377,213,555,132,299,81,256,104,133,55,181,236,49,34,5,60,68,611
6102,Joe Efese,2010,2013,Central Connecticut State,NEC,115,1915,244,458,244,458,0,0,123,186,173,203,376,36,37,150,128,279,611
6103,Travis Hammonds,2014,2016,Long Beach State,Big West,77,1534,206,462,120,242,86,220,113,155,80,204,284,75,60,28,97,193,611
6104,Phil Jones,2008,2011,Charlotte,A-10,110,1901,225,519,221,497,4,22,157,225,191,249,440,54,27,158,88,267,611
6105,Skylar McBee,2010,2013,Tennessee,SEC,131,2409,182,537,21,72,161,465,86,100,26,127,153,78,74,2,70,213,611
6106,Brady Morningstar,2009,2011,Kansas,Big 12,100,2689,218,490,106,218,112,272,63,86,69,183,252,297,128,16,120,172,611
6107,Lucas Siewert,2017,2019,Colorado,Pac-12,98,1840,210,495,119,257,91,238,100,131,98,240,338,92,27,29,100,189,611
6108,Manny Thomas,2012,2015,Marist,MAAC,123,2570,188,519,90,250,98,269,137,185,56,247,303,133,71,29,150,206,611
6109,Corey Wickware,2011,2012,Southern Illinois-Edwardsville,Total,56,1661,176,460,66,171,110,289,149,180,24,112,136,144,54,5,137,104,611
6110,Cory Cooperwood,2009,2010,Wright State,Horizon,65,1558,218,452,208,416,10,36,164,230,155,217,372,51,51,50,86,201,610
6111,Ben Dickinson,2012,2015,Total,Total,68,1504,239,548,228,491,11,57,121,182,105,191,296,104,31,22,126,187,610
6112,Jimmy Gavin,2013,2016,Total,Total,42,1108,201,423,105,188,96,235,112,135,17,79,96,95,26,2,67,57,610
6113,John Pichon,2008,2009,McNeese State,Southland,58,1795,239,534,224,464,15,70,117,182,124,253,377,151,47,32,166,98,610
6114,Kevin White,2008,2011,Total,Total,88,2202,225,622,199,505,26,117,134,194,35,145,180,341,88,6,244,150,610
6115,Sam Downey,2014,2017,Yale,Ivy,91,1567,250,443,245,425,5,18,104,148,134,221,355,45,31,23,59,153,609
6116,Paul Garnica,2011,2013,Northern Colorado,Big Sky,90,1658,218,509,111,250,107,259,66,84,25,140,165,172,89,7,144,154,609
6117,Denzel Johnson,2012,2015,Santa Clara,WCC,117,2055,229,608,171,421,58,187,93,127,54,134,188,111,69,6,78,134,609
6118,Christian Jones,2013,2017,Total,Total,101,1893,252,532,251,528,1,4,104,178,106,277,383,77,49,36,118,147,609
6119,Kyle Lewis,2008,2011,Denver,Sun Belt,120,2830,203,494,107,229,96,265,107,137,33,92,125,159,60,5,119,268,609
6120,Gary Stewart,2011,2014,Northwestern State,Southland,120,1908,206,497,115,238,91,259,106,144,82,193,275,106,53,20,151,134,609
6121,Tony Watson,2010,2013,Buffalo,MAC,110,2057,185,450,53,117,132,333,107,125,14,175,189,204,47,0,110,123,609
6122,Ryan Bass,2011,2015,Total,Total,104,1835,207,542,156,387,51,155,143,176,53,118,171,194,71,5,127,213,608
6123,Ahmad Clark,2018,2019,Albany (NY),AEC,61,1293,188,514,112,286,76,228,156,200,21,148,169,163,78,15,141,127,608
6124,Anthony Farmer,2008,2009,Rutgers,Big East,63,1850,204,483,154,339,50,144,150,203,35,131,166,159,49,5,110,123,608
6125,Jordan Glynn,2010,2011,Stephen F. Austin,Southland,61,1854,219,405,219,402,0,3,170,212,190,310,500,69,63,9,93,146,608
6126,Tyler Honeycutt,2010,2011,UCLA,Pac-10,59,1873,213,494,148,313,65,181,117,171,103,304,407,163,68,98,163,112,608
6127,Jaylen Minnett,2018,2019,IUPUI,Horizon,63,1419,200,541,71,168,129,373,79,93,22,82,104,100,43,3,88,95,608
6128,Christian Moon,2012,2013,Montana State,Big Sky,51,1500,200,439,98,178,102,261,106,137,42,87,129,68,60,7,57,96,608
6129,Tyler Quinney,2008,2009,Southern Utah,Summit,60,1636,207,422,207,420,0,2,194,240,105,147,252,70,38,5,118,175,608
6130,L.J. Rose,2013,2017,Total,Total,106,2374,192,516,123,303,69,213,155,210,42,214,256,415,66,8,189,132,608
6131,Joe Alexander,2008,2008,West Virginia,Big East,36,1137,219,474,208,433,11,41,158,194,68,163,231,88,26,54,80,103,607
6132,DeMario Anderson,2008,2008,Quinnipiac,NEC,28,924,220,492,185,398,35,94,132,164,29,152,181,91,43,12,116,82,607
6133,Carl Baptiste,2010,2014,Total,Total,115,1989,250,451,248,440,2,11,105,158,150,337,487,31,32,82,110,284,607
6134,Auston Barnes,2011,2015,Total,Total,93,2239,205,498,128,277,77,221,120,143,135,229,364,69,61,27,93,180,607
6135,Bruce Brown,2017,2018,Miami (FL),ACC,52,1693,212,480,163,325,49,155,134,191,73,248,321,182,74,33,110,126,607
6136,Shakir Brown,2016,2017,James Madison,CAA,61,1445,204,540,105,242,99,298,100,129,80,206,286,72,54,12,87,152,607
6137,Uche Echefu,2008,2009,Florida State,ACC,67,1729,188,431,151,305,37,126,194,234,125,296,421,36,41,45,127,182,607
6138,Tramayne Hawthorne,2008,2009,Drexel,CAA,61,1864,206,595,68,165,138,430,57,85,48,129,177,151,92,9,76,122,607
6139,Sanjay Lumpkin,2013,2017,Northwestern,Big Ten,137,3475,213,441,159,270,54,171,127,190,179,458,637,158,97,45,143,417,607
6140,Joe Mazzulla,2008,2011,West Virginia,Big East,114,2380,183,419,163,354,20,65,221,344,54,267,321,338,92,6,166,267,607
6141,Terry Nolan Jr.,2018,2019,George Washington,A-10,62,1782,182,475,93,210,89,265,154,233,38,202,240,135,80,24,114,169,607
6142,Darren Payen,2013,2017,Total,Total,124,1591,248,430,244,406,4,24,107,165,117,224,341,23,26,83,102,186,607
6143,Jeffrey Simmons,2014,2015,Mississippi Valley State,SWAC,54,1386,255,556,238,482,17,74,80,129,24,120,144,110,56,2,158,89,607
6144,Michael Zeno,2015,2018,New Orleans,Southland,122,1979,226,570,225,558,1,12,154,273,145,238,383,94,83,55,190,203,607
6145,Brock Zylstra,2010,2013,Brigham Young,Total,119,2100,209,487,107,199,102,288,87,129,61,271,332,147,82,12,93,157,607
6146,Kauri Black,2010,2013,Total,Total,114,2400,232,441,232,441,0,0,142,253,150,258,408,119,103,56,142,347,606
6147,Jacob Enevold,2014,2017,Drake,MVC,119,2148,229,405,229,405,0,0,148,211,155,373,528,40,20,74,162,203,606
6148,Steve Harley,2008,2009,Nebraska,Big 12,63,1780,225,538,183,425,42,113,114,172,26,151,177,108,79,5,87,79,606
6149,Andre Malone,2010,2013,Total,Total,80,1773,220,568,127,277,93,291,73,100,68,174,242,55,63,10,59,132,606
6150,Eli Scott,2018,2019,Loyola Marymount,WCC,58,1611,230,472,225,451,5,21,141,229,129,226,355,140,39,22,124,118,606
6151,Shawn Williams,2010,2014,Total,Total,100,2354,234,520,177,338,57,182,81,144,148,245,393,110,69,44,87,220,606
6152,Rakiya Battle,2014,2017,Alabama A&M,SWAC,105,2641,172,535,128,361,44,174,217,303,58,197,255,473,96,9,238,159,605
6153,Julian Boatner,2011,2014,William & Mary,CAA,124,2303,196,497,35,77,161,420,52,66,18,134,152,135,48,2,104,131,605
6154,Chris Cooks,2008,2009,Missouri State,MVC,58,1564,200,496,153,365,47,131,158,233,116,196,312,132,55,12,172,152,605
6155,Luke Devlin,2011,2014,Albany (NY),AEC,128,2389,230,529,177,347,53,182,92,139,168,337,505,84,57,26,90,174,605
6156,Jarrid Famous,2010,2011,South Florida,Big East,63,1594,226,439,226,437,0,2,153,222,173,236,409,29,24,38,108,151,605
6157,Kyrin Galloway,2017,2019,North Carolina-Greensboro,Southern,100,1897,231,442,165,255,66,187,77,113,123,252,375,31,40,73,69,170,605
6158,Xavier Gibson,2009,2012,Florida State,ACC,124,1610,237,485,225,437,12,48,119,189,138,239,377,40,39,100,156,221,605
6159,Devonte Hampton,2013,2016,Alcorn State,SWAC,101,2356,215,583,125,303,90,280,85,138,52,252,304,159,88,21,154,215,605
6160,Eric Petty,2008,2009,Mississippi Valley State,SWAC,65,1707,218,510,204,453,14,57,155,247,179,232,411,54,48,35,131,171,605
6161,Anthony Winbush,2009,2013,Loyola (MD),MAAC,123,2911,223,533,193,430,30,103,129,187,175,348,523,180,136,40,177,263,605
6162,Patrik Auda,2011,2014,Seton Hall,Big East,90,1970,212,415,174,304,38,111,142,203,105,230,335,96,53,32,103,212,604
6163,Treshawn Bolden,2014,2018,Jackson State,SWAC,120,2236,228,584,219,552,9,32,139,242,164,332,496,131,36,60,246,354,604
6164,Chris Burke,2011,2014,Saint Peter's,MAAC,119,2540,222,536,156,331,66,205,94,135,120,273,393,124,92,86,139,179,604
6165,Shaun Green,2008,2009,Utah,MWC,67,2017,206,453,78,120,128,333,64,87,80,260,340,137,67,61,70,185,604
6166,Makinde London,2016,2018,Total,Total,77,1325,208,508,134,286,74,222,114,162,70,256,326,81,52,45,137,158,604
6167,Sean O'Mara,2015,2018,Xavier,Big East,130,1366,234,391,234,391,0,0,136,199,121,184,305,70,31,50,83,167,604
6168,Christian Peevy,2017,2019,Incarnate Word,Southland,60,1165,195,368,190,350,5,18,209,243,75,157,232,45,41,23,115,141,604
6169,Keenan Simmons,2015,2018,Southern Illinois-Edwardsville,OVC,104,2288,250,456,240,430,10,26,94,156,216,305,521,26,33,117,72,297,604
6170,Onno Steger,2017,2019,Western Carolina,Southern,91,1948,199,519,85,210,114,309,92,133,85,200,285,98,62,14,139,207,604
6171,Denzell Watts,2014,2017,Alabama-Birmingham,CUSA,131,2284,199,487,98,227,101,260,105,146,19,208,227,223,77,4,135,144,604
6172,Antoine Allen,2013,2014,South Alabama,Sun Belt,61,1660,189,577,81,233,108,344,117,158,25,162,187,82,63,10,114,151,603
6173,Derail Green,2014,2017,Total,Total,87,1677,208,496,124,274,84,222,103,126,55,170,225,94,33,19,100,171,603
6174,Mario Kegler,2017,2019,Total,Total,60,1692,211,495,144,290,67,205,114,174,79,258,337,73,33,24,105,155,603
6175,Corbin Miller,2012,2017,Harvard,Ivy,108,1961,200,540,44,122,156,418,47,63,14,109,123,70,36,3,66,70,603
6176,Carlos Morris,2015,2016,Minnesota,Big Ten,57,1459,219,515,162,356,57,159,108,152,35,155,190,104,77,13,113,93,603
6177,Donovan Ross,2014,2015,Lamar,Southland,60,1617,221,412,220,403,1,9,160,201,92,181,273,49,51,40,109,138,603
6178,Tory Stewart-Miller,2015,2019,Total,Total,115,1687,227,442,222,427,5,15,144,222,149,295,444,36,29,34,123,216,603
6179,Ameer Ali,2009,2012,Morgan State,MEAC,115,1917,220,443,203,393,17,50,145,244,163,323,486,76,74,25,172,249,602
6180,Mitchell Anderson,2012,2013,Arkansas-Pine Bluff,SWAC,63,1687,231,575,188,413,43,162,97,164,115,237,352,70,63,90,110,120,602
6181,Anthony Brown,2008,2009,Pacific,Big West,65,1609,204,377,203,376,1,1,193,300,100,284,384,53,33,19,124,139,602
6182,Trahson Burrell,2015,2016,Memphis,AAC,63,1507,219,502,170,342,49,160,115,159,145,212,357,146,62,39,80,137,602
6183,Darion Clark,2013,2017,Total,Total,110,1936,229,467,229,466,0,1,144,282,191,389,580,53,43,54,155,209,602
6184,Craig Craft,2008,2009,Southern Mississippi,CUSA,63,1753,230,546,150,319,80,227,62,93,110,212,322,42,46,3,77,124,602
6185,Miles Dixon,2013,2014,Wright State,Horizon,71,1677,201,504,168,389,33,115,167,214,35,101,136,117,46,16,98,101,602
6186,Anthony Holliday,2014,2015,Lamar,Southland,57,1437,191,392,162,307,29,85,191,249,22,84,106,145,50,10,132,125,602
6187,Jeremiah Kreisberg,2011,2015,Total,Total,108,2025,218,440,214,422,4,18,162,225,137,241,378,87,24,25,159,221,602
6188,Alex Murphy,2013,2017,Total,Total,91,1520,226,470,165,278,61,192,89,166,62,191,253,61,35,28,98,126,602
6189,David Ndoumba,2008,2011,Southeastern Louisiana,Southland,119,2030,211,401,211,399,0,2,180,292,186,368,554,58,34,97,95,198,602
6190,RaShawn Polk,2010,2011,Towson,CAA,58,1484,221,539,133,288,88,251,72,109,72,112,184,60,56,14,80,111,602
6191,Justin Raffington,2011,2015,Total,Total,105,1957,227,481,222,455,5,26,143,256,186,335,521,58,23,56,167,213,602
6192,Reggie Redding,2008,2010,Villanova,Big East,96,2457,213,509,169,369,44,140,132,198,117,268,385,231,114,44,137,249,602
6193,Chris Washburn,2013,2017,Total,Total,122,2050,212,474,207,458,5,16,173,330,145,284,429,117,112,86,155,293,602
6194,Kareem Brewton Jr.,2018,2019,Memphis,AAC,70,1633,229,518,186,360,43,158,100,148,64,145,209,163,74,5,136,167,601
6195,Adam Brown,2010,2011,Houston,CUSA,60,1545,214,496,118,256,96,240,77,106,46,133,179,106,57,11,87,121,601
6196,Mike Bruesewitz,2010,2013,Wisconsin,Big Ten,131,2723,211,514,136,253,75,261,104,145,197,325,522,162,63,26,123,268,601
6197,Hayden Farquhar,2016,2019,Abilene Christian,Southland,124,1444,227,492,133,229,94,263,53,91,93,211,304,68,51,23,84,208,601
6198,De'Aaron Fox,2017,2017,Kentucky,SEC,36,1064,214,447,197,378,17,69,156,212,21,122,143,165,53,7,87,90,601
6199,Jaycee Hillsman,2016,2018,San Jose State,MWC,90,1847,181,456,124,266,57,190,182,225,71,171,242,144,36,17,160,204,601
6200,Tyrone Johnson,2012,2015,Total,Total,81,1978,182,507,140,366,42,141,195,241,28,141,169,234,69,12,151,141,601
6201,TJ Lang,2015,2019,Total,Total,121,2302,176,467,42,100,134,367,115,169,67,158,225,72,46,8,73,230,601
6202,Bryan LeDuc,2008,2009,Pacific,Big West,65,1320,213,385,159,240,54,145,121,156,97,179,276,20,42,20,58,108,601
6203,Isaac Neilson,2015,2018,Total,Total,102,1544,235,410,214,353,21,57,110,157,208,335,543,55,45,86,99,211,601
6204,Kipper Nichols,2017,2019,Illinois,Big Ten,85,1477,214,490,157,317,57,173,116,153,89,190,279,61,51,28,78,200,601
6205,Chris Reyes,2015,2017,Total,Total,97,1734,233,452,228,437,5,15,130,220,128,291,419,88,25,67,86,146,601
6206,AJ West,2014,2016,Nevada,MWC,61,1626,210,425,210,424,0,1,181,289,296,254,550,27,27,145,116,161,601
6207,Korvotney Barber,2008,2009,Auburn,SEC,46,1344,247,427,247,427,0,0,106,229,160,256,416,42,32,57,103,130,600
6208,Jeremy Crouch,2008,2008,Bradley,MVC,38,1315,194,460,76,164,118,296,94,108,17,121,138,122,57,3,87,83,600
6209,Christian Ellis,2017,2019,Southern Illinois-Edwardsville,OVC,90,2148,220,487,209,434,11,53,149,293,122,253,375,257,76,5,211,290,600
6210,Malik Ellison,2016,2019,Total,Total,88,1979,200,483,153,335,47,148,153,254,74,210,284,182,60,20,172,227,600
6211,Scooter Gillette,2010,2014,Total,Total,133,2122,220,395,220,393,0,2,160,245,162,217,379,33,40,117,112,364,600
6212,Artur Labinowicz,2017,2018,Coastal Carolina,Sun Belt,71,1731,175,461,85,212,90,249,160,217,73,220,293,75,47,26,123,117,600
6213,Justin Mason,2008,2010,Texas,Big 12,106,2924,223,530,185,400,38,130,116,204,133,234,367,314,108,35,150,208,600
6214,Papa Oppong,2009,2010,Eastern Kentucky,OVC,59,1519,222,460,127,236,95,224,61,88,75,174,249,79,73,18,57,128,600
6215,R.J. Rutledge,2008,2011,Monmouth,NEC,101,1877,204,535,96,211,108,324,84,132,43,190,233,84,33,16,95,240,600
6216,Joey Shaw,2009,2010,Nevada,WAC,67,1601,205,466,138,265,67,201,123,152,104,200,304,73,41,31,79,176,600
6217,Joshua Treadwell,2016,2017,Coppin State,MEAC,63,1349,200,513,123,291,77,222,123,158,62,205,267,55,33,6,94,134,600
6218,Kayode Ayeni,2008,2010,St. Francis (NY),NEC,64,1662,209,513,156,342,53,171,128,187,138,233,371,79,43,52,151,175,599
6219,Trey Blue,2009,2013,Total,Total,96,1600,204,544,114,254,90,290,101,142,42,127,169,90,51,6,127,127,599
6220,Shawntes Gary,2008,2009,Western Michigan,MAC,63,1630,199,479,166,374,33,105,168,224,104,229,333,73,57,30,103,181,599
6221,Jordan Hill,2014,2018,Total,Total,109,1960,203,526,102,232,101,294,92,123,41,168,209,155,56,16,129,182,599
6222,Christopher Hyder,2013,2016,Southern,SWAC,119,3321,204,456,186,382,18,74,173,241,52,322,374,476,198,4,174,228,599
6223,Cooper Land,2008,2011,Wright State,Horizon,113,1881,189,477,94,207,95,270,126,183,102,175,277,58,39,8,107,248,599
6224,Cortez Mitchell,2017,2018,Charleston Southern,Big South,59,1384,221,487,183,366,38,121,119,181,25,159,184,116,50,7,83,103,599
6225,Milan Prodanovic,2008,2010,Iona,MAAC,92,2189,191,504,59,134,132,370,85,109,30,158,188,93,86,12,88,191,599
6226,Julius Randle,2014,2014,Kentucky,SEC,40,1233,196,391,193,373,3,18,204,289,139,277,416,57,20,31,101,91,599
6227,Sean Smiley,2008,2010,Buffalo,MAC,88,1330,197,549,71,188,126,361,79,102,30,122,152,66,52,5,88,83,599
6228,Aaron Thompson,2009,2010,Cal State Fullerton,Big West,63,1661,218,469,155,299,63,170,100,146,89,220,309,124,57,35,130,120,599
6229,Ian Boyd,2017,2019,George Mason,A-10,95,1909,214,525,147,301,67,224,103,143,94,189,283,81,60,9,96,194,598
6230,Claude Britten,2008,2011,Texas-El Paso,CUSA,115,1204,257,474,257,472,0,2,84,155,107,155,262,20,20,78,69,209,598
6231,Jeremy Buttell,2008,2010,Illinois-Chicago,Horizon,88,1999,219,495,150,283,69,212,91,133,175,333,508,49,48,21,91,189,598
6232,Jesse Carr,2009,2012,Colorado State,MWC,93,2010,200,451,123,234,77,217,121,170,33,185,218,204,70,7,152,176,598
6233,Travis Gabbidon,2008,2009,Texas-San Antonio,Southland,46,1318,195,478,146,316,49,162,159,222,86,201,287,73,59,18,111,98,598
6234,Laron Griffin,2010,2012,Eastern Washington,Big Sky,92,1875,229,454,229,454,0,0,140,255,239,301,540,52,53,70,89,332,598
6235,Adedeji Ibitayo,2012,2015,Akron,MAC,102,1508,192,453,116,234,76,219,138,209,73,159,232,68,52,29,89,157,598
6236,Carderro Nwoji,2008,2009,Florida Atlantic,Sun Belt,61,1987,195,501,97,232,98,269,110,131,41,165,206,185,42,1,111,117,598
6237,John Rybak,2009,2010,Texas State,Southland,61,1629,189,450,68,122,121,328,99,122,120,143,263,106,68,15,71,209,598
6238,Antonnio Benton,2011,2014,Southeastern Louisiana,Southland,95,2025,220,506,192,394,28,112,129,179,118,275,393,65,37,66,132,189,597
6239,Chaundee Brown,2018,2019,Wake Forest,ACC,61,1527,217,530,147,318,70,212,93,112,79,165,244,72,28,11,85,98,597
6240,Lance Feurtado,2008,2011,Total,Total,67,1546,205,541,145,367,60,174,127,173,67,180,247,60,36,11,104,137,597
6241,Harrison Hawkins,2014,2015,Abilene Christian,Southland,47,1222,197,471,115,253,82,218,121,148,15,62,77,97,42,3,121,127,597
6242,Justin Hawkins,2008,2008,New Mexico State,WAC,33,1093,199,421,157,316,42,105,157,201,84,154,238,78,32,16,92,89,597
6243,Tyler Kepkay,2008,2009,Utah,MWC,67,1899,199,491,114,263,85,228,114,135,18,170,188,106,46,0,123,129,597
6244,Kirk Korver,2010,2014,Missouri-Kansas City,Total,113,2038,193,479,93,171,100,308,111,141,85,182,267,67,46,21,107,209,597
6245,Marquez Letcher-Ellis,2016,2017,Rice,CUSA,67,1357,196,397,169,301,27,96,178,273,100,229,329,39,53,72,135,211,597
6246,Lekendric Longmire,2008,2010,Oregon,Pac-10,84,1589,231,515,198,421,33,94,102,158,110,151,261,44,74,14,75,175,597
6247,Kamar McKnight,2018,2019,Tennessee State,OVC,59,1505,209,540,148,316,61,224,118,167,28,125,153,103,49,2,120,126,597
6248,Trayvon Reed,2015,2019,Total,Total,75,1541,235,358,229,337,6,21,121,197,131,346,477,29,21,140,96,188,597
6249,Chris Roberts,2009,2010,Bradley,MVC,67,1845,200,459,130,263,70,196,127,187,99,195,294,113,86,43,99,138,597
6250,Derrick Rose,2008,2008,Memphis,CUSA,40,1168,208,436,173,332,35,104,146,205,54,127,181,189,48,15,107,68,597
6251,Paul Scruggs,2018,2019,Xavier,Big East,69,1719,214,466,149,284,65,182,104,142,50,189,239,176,60,27,144,164,597
6252,Andrew Wiggins,2014,2014,Kansas,Big 12,35,1148,189,422,146,296,43,126,176,227,76,129,205,54,41,34,80,94,597
6253,Ian Andersen,2008,2010,Charlotte,A-10,91,1575,188,519,32,67,156,452,64,81,29,128,157,33,15,2,56,102,596
6254,Bobby Austin,2008,2013,Furman,Southern,105,2499,203,552,105,286,98,266,92,123,76,220,296,123,81,33,155,198,596
6255,Alex Barlow,2012,2015,Butler,Total,116,2931,194,497,91,207,103,290,105,132,52,307,359,274,187,18,146,305,596
6256,Matt Bingaya,2014,2015,Southern Mississippi,CUSA,64,1420,215,465,189,366,26,99,140,214,85,212,297,78,64,25,108,116,596
6257,Milton Burton,2010,2011,Hartford,AEC,58,1949,219,594,132,305,87,289,71,97,73,175,248,127,94,27,95,153,596
6258,Jamaal Calvin,2014,2017,Southeast Missouri State,OVC,108,2232,185,519,53,148,132,371,94,114,47,177,224,180,99,3,104,154,596
6259,Caden Dickerson,2010,2014,Western Kentucky,Sun Belt,124,2927,197,511,79,176,118,335,84,108,50,152,202,131,53,3,127,178,596
6260,Travis Fields,2017,2019,Total,Total,95,1826,215,547,123,298,92,249,74,104,31,120,151,185,89,7,103,145,596
6261,Phil Gary,2010,2011,Florida International,Sun Belt,60,1709,180,411,125,250,55,161,181,255,34,88,122,187,92,5,141,162,596
6262,Kyle Hines,2008,2008,North Carolina-Greensboro,Southern,31,1002,235,423,234,415,1,8,125,199,122,159,281,43,56,95,103,86,596
6263,Jordan McCoy,2010,2013,Florida Atlantic,Sun Belt,121,2432,227,426,227,425,0,1,142,238,236,318,554,23,45,63,75,251,596
6264,Willie Moore,2013,2016,Total,Total,109,1937,188,502,122,283,66,219,154,205,56,206,262,118,113,9,181,230,596
6265,Race Parsons,2014,2017,Southern Utah,Big Sky,99,1888,190,506,72,162,118,344,98,129,65,193,258,94,34,11,85,182,596
6266,Rex Pflueger,2016,2019,Notre Dame,ACC,110,2607,196,507,107,252,89,255,115,147,81,253,334,240,103,33,102,183,596
6267,Derryck Thornton,2016,2019,Total,Total,93,2178,223,583,171,415,52,168,98,138,26,164,190,260,84,16,156,158,596
6268,Pieter van Tongeren,2008,2011,Evansville,MVC,122,2078,248,449,248,449,0,0,100,177,147,207,354,27,21,36,110,331,596
6269,Calvin Baker,2008,2010,Virginia,ACC,86,1938,215,551,145,336,70,215,95,126,34,145,179,204,71,10,147,143,595
6270,Nick Chasten,2011,2012,North Carolina Central,Total,62,1644,251,490,206,351,45,139,48,72,117,211,328,46,58,39,96,178,595
6271,Tamenang Choh,2018,2019,Brown,Ivy,59,1625,209,406,201,374,8,32,169,260,126,297,423,149,55,45,147,179,595
6272,Adonis De La Rosa,2017,2019,Total,Total,96,1581,201,406,201,405,0,1,193,271,175,259,434,54,35,50,178,263,595
6273,Jontel Evans,2010,2013,Virginia,ACC,120,3096,247,594,234,552,13,42,88,158,37,210,247,419,149,8,224,243,595
6274,Brian Laing,2008,2008,Seton Hall,Big East,32,1225,218,479,181,380,37,99,122,152,60,161,221,63,50,16,78,90,595
6275,Jonathan Laurent,2016,2019,Total,Total,88,1750,208,427,163,312,45,115,134,172,88,275,363,79,39,19,128,169,595
6276,Luke Loucks,2009,2012,Florida State,ACC,136,2673,193,504,105,233,88,271,121,178,38,264,302,391,119,18,249,275,595
6277,Chris Lutz,2009,2010,Marshall,CUSA,62,1665,185,476,56,150,129,326,96,122,23,107,130,119,50,4,87,125,595
6278,Eric Mosley,2012,2013,St. Bonaventure,A-10,61,1181,188,451,70,161,118,290,101,121,15,108,123,114,58,7,87,109,595
6279,Al Nolen,2008,2011,Minnesota,Big Ten,98,2485,161,473,101,279,60,194,213,290,69,228,297,394,205,11,174,192,595
6280,Nick Pascale,2009,2012,Colgate,Patriot,117,2167,219,443,219,442,0,1,157,248,141,402,543,93,35,100,148,289,595
6281,Chris Anderson,2013,2014,Louisiana Tech,Total,71,1365,220,501,182,372,38,129,116,178,116,210,326,55,72,29,99,201,594
6282,Braian Angola-Rodas,2017,2018,Florida State,ACC,69,1365,187,439,102,219,85,220,135,164,43,150,193,147,61,13,90,126,594
6283,Devon Austin,2008,2009,Manhattan,MAAC,52,1533,209,521,124,261,85,260,91,112,95,133,228,46,41,40,69,126,594
6284,Nate Blank,2008,2009,Gardner-Webb,Total,59,1445,205,486,106,226,99,260,85,110,50,142,192,118,59,10,109,200,594
6285,Pat Calathes,2008,2008,Saint Joseph's,A-10,34,1143,189,422,115,237,74,185,142,172,66,189,255,92,42,42,78,92,594
6286,Tyree Crump,2017,2019,Georgia,SEC,91,1317,185,513,58,138,127,375,97,123,9,102,111,99,27,3,100,80,594
6287,Mikey Dixon,2017,2019,Total,Total,45,1167,202,444,129,252,73,192,117,144,39,95,134,87,32,3,78,75,594
6288,Daylon Guy,2011,2012,Little Rock,Sun Belt,67,1722,190,498,110,251,80,247,134,178,23,160,183,126,79,4,85,113,594
6289,Tyler Holloway,2008,2009,Murray State,OVC,62,1701,201,452,86,177,115,275,77,91,21,88,109,127,38,2,66,66,594
6290,Jaden Jackson,2015,2016,Utah Valley,WAC,60,1543,212,548,128,301,84,247,86,109,22,98,120,115,43,1,57,79,594
6291,Deshaun Morman,2015,2018,Total,Total,80,1574,195,453,165,358,30,95,174,233,59,130,189,117,90,22,117,146,594
6292,Earl Peterson,2015,2016,Loyola (IL),MVC,68,1783,202,430,162,330,40,100,150,195,17,130,147,142,57,11,120,99,594
6293,Nafis Ricks,2010,2011,Missouri State,MVC,71,1729,187,461,172,414,15,47,205,291,108,150,258,234,58,19,127,156,594
6294,Devonte Upson,2014,2015,Southeastern Louisiana,Southland,62,1846,241,402,241,401,0,1,112,195,151,269,420,45,43,99,97,178,594
6295,Cornelius Vines,2009,2010,Hofstra,CAA,64,1744,185,584,53,161,132,423,92,145,49,134,183,125,78,5,97,187,594
6296,Jerran Young,2013,2014,Wright State,Horizon,71,1421,218,432,179,323,39,109,119,185,88,183,271,75,100,59,122,205,594
6297,Samir Doughty,2017,2019,Total,Total,74,1751,197,456,131,274,66,182,133,172,70,190,260,142,87,5,121,161,593
6298,Geoffrey Groselle,2013,2016,Creighton,Total,98,1220,232,339,232,339,0,0,129,191,124,193,317,27,24,67,83,172,593
6299,Anwar Johnson,2008,2009,Air Force,MWC,61,1970,184,411,177,384,7,27,218,319,65,156,221,148,55,9,115,175,593
6300,Sam Kearns,2018,2019,Oral Roberts,Summit,58,1819,199,505,73,164,126,341,69,85,22,124,146,224,40,4,120,150,593
6301,Kameron McGusty,2017,2018,Oklahoma,Big 12,63,1363,215,504,143,294,72,210,91,119,24,105,129,38,35,9,74,75,593
6302,James Siakam,2012,2015,Vanderbilt,SEC,104,1829,196,332,194,324,2,8,199,283,190,227,417,65,68,91,101,239,593
6303,C.J. Washington,2014,2015,Alabama-Birmingham,CUSA,62,1365,228,522,185,382,43,140,94,151,135,187,322,31,45,31,83,143,593
6304,Dana Batt,2016,2019,Colgate,Patriot,125,2045,246,402,246,401,0,1,100,135,120,260,380,56,47,84,101,257,592
6305,Jerryd Bayless,2008,2008,Arizona,Pac-10,30,1072,173,378,114,233,59,145,187,223,13,69,82,121,29,3,89,66,592
6306,Josh Davenport,2014,2017,Winthrop,Big South,129,2106,208,455,193,400,15,55,161,237,95,313,408,165,95,36,144,199,592
6307,Cameron Delaney,2018,2019,Sam Houston State,Southland,68,1582,192,458,90,189,102,269,106,129,69,220,289,98,50,21,79,126,592
6308,Micheal Eric,2009,2012,Temple,A-10,99,1670,258,512,258,512,0,0,76,140,153,304,457,64,27,109,114,192,592
6309,Nick Gore,2010,2013,Virginia Military Institute,Big South,119,2068,215,514,145,254,70,260,92,151,105,249,354,163,88,21,114,214,592
6310,Paul Kirkpatrick,2008,2010,Howard,MEAC,93,2238,228,411,228,411,0,0,136,272,164,260,424,59,29,77,178,226,592
6311,Peter Kiss,2017,2019,Total,Total,61,1468,220,549,155,323,65,226,87,124,56,185,241,114,50,9,118,95,592
6312,Kristijan Krajina,2010,2015,Mount St. Mary's,NEC,115,2035,251,503,239,434,12,69,78,141,158,248,406,56,46,40,160,287,592
6313,Chip Rank,2011,2014,Northern Iowa,MVC,135,2233,200,503,89,167,111,336,81,110,109,228,337,53,34,8,53,189,592
6314,Travis Robinson,2011,2014,Boston University,Total,125,2269,202,520,80,176,122,344,66,102,68,204,272,91,91,22,107,238,592
6315,Austin Stewart,2013,2016,Central Michigan,MAC,122,1857,204,411,167,300,37,111,147,200,141,228,369,54,92,6,105,174,592
6316,Kareem Storey,2012,2015,Total,Total,94,2636,178,479,128,305,50,174,186,252,46,168,214,399,106,2,268,225,592
6317,Idris Taqqee,2015,2018,St. Bonaventure,A-10,124,3073,227,534,192,407,35,127,103,166,199,311,510,158,115,56,94,290,592
6318,Brandon Bryant,2009,2010,Florida A&M,MEAC,62,816,192,537,100,239,92,298,115,155,20,87,107,69,46,2,107,90,591
6319,T.J. Buchanan,2012,2015,Rhode Island,A-10,123,2679,192,433,171,360,21,73,186,288,109,238,347,233,97,22,149,240,591
6320,Jesus Cruz,2018,2019,Fairfield,MAAC,64,1689,233,527,191,376,42,151,83,124,74,202,276,87,77,11,99,162,591
6321,Cliff Ederain,2011,2012,Eastern Washington,Big Sky,62,1766,221,459,218,446,3,13,146,270,162,296,458,131,72,75,173,189,591
6322,Markus Golder,2018,2019,Valparaiso,MVC,63,1501,214,465,156,304,58,161,105,133,66,189,255,69,51,23,85,125,591
6323,Matt Griffin,2008,2012,Total,Total,133,2684,175,481,40,118,135,363,106,125,72,228,300,208,75,4,126,219,591
6324,R.J. Griffin,2010,2012,Dartmouth,Ivy,83,1907,192,520,105,272,87,248,120,155,24,154,178,68,59,8,114,154,591
6325,Tra'von Joseph,2014,2017,Northwestern State,Southland,113,2124,219,446,192,357,27,89,126,180,142,294,436,115,62,29,127,259,591
6326,K.J. Lawson,2016,2019,Total,Total,77,1622,210,520,173,400,37,120,134,193,103,261,364,117,30,20,107,143,591
6327,Antonio Lofton,2010,2011,Chicago State,GWC,62,1725,160,411,144,353,16,58,255,359,84,169,253,88,59,8,187,186,591
6328,Solomon Poole,2013,2016,Total,Total,85,1608,220,622,123,309,97,313,54,90,31,126,157,140,48,8,184,157,591
6329,Mike Rostampour,2014,2015,Omaha,Summit,61,1371,193,391,173,340,20,51,185,268,176,285,461,26,51,23,87,228,591
6330,Henry Sims,2009,2012,Georgetown,Big East,121,1822,214,447,212,430,2,17,161,246,113,272,385,167,41,94,158,210,591
6331,Zac Tillman,2014,2018,Monmouth,MAAC,129,1858,228,452,228,452,0,0,135,203,112,224,336,52,47,44,97,302,591
6332,Zavion Williams,2012,2015,Total,Total,79,1565,207,522,167,367,40,155,137,191,44,138,182,185,92,6,175,165,591
6333,Corey Baldwin,2016,2017,North Dakota,Big Sky,65,1619,198,469,72,152,126,317,68,111,37,198,235,78,70,10,78,137,590
6334,Cameron Black,2011,2014,Bowling Green State,MAC,127,2690,266,516,266,516,0,0,58,121,185,438,623,86,74,154,118,290,590
6335,Jackson Donahue,2016,2019,Pennsylvania,Ivy,104,1657,195,535,45,98,150,437,50,84,33,97,130,100,36,1,65,117,590
6336,Nate Fowler,2016,2019,Butler,Big East,122,1748,235,417,200,322,35,95,85,115,156,172,328,73,35,29,83,251,590
6337,Zach Hahn,2008,2011,Butler,Horizon,139,1974,193,514,39,107,154,407,50,58,14,123,137,127,39,0,104,122,590
6338,Kendrick Hogans,2008,2012,North Texas,Sun Belt,120,2111,239,445,239,443,0,2,112,226,191,218,409,40,40,92,104,283,590
6339,James Hollowell,2009,2012,Eastern Illinois,OVC,82,1665,234,525,222,489,12,36,110,156,136,262,398,90,61,86,112,157,590
6340,Nehemias Morillo,2015,2016,South Florida,AAC,63,1744,215,559,144,328,71,231,89,117,45,158,203,106,45,16,132,133,590
6341,Menji Mundadi,2009,2010,Alabama State,SWAC,62,1314,185,464,67,146,118,318,102,141,43,136,179,37,38,5,67,62,590
6342,Tommy Spagnolo,2011,2015,Total,Total,86,1813,239,447,233,430,6,17,106,171,135,350,485,66,35,45,130,209,590
6343,Kasheem Thomas,2017,2019,Cleveland State,Horizon,94,2262,187,502,117,282,70,220,146,203,25,206,231,261,56,1,141,167,590
6344,Mike Walker,2008,2011,Southern Methodist,CUSA,120,2391,182,506,51,132,131,374,95,121,24,112,136,143,63,5,122,208,590
6345,Jamari Bradshaw,2013,2014,Florida A&M,MEAC,63,1231,216,509,150,316,66,193,91,164,72,152,224,66,83,4,101,127,589
6346,Fred Chatmon,2010,2014,Missouri-Kansas City,Total,110,1911,246,470,244,440,2,30,95,208,182,346,528,21,48,67,134,224,589
6347,Derek Cooke,2013,2015,Wyoming,MWC,102,2109,244,378,243,375,1,3,100,215,156,369,525,73,59,70,96,188,589
6348,Jordan Henriquez,2010,2013,Kansas State,Big 12,126,1906,227,454,227,454,0,0,135,270,228,334,562,55,25,210,108,282,589
6349,Dontel Highsmith,2014,2019,Total,Total,101,2021,201,467,151,301,50,166,137,189,71,149,220,125,75,11,106,155,589
6350,Deckie Johnson,2016,2017,North Texas,CUSA,48,1365,180,484,91,198,89,286,140,173,56,124,180,95,39,9,80,118,589
6351,Sean Kowal,2009,2010,Northern Illinois,MAC,59,1515,242,443,241,442,1,1,104,200,126,217,343,41,32,47,76,134,589
6352,Ben McLemore,2013,2013,Kansas,Big 12,37,1191,198,400,125,226,73,174,120,138,47,145,192,73,37,25,77,69,589
6353,Mastadi Pitt,2018,2019,Norfolk State,MEAC,64,1481,196,498,123,284,73,214,124,164,24,111,135,162,28,0,99,114,589
6354,Mason Riggins,2016,2019,Long Beach State,Big West,132,2362,241,416,241,416,0,0,107,251,178,291,469,67,55,78,87,247,589
6355,Adonis Thomas,2012,2013,Memphis,CUSA,55,1511,223,523,182,397,41,126,102,137,69,153,222,84,35,39,82,76,589
6356,Dustin Thomas,2014,2018,Total,Total,129,2210,215,463,201,404,14,59,145,227,135,273,408,112,62,24,148,337,589
6357,Isaac Thornton,2014,2017,San Jose State,MWC,121,2629,185,520,132,336,53,184,166,239,64,287,351,250,144,66,210,324,589
6358,Preston Brown,2009,2010,Sam Houston State,Southland,62,1352,207,459,153,321,54,138,120,182,101,215,316,62,23,50,77,211,588
6359,Justin Browning,2013,2016,Western Carolina,Southern,98,2237,212,398,183,301,29,97,135,202,135,271,406,122,149,88,133,307,588
6360,David Devezin,2008,2009,Marist,MAAC,59,1880,228,476,207,398,21,78,111,183,21,125,146,247,49,6,138,101,588
6361,Ronnie Dixon,2008,2011,Dartmouth,Ivy,94,1765,220,528,158,345,62,183,86,113,32,168,200,123,49,12,128,180,588
6362,Terry Evans,2008,2009,Green Bay,Horizon,61,1950,222,480,201,406,21,74,123,207,100,265,365,153,126,53,159,144,588
6363,Geoff McDermott,2008,2009,Providence,Big East,64,2060,212,458,196,392,16,66,148,273,148,381,529,249,98,75,207,184,588
6364,Federico Mussini,2016,2017,St. John's (NY),Big East,62,1514,180,492,68,177,112,315,116,135,20,110,130,96,55,2,102,78,588
6365,Babatunde Olomuwiya,2011,2014,South Carolina Upstate,A-Sun,119,2068,236,423,235,418,1,5,115,222,168,241,409,75,37,147,140,198,588
6366,Jarrid Rhodes,2017,2018,Missouri State,MVC,66,1740,209,487,106,226,103,261,67,81,68,181,249,68,28,14,75,120,588
6367,Sam Sessoms,2019,2019,Binghamton,AEC,33,1132,224,500,154,309,70,191,70,106,24,85,109,115,37,2,142,71,588
6368,Donte Williams,2011,2014,Georgia,SEC,125,2409,225,476,224,474,1,2,137,243,214,300,514,44,30,136,86,333,588
6369,Ruben Cabrera,2011,2013,Texas-Rio Grande Valley,GWC,94,1524,212,468,168,343,44,125,119,187,85,222,307,39,11,9,130,200,587
6370,Micah Downs,2008,2009,Gonzaga,WCC,67,1650,199,449,113,227,86,222,103,130,78,200,278,85,59,26,74,120,587
6371,Gavin Edwards,2008,2010,Connecticut,Big East,101,1695,216,363,216,362,0,1,155,201,156,223,379,45,49,108,102,185,587
6372,Bo Hodges,2018,2019,East Tennessee State,Southern,61,1425,227,459,206,391,21,68,112,182,81,157,238,103,58,44,84,138,587
6373,Tavarius Shine,2015,2018,Oklahoma State,Big 12,94,1888,191,489,98,194,93,295,112,154,77,175,252,82,72,42,87,200,587
6374,Milton Chavis,2012,2013,Morehead State,OVC,62,1288,235,480,200,380,35,100,81,124,99,149,248,42,67,26,113,138,586
6375,Dallas Ennema,2014,2017,Albany (NY),AEC,122,2078,195,469,79,163,116,306,80,116,52,230,282,69,34,28,66,174,586
6376,Delwan Graham,2009,2012,Total,Total,85,1563,208,461,206,451,2,10,168,247,158,267,425,92,69,57,151,186,586
6377,Christian Hairston,2014,2017,Elon,Total,123,1785,240,422,239,414,1,8,105,176,123,318,441,75,45,22,126,210,586
6378,Drew Housman,2008,2009,Harvard,Ivy,58,1562,165,410,110,268,55,142,201,241,23,122,145,161,72,0,137,83,586
6379,Cedric Jenkins,2011,2015,Total,Total,100,1576,213,538,132,263,81,275,79,113,71,136,207,96,76,13,102,113,586
6380,Justin Knox,2008,2011,Total,Total,120,1958,211,450,210,448,1,2,163,233,160,275,435,52,33,55,118,240,586
6381,Meiko Lyles,2011,2014,Columbia,Ivy,77,1950,201,467,86,189,115,278,69,94,45,200,245,44,62,12,74,119,586
6382,Will Magarity,2014,2018,Total,Total,113,2013,228,468,172,282,56,186,74,108,121,264,385,72,38,78,112,257,586
6383,Robert Martin,2017,2019,Rice,CUSA,80,1510,181,404,121,246,60,158,164,235,69,237,306,83,47,12,107,150,586
6384,Sirlester Martin,2009,2010,Youngstown State,Horizon,60,1614,244,558,222,472,22,86,76,121,119,254,373,55,35,31,91,120,586
6385,Woody Payne,2008,2010,Detroit Mercy,Horizon,88,2514,209,469,188,404,21,65,147,233,49,238,287,297,187,18,212,185,586
6386,Geddes Robinson,2011,2012,Utah Valley,GWC,63,1875,221,398,221,397,0,1,144,250,244,382,626,91,42,18,131,124,586
6387,Max Rothschild,2016,2019,Pennsylvania,Ivy,112,1948,230,445,229,437,1,8,125,203,133,313,446,168,63,23,194,240,586
6388,Tim Burns,2008,2011,Total,Total,86,2010,218,516,167,348,51,168,98,126,46,108,154,130,59,3,124,97,585
6389,Larry Davis,2008,2011,Total,Total,79,1753,205,571,142,380,63,191,112,161,75,158,233,116,70,18,94,123,585
6390,Landon Drew,2013,2016,Cal State Northridge,Big West,111,2525,208,545,118,296,90,249,79,109,27,162,189,393,69,11,193,245,585
6391,Grantham Gillard,2018,2019,Arkansas State,Sun Belt,62,1597,189,471,72,138,117,333,90,131,58,236,294,54,55,9,66,138,585
6392,Adonys Henriquez,2015,2016,Central Florida,AAC,56,1874,193,469,79,167,114,302,85,116,41,138,179,115,34,9,74,53,585
6393,Ray Jones ,2011,2012,Southern Utah,Summit,61,1967,192,393,165,310,27,83,174,233,38,179,217,259,77,17,168,174,585
6394,Brendan Lane,2010,2014,Total,Total,109,1781,241,447,221,386,20,61,83,145,124,271,395,65,30,109,97,201,585
6395,Travis McConico,2018,2019,Charleston Southern,Big South,64,1718,206,489,103,207,103,282,70,104,99,223,322,118,78,31,87,120,585
6396,Jules Montgomery,2012,2014,Prairie View,SWAC,98,2128,248,623,227,540,21,83,68,119,223,316,539,69,77,83,99,225,585
6397,Darious Moten,2012,2015,Mercer,Total,122,1528,208,417,181,346,27,71,142,201,107,126,233,75,31,46,75,109,585
6398,Josh Sharma,2016,2019,Stanford,Pac-12,121,1630,243,432,232,388,11,44,88,147,146,281,427,20,34,126,88,295,585
6399,Quincy Smith,2014,2016,Hawaii,Big West,100,2013,202,461,174,362,28,99,153,281,59,179,238,199,126,10,135,200,585
6400,David Syfax,2017,2019,Morgan State,MEAC,87,1778,204,540,170,414,34,126,143,226,138,231,369,67,57,53,119,235,585
6401,Kyle Toth,2013,2017,Total,Total,71,1753,207,492,69,154,138,338,33,51,24,172,196,53,28,4,34,79,585
6402,Kevin Bell,2008,2008,Fresno State,WAC,32,1199,202,460,170,378,32,82,148,212,13,91,104,187,39,2,106,58,584
6403,Justin Carter,2009,2010,Creighton,MVC,66,1608,197,440,162,325,35,115,155,231,119,273,392,124,60,25,118,126,584
6404,Jamont Gordon,2008,2008,Mississippi State,SEC,34,1178,193,465,133,277,60,188,138,199,40,184,224,168,38,21,138,88,584
6405,Anthony Hill,2009,2013,Total,Total,116,2622,188,587,63,199,125,388,83,114,49,175,224,196,70,3,140,187,584
6406,P.J. Horgan,2012,2015,Citadel,Southern,66,1665,219,396,217,394,2,2,144,207,117,228,345,50,41,40,107,122,584
6407,Josh James,2014,2017,Monmouth,MAAC,111,2691,215,550,185,435,30,115,124,215,85,260,345,212,78,8,150,214,584
6408,Ryan Mikesell,2016,2019,Dayton,A-10,87,1830,207,425,137,217,70,208,100,137,87,245,332,122,48,42,92,165,584
6409,Rory Spencer,2010,2011,Georgia Southern,Southern,61,1427,195,394,195,394,0,0,194,303,95,198,293,45,39,97,130,204,584
6410,Jeremiah Tilmon,2018,2019,Missouri,SEC,64,1388,241,435,241,434,0,1,102,167,138,183,321,35,25,58,139,232,584
6411,Phlandrous Fleming Jr.,2018,2019,Charleston Southern,Big South,51,1433,203,495,127,263,76,232,101,133,76,158,234,107,64,25,88,95,583
6412,Carlton Hurst,2014,2018,Total,Total,117,2240,194,385,168,318,26,67,169,241,124,254,378,83,57,36,84,180,583
6413,Alex Len,2012,2013,Maryland,ACC,60,1470,225,418,224,409,1,9,132,199,145,272,417,50,12,125,93,155,583
6414,Adam Link,2013,2014,Western Illinois,Summit,61,1883,218,400,217,394,1,6,146,219,87,181,268,95,49,32,103,110,583
6415,Josh Wilson,2008,2009,Northern Arizona,Big Sky,55,1650,200,431,137,266,63,165,120,173,24,121,145,260,45,1,161,114,583
6416,Josh Anderson,2018,2019,Western Kentucky,CUSA,57,1405,215,436,199,377,16,59,136,204,58,141,199,76,82,31,93,143,582
6417,Dwayne Benjamin,2015,2016,Oregon,Pac-12,72,1615,213,502,132,258,81,244,75,127,78,231,309,68,69,25,65,131,582
6418,Michael Craig,2013,2014,Southern Mississippi,CUSA,57,1277,230,388,229,381,1,7,121,180,127,241,368,128,77,15,124,171,582
6419,Andre Hardy,2008,2012,Total,Total,83,1645,207,455,207,455,0,0,168,273,172,295,467,47,37,6,125,194,582
6420,Kinnon LaRose,2016,2019,Total,Total,92,1743,209,456,99,155,110,301,54,71,95,190,285,57,36,21,58,158,582
6421,Desmond Simmons,2012,2015,Total,Total,122,2757,197,499,154,363,43,136,145,208,251,437,688,116,100,26,116,277,582
6422,RJ Slawson,2011,2014,Total,Total,121,2018,208,463,179,357,29,106,137,200,209,263,472,51,76,88,128,334,582
6423,Andre Smith,2008,2009,George Mason,CAA,67,1796,205,552,96,215,109,337,63,87,39,121,160,78,51,8,59,151,582
6424,Manny Ubilla,2008,2008,Fairleigh Dickinson,NEC,28,1074,178,409,85,192,93,217,133,163,17,118,135,136,41,9,105,62,582
6425,Amos Wilson,2013,2014,Lamar,Southland,57,1574,228,507,228,504,0,3,126,165,102,187,289,46,53,31,115,183,582
6426,Jamar Briscoe,2011,2012,Charlotte,A-10,59,1582,192,509,113,277,79,232,118,156,24,151,175,121,70,0,120,113,581
6427,Allan Chaney,2009,2014,Total,Total,58,1135,221,425,211,378,10,47,129,164,105,228,333,54,32,43,83,126,581
6428,Ahmed Hamdy Mohamed,2016,2018,Total,Total,102,1292,218,443,218,442,0,1,145,239,134,210,344,21,28,47,99,222,581
6429,Jovaughn Love,2015,2016,Arkansas-Pine Bluff,SWAC,59,1603,205,570,161,411,44,159,127,193,70,201,271,60,36,41,100,126,581
6430,Tramayne Moorer,2009,2011,Alabama State,SWAC,48,1149,191,397,179,356,12,41,187,264,106,198,304,30,45,22,89,109,581
6431,Atif Russell,2013,2017,Total,Total,118,1804,211,484,169,344,42,140,117,180,90,198,288,93,58,12,110,189,581
6432,Marvin Baynham,2011,2014,Georgia Southern,Southern,129,2611,221,396,221,396,0,0,138,249,214,340,554,49,70,33,173,389,580
6433,Michael Flowers,2018,2019,Western Michigan,MAC,55,1202,174,440,97,219,77,221,155,201,15,133,148,115,33,4,112,94,580
6434,Tyrn Flowers,2017,2019,Total,Total,65,1460,216,490,108,189,108,301,40,59,69,227,296,88,48,59,71,119,580
6435,Lionheart Leslie,2016,2017,Cal State Fullerton,Big West,61,1554,192,424,159,296,33,128,163,224,58,165,223,128,84,5,100,177,580
6436,Marcus LoVett,2017,2018,St. John's (NY),Big East,37,1177,205,451,140,281,65,170,105,132,20,83,103,125,55,1,92,77,580
6437,Dennis Smith Jr.,2017,2017,North Carolina State,ACC,32,1114,191,420,136,267,55,153,143,200,26,120,146,197,62,14,108,67,580
6438,Steven Thornton,2012,2015,Total,Total,69,1864,183,452,105,219,78,233,136,182,56,130,186,63,63,20,78,206,580
6439,Jonathan Toles,2008,2009,Jacksonville State,OVC,55,1710,161,419,89,247,72,172,186,260,30,126,156,202,64,3,133,162,580
6440,Michael Zangari,2013,2016,East Carolina,Total,123,2045,211,465,196,394,15,71,143,212,176,245,421,51,27,40,99,260,580
6441,E.J. Anosike,2018,2019,Sacred Heart,NEC,62,1342,198,411,179,353,19,58,164,221,148,226,374,41,25,30,83,130,579
6442,Nick Cook,2011,2014,Jacksonville State,OVC,118,2396,219,448,219,445,0,3,141,294,212,303,515,111,77,133,130,277,579
6443,Cruz Daniels,2008,2010,High Point,Big South,89,2093,242,415,242,414,0,1,95,137,248,317,565,53,30,232,128,261,579
6444,Jacob Davison,2018,2019,Eastern Washington,Big Sky,57,1182,200,433,142,274,58,159,121,147,34,128,162,61,52,24,82,120,579
6445,Arnold Fripp,2014,2015,Coppin State,MEAC,62,1443,214,505,142,312,72,193,79,112,83,209,292,30,25,44,66,144,579
6446,Markelle Fultz,2017,2017,Washington,Pac-12,25,892,209,439,157,313,52,126,109,168,33,110,143,148,40,30,80,63,579
6447,Ryon Howard,2008,2009,Sacred Heart,NEC,63,1716,233,455,207,372,26,83,87,123,120,258,378,111,57,29,99,167,579
6448,Joe Hugley,2018,2019,Central Connecticut State,NEC,54,1093,174,406,99,200,75,206,156,190,70,172,242,15,22,31,81,143,579
6449,Tim Johnson,2010,2014,Total,Total,105,1612,214,524,159,331,55,193,96,135,75,127,202,99,56,27,125,142,579
6450,Chazz Patterson,2013,2017,Saint Peter's,MAAC,127,2898,177,514,75,191,102,323,123,166,37,324,361,152,142,37,151,181,579
6451,Thomas Sanders,2008,2008,Gardner-Webb,A-Sun,32,1039,211,443,203,405,8,38,149,235,104,242,346,104,43,6,112,99,579
6452,Rodney Simeon,2015,2018,Total,Total,74,1443,187,562,62,165,125,397,80,108,58,144,202,38,29,15,106,137,579
6453,Ian Theisen,2015,2018,South Dakota State,Summit,128,1842,197,374,146,248,51,126,134,180,114,252,366,61,27,45,87,285,579
6454,Steven Wronkoski,2013,2016,Louisiana,Sun Belt,136,2448,186,469,89,188,97,281,110,147,82,200,282,86,46,4,137,198,579
6455,Jay Canty,2011,2014,Total,Total,57,1337,212,468,192,387,20,81,134,193,78,161,239,109,47,20,106,85,578
6456,Renaldo Dixon,2011,2014,New Mexico State,WAC,106,1835,202,394,192,361,10,33,164,215,144,257,401,62,35,91,106,160,578
6457,Ty Gibson,2016,2019,Eastern Washington,Big Sky,129,2340,180,459,27,60,153,399,65,83,26,193,219,104,56,4,56,166,578
6458,Stephan Holm,2014,2016,Montana State,Big Sky,80,1465,205,486,81,165,124,321,44,59,23,127,150,33,31,4,74,76,578
6459,Jordan Hunter,2016,2019,Total,Total,88,1609,186,455,106,240,80,215,126,151,18,136,154,218,72,7,133,140,578
6460,Junior Lomomba,2013,2017,Total,Total,123,2582,179,504,133,360,46,144,174,256,67,191,258,221,61,4,188,203,578
6461,Michael McConathy,2008,2010,Northwestern State,Southland,93,2067,157,495,78,254,79,241,185,227,28,82,110,335,127,1,291,287,578
6462,Jeremy Mixon,2009,2011,Purdue-Fort Wayne,Summit,82,1292,202,497,149,359,53,138,121,158,37,104,141,98,37,15,96,112,578
6463,Dale Moss,2009,2011,South Dakota State,Summit,93,1943,206,405,189,354,17,51,149,227,149,222,371,101,46,45,101,179,578
6464,David Robinson,2011,2013,Longwood,Total,87,1800,178,465,87,201,91,264,131,160,30,99,129,88,37,1,93,176,578
6465,Timmy Rose,2016,2019,Binghamton,AEC,124,2410,210,480,149,320,61,160,97,158,30,174,204,313,71,4,174,141,578
6466,Horace Spencer,2016,2019,Auburn,SEC,123,2070,223,470,220,448,3,22,129,225,216,328,544,67,101,170,135,378,578
6467,Josh Warren,2017,2019,Cornell,Ivy,88,1740,228,452,205,383,23,69,99,148,85,240,325,164,28,40,155,202,578
6468,Terrell Bell,2008,2011,Virginia Tech,ACC,133,2686,207,481,144,290,63,191,100,165,161,357,518,180,76,80,137,230,577
6469,Michael Buckland,2017,2019,Lipscomb,A-Sun,98,2455,187,462,88,184,99,278,104,137,41,273,314,227,70,50,142,211,577
6470,Ousmane Cisse,2008,2010,Eastern Illinois,OVC,90,2160,238,425,238,425,0,0,101,178,215,382,597,90,59,49,146,253,577
6471,Phillip Crawford,2012,2013,Alabama State,SWAC,49,1120,233,448,232,443,1,5,110,176,122,170,292,25,32,32,93,153,577
6472,Cory Dixon,2013,2014,New Orleans,Total,52,1253,187,371,186,370,1,1,202,290,114,219,333,56,42,50,147,137,577
6473,Parker Ernsthausen,2016,2019,Wright State,Horizon,133,2523,193,413,158,290,35,123,156,223,132,179,311,163,68,33,135,261,577
6474,Darren Goodson,2013,2014,Kent State,MAC,66,1381,216,518,173,374,43,144,102,163,79,178,257,126,26,4,111,190,577
6475,Davonta Jordan,2017,2019,Buffalo,MAC,103,2312,242,529,191,358,51,171,42,115,51,224,275,354,115,33,217,261,577
6476,Wayne Sparrow,2012,2015,Total,Total,109,1990,208,565,136,323,72,242,89,158,60,194,254,135,99,28,139,213,577
6477,Art Steward,2011,2012,Montana,Big Sky,64,1744,212,414,189,357,23,57,130,193,104,160,264,81,58,28,88,169,577
6478,Deon Tresvant,2008,2009,Cal State Northridge,Big West,42,1130,208,476,91,182,117,294,44,57,14,64,78,78,50,3,96,69,577
6479,Tommie Tyler,2009,2012,Western Illinois,Summit,100,2534,195,516,165,414,30,102,157,264,64,170,234,140,50,15,166,204,577
6480,Brent Wrapp,2015,2018,Cal State Bakersfield,WAC,129,3250,166,422,133,299,33,123,212,304,94,389,483,520,134,24,203,322,577
6481,Anell Alexis,2011,2014,Total,Total,106,1643,192,438,147,309,45,129,147,186,116,213,329,53,41,33,116,176,576
6482,Garrett Covington,2018,2019,Youngstown State,Horizon,62,1573,212,490,158,332,54,158,98,141,91,138,229,65,67,9,79,132,576
6483,Kevin Holland,2015,2019,Southern Mississippi,CUSA,127,3326,200,531,63,173,137,358,39,55,26,229,255,197,88,10,106,195,576
6484,Barry Honore',2008,2012,Total,Total,104,1774,230,518,198,435,32,83,84,134,114,218,332,32,30,49,134,122,576
6485,Mareik Isom,2014,2017,Total,Total,110,1619,187,456,86,188,101,268,101,137,71,195,266,33,33,36,53,249,576
6486,Marvin Jefferson,2009,2010,Idaho,WAC,63,1490,234,421,234,421,0,0,108,195,139,197,336,33,37,122,104,202,576
6487,Kevin Knox,2018,2018,Kentucky,SEC,37,1198,196,440,139,273,57,167,127,164,33,167,200,53,31,10,85,82,576
6488,DeAndre Liggins,2009,2011,Kentucky,SEC,100,2192,194,477,132,290,62,187,126,196,46,250,296,212,90,50,147,190,576
6489,Lauri Markkanen,2017,2017,Arizona,Pac-12,37,1140,185,376,116,213,69,163,137,164,88,178,266,32,15,19,40,73,576
6490,Stephen Nwaukoni,2011,2014,Hofstra,CAA,119,2284,186,409,186,409,0,0,204,314,294,459,753,35,36,38,140,276,576
6491,David Pellom,2010,2012,George Washington,A-10,88,1953,241,399,236,371,5,28,89,176,142,283,425,85,65,45,111,186,576
6492,Titus Shelton,2008,2009,Cal Poly,Big West,58,1693,221,421,221,420,0,1,134,199,109,175,284,96,43,79,130,180,576
6493,Aaron Wheeler,2015,2016,Charleston Southern,Big South,61,1748,233,474,220,412,13,62,97,184,126,210,336,129,60,42,101,132,576
6494,Kendal Yancy,2014,2017,Texas,Big 12,127,1996,204,484,145,310,59,174,109,174,96,191,287,118,55,13,86,148,576
6495,Bo Barnes,2011,2015,Total,Total,118,1841,182,461,54,122,128,339,83,112,54,138,192,64,52,10,67,149,575
6496,Horace Bond,2008,2011,Texas A&M-Corpus Christi,Southland,124,2949,214,433,194,358,20,75,127,244,202,258,460,100,67,31,166,296,575
6497,DeMarcus Cousins,2010,2010,Kentucky,SEC,38,893,206,369,205,363,1,6,162,268,154,220,374,38,37,67,78,122,575
6498,Ahmad Frost,2016,2019,Maryland-Eastern Shore,MEAC,84,2053,205,566,103,251,102,315,63,99,52,154,206,146,63,1,129,189,575
6499,Andrew Gabriel,2008,2011,Manhattan,MAAC,122,2603,233,572,233,570,0,2,109,231,191,272,463,99,78,78,206,324,575
6500,Genesis Maciel,2009,2012,Hartford,AEC,91,1728,209,539,113,267,96,272,61,86,45,161,206,83,28,18,112,172,575
6501,JayQuan McCloud,2016,2019,Total,Horizon,53,1204,194,446,110,228,84,218,103,125,34,92,126,96,33,17,75,98,575
6502,Brandon McThay,2008,2009,Lamar,Southland,59,1502,175,419,90,198,85,221,140,176,31,93,124,128,62,1,112,107,575
6503,Kanayo Obi-Rapu,2015,2018,Total,Total,89,1703,193,491,80,176,113,315,76,104,33,158,191,87,47,9,103,181,575
6504,Amin Torres,2013,2015,Nicholls State,Southland,78,1222,191,476,109,239,82,237,111,142,13,78,91,89,59,4,122,134,575
6505,D.J. White,2008,2008,Indiana,Big Ten,33,1105,216,357,215,354,1,3,142,206,100,241,341,25,26,54,63,83,575
6506,Omer Yurtseven,2017,2018,North Carolina State,ACC,55,1202,240,443,217,396,23,47,72,112,121,197,318,41,20,76,66,161,575
6507,Mamadi Diakite,2017,2019,Virginia,ACC,102,1749,243,434,235,409,8,25,80,116,111,227,338,23,39,111,71,225,574
6508,Garrett Gilkeson,2017,2019,Virginia Military Institute,Southern,91,2105,195,508,119,273,76,235,108,137,100,269,369,152,95,10,117,170,574
6509,Dallas Lauderdale,2008,2011,Ohio State,Big Ten,138,2425,246,335,246,335,0,0,82,200,157,327,484,25,44,213,115,255,574
6510,James Legan,2008,2009,East Carolina,CUSA,60,1373,185,466,50,119,135,347,69,86,24,133,157,57,31,3,49,76,574
6511,Demetrius Monroe,2008,2010,Idaho State,Big Sky,83,1984,244,420,244,420,0,0,86,119,184,284,468,59,34,33,78,156,574
6512,Chad Posthumus,2013,2014,Morehead State,OVC,67,1480,214,427,214,427,0,0,146,249,245,350,595,20,42,55,98,188,574
6513,Zachary Simmons,2018,2019,North Texas,CUSA,70,1656,240,379,239,375,1,4,93,153,168,255,423,45,35,57,89,218,574
6514,Ahmad Walker,2014,2016,Stony Brook,AEC,67,1779,195,455,178,368,17,87,167,255,103,299,402,209,64,13,165,180,574
6515,Kenton Walker,2008,2012,Total,Total,131,1587,236,438,235,435,1,3,101,164,138,279,417,29,52,111,86,264,574
6516,Stephon Whyatt,2012,2015,Saint Francis (PA),NEC,103,2108,203,493,135,283,68,210,100,150,29,115,144,181,73,9,157,159,574
6517,Amorie Archibald,2018,2019,Louisiana Tech,CUSA,62,1649,194,491,119,270,75,221,110,156,45,164,209,219,49,13,115,105,573
6518,Justin Cecil,2011,2012,Mercer,A-Sun,68,1385,195,503,85,178,110,325,73,93,58,154,212,35,26,24,59,131,573
6519,Demarco Cox,2011,2015,Total,Total,133,2110,230,447,230,447,0,0,113,219,198,275,473,40,46,78,97,214,573
6520,Shyquan Gibbs,2017,2019,NJIT,A-Sun,95,2367,188,422,126,269,62,153,135,176,21,153,174,184,82,6,99,198,573
6521,Kevin Goffney,2008,2009,Chattanooga,Southern,58,1362,201,427,164,309,37,118,134,184,110,232,342,133,63,11,125,152,573
6522,Taylor Griffin,2008,2009,Oklahoma,Big 12,71,1849,199,406,188,370,11,36,164,225,138,243,381,78,76,61,104,184,573
6523,Khalid Lewis,2012,2016,Total,Total,125,2988,205,579,162,421,43,158,120,178,38,171,209,277,112,17,189,231,573
6524,Rod Mills,2015,2018,Miami (OH),MAC,114,2034,219,575,138,317,81,258,54,76,63,220,283,59,52,16,109,203,573
6525,Bryce Nze,2017,2018,Milwaukee,Horizon,68,1600,247,406,238,375,9,31,70,156,182,275,457,67,46,57,117,201,573
6526,Bola Olaniyan,2014,2017,Total,Total,123,2201,214,417,214,417,0,0,145,232,303,448,751,63,83,18,163,327,573
6527,A.J. Spencer,2014,2016,Long Beach State,Big West,67,1796,229,509,185,366,44,143,71,100,60,145,205,105,30,6,68,150,573
6528,Kevin Thomas,2014,2015,Troy,Sun Belt,59,1773,233,421,233,419,0,2,107,170,185,257,442,64,67,53,166,140,573
6529,James Young,2014,2014,Kentucky,SEC,40,1296,183,450,101,215,82,235,125,177,41,130,171,67,30,8,75,83,573
6530,Rashad Allison,2010,2011,Arkansas State,Sun Belt,63,1878,172,421,129,287,43,134,185,229,43,148,191,247,48,11,124,141,572
6531,Sean Cunningham,2008,2010,UC-Riverside,Big West,89,2388,192,539,134,364,58,175,130,202,37,225,262,239,95,21,190,185,572
6532,Jordan Davis,2018,2019,Dayton,A-10,64,1955,199,483,89,177,110,306,64,90,11,138,149,119,64,15,70,74,572
6533,Dre Evans,2013,2014,Southeastern Louisiana,Southland,61,1805,199,482,96,244,103,238,71,102,17,101,118,158,36,3,103,137,572
6534,Anthony Harris,2018,2019,Chicago State,WAC,58,1549,184,422,144,303,40,119,164,216,43,185,228,95,69,27,130,161,572
6535,Fabyon Harris,2013,2014,Texas A&M,SEC,62,1663,195,437,118,241,77,196,105,130,35,102,137,94,61,2,85,104,572
6536,Isaiah Ivey,2013,2016,Gardner-Webb,Big South,121,1889,183,485,99,246,84,239,122,152,62,184,246,85,48,30,66,124,572
6537,Josh Jackson,2017,2017,Kansas,Big 12,35,1077,220,429,186,339,34,90,98,173,81,177,258,104,59,37,97,104,572
6538,Diamante Lewis,2016,2017,Bethune-Cookman,MEAC,61,1572,214,549,166,407,48,142,96,148,93,180,273,186,66,6,122,153,572
6539,Shabazz Muhammad,2013,2013,UCLA,Pac-12,32,987,202,456,162,350,40,106,128,180,87,80,167,27,23,4,51,53,572
6540,Daniel Norl,2015,2018,Total,Total,71,1503,195,437,121,228,74,209,108,132,28,126,154,115,36,8,103,112,572
6541,Charlie Coley,2008,2009,Charlotte,A-10,65,1846,230,470,229,450,1,20,110,192,149,272,421,44,94,77,113,176,571
6542,Jake Eastman,2010,2013,Bradley,MVC,118,2846,199,536,132,292,67,244,106,157,95,311,406,208,84,19,110,186,571
6543,Adam Flagler,2019,2019,Presbyterian,Big South,36,1105,196,447,88,167,108,280,71,85,27,95,122,45,28,9,42,61,571
6544,Harrison Gaines,2008,2012,Total,Total,94,464,205,523,171,400,34,123,127,189,38,132,170,179,41,6,127,131,571
6545,Nick Havener,2015,2018,Boston University,Patriot,105,1709,242,451,239,438,3,13,84,140,154,339,493,107,81,80,137,280,571
6546,Austin Keel,2012,2015,Central Michigan,MAC,124,1687,199,522,116,217,83,305,90,123,64,140,204,71,52,5,84,95,571
6547,Jack Montague,2013,2016,Yale,Ivy,87,1864,187,463,47,141,140,322,57,80,29,108,137,170,62,1,135,115,571
6548,Gavin Montgomery,2008,2011,Arkansas-Pine Bluff,SWAC,101,1693,207,481,144,322,63,159,94,153,91,177,268,69,78,17,148,210,571
6549,Sean Sheldon,2013,2016,William & Mary,CAA,111,2039,235,378,235,378,0,0,101,173,143,247,390,150,23,41,96,205,571
6550,Ben Smith,2011,2012,Wichita State,MVC,70,1450,192,416,102,183,90,233,97,132,98,90,188,70,31,12,51,95,571
6551,Courtney Alexander II,2016,2019,Tennessee Tech,OVC,120,2433,204,455,204,453,0,2,162,329,202,496,698,163,88,75,229,274,570
6552,Deion Bute,2018,2019,Central Connecticut State,NEC,61,1452,216,361,216,361,0,0,138,192,150,187,337,34,25,77,138,201,570
6553,Sheldon Eberhardt,2016,2019,Elon,CAA,93,1760,213,483,147,257,66,226,78,110,49,187,236,214,47,21,139,144,570
6554,Amauri Hardy,2018,2019,Nevada-Las Vegas,MWC,64,1544,198,462,133,262,65,200,109,157,22,122,144,161,35,11,90,97,570
6555,Samajae Haynes-Jones,2018,2019,Wichita State,AAC,61,1458,209,568,131,321,78,247,74,94,22,112,134,129,29,2,78,94,570
6556,Donovan Kates,2012,2015,Manhattan,MAAC,131,2601,146,475,69,199,77,276,201,251,72,205,277,105,50,10,147,188,570
6557,Tommy Moffitt,2008,2010,Texas-Arlington,Southland,81,1744,227,479,186,361,41,118,75,117,147,332,479,68,52,16,91,197,570
6558,Chris Pelcher,2010,2014,Total,Total,99,1600,235,450,235,450,0,0,100,166,124,297,421,47,42,94,88,193,570
6559,Sacar Anim,2016,2019,Marquette,Big East,86,2053,221,482,184,374,37,108,90,153,69,145,214,100,50,7,92,172,569
6560,Bryan Bynes,2010,2013,George Washington,A-10,115,2406,184,561,128,363,56,198,145,200,64,176,240,182,86,8,127,187,569
6561,Jermaine Dixon,2009,2010,Pittsburgh,Big East,61,1600,210,509,164,333,46,176,103,151,41,151,192,128,80,38,73,128,569
6562,Joey Frenchwood,2015,2018,Total,Total,87,1965,196,525,100,230,96,295,81,121,20,137,157,287,110,13,179,181,569
6563,TJ Leaf,2017,2017,UCLA,Pac-12,35,1048,235,381,208,323,27,58,72,106,78,209,287,85,22,39,52,89,569
6564,Evan Taylor,2015,2018,Total,Total,95,2299,206,504,170,402,36,102,121,176,66,239,305,148,93,25,124,176,569
6565,Tra'Vaughn White,2014,2016,Total,Total,56,1353,194,516,129,316,65,200,116,148,23,106,129,104,37,1,69,98,569
6566,Jazz Williams,2008,2010,Southern,SWAC,83,1535,203,560,90,238,113,322,50,75,31,121,152,43,34,14,69,85,569
6567,Monty Boykins,2014,2018,Total,Total,104,1461,188,522,95,247,93,275,99,170,18,139,157,92,37,7,119,92,568
6568,Raymond Cintron,2012,2013,Middle Tennessee,Sun Belt,67,1473,175,394,37,77,138,317,80,92,16,102,118,84,33,7,79,106,568
6569,Nikola Gacesa,2008,2011,Total,Total,87,1919,200,484,159,373,41,111,127,156,93,203,296,44,37,24,92,135,568
6570,Justin Goldsborough,2013,2016,Lehigh,Patriot,125,2034,233,407,233,407,0,0,102,171,152,283,435,42,35,98,127,284,568
6571,Richard Hendrix,2008,2008,Alabama,SEC,32,980,229,383,227,376,2,7,108,201,118,206,324,51,41,62,55,94,568
6572,Shakur Juiston,2018,2019,Nevada-Las Vegas,MWC,41,1233,253,420,247,405,6,15,56,107,103,296,399,80,42,28,113,116,568
6573,Dane Kuiper,2016,2019,New Mexico,MWC,113,2181,195,522,102,219,93,303,85,106,42,233,275,152,84,28,87,219,568
6574,Haboubacar Mutombo,2015,2018,Western Carolina,Southern,95,1924,238,533,202,412,36,121,56,117,128,208,336,101,54,15,85,117,568
6575,Keith Pickens,2010,2014,Missouri State,MVC,111,2237,199,420,188,385,11,35,159,247,154,293,447,105,74,70,116,253,568
6576,Khaliq Spicer,2013,2016,Kent State,MAC,124,2120,227,398,227,398,0,0,114,224,202,354,556,33,33,158,80,217,568
6577,J.J. Thomas,2011,2014,Total,Total,77,1437,200,461,174,385,26,76,142,207,101,246,347,62,28,17,130,195,568
6578,Dockery Walker,2011,2015,Brown,Ivy,108,1493,234,459,233,454,1,5,99,202,137,313,450,35,35,33,114,270,568
6579,Johquin Wiley,2018,2019,Delaware State,MEAC,63,2213,205,594,112,285,93,309,65,101,25,140,165,226,112,2,162,96,568
6580,Brandon Brekke,2011,2013,North Dakota,Total,82,1466,229,370,229,370,0,0,109,188,121,264,385,33,21,45,111,212,567
6581,Amir Celestin,2009,2012,Campbell,Total,115,2229,203,499,166,388,37,111,124,187,29,132,161,250,91,10,185,265,567
6582,Justin Cerasoli,2008,2009,Loyola (IL),Horizon,54,1403,213,565,148,373,65,192,76,88,31,131,162,127,88,36,140,138,567
6583,Da'Quan Cook,2009,2012,St. Bonaventure,A-10,116,2270,181,412,181,412,0,0,205,294,143,234,377,81,44,23,160,269,567
6584,Anthony Davis,2012,2012,Kentucky,SEC,40,1281,210,337,207,317,3,20,144,203,119,296,415,50,54,186,41,78,567
6585,Savion Flagg,2018,2019,Texas A&M,SEC,62,1581,216,470,158,296,58,174,77,120,106,244,350,94,31,13,104,76,567
6586,Michael Hoffman,2014,2018,Total,Total,124,1743,213,469,138,275,75,194,66,87,95,216,311,59,47,63,64,247,567
6587,Isaac Johnson,2018,2019,Western Illinois,Summit,58,1381,219,518,188,411,31,107,98,126,34,248,282,59,44,5,99,113,567
6588,Cameron Naylor,2013,2016,Total,Total,82,1661,217,508,211,471,6,37,127,180,89,240,329,41,32,21,106,148,567
6589,Eddy Polanco,2017,2018,Southeastern Louisiana,Southland,65,1253,163,426,83,196,80,230,161,206,63,167,230,101,35,8,98,95,567
6590,Quinn Taylor,2017,2019,Saint Peter's,MAAC,100,2243,193,417,170,322,23,95,158,212,149,299,448,105,67,21,124,232,567
6591,Andell Cumberbatch,2014,2015,St. Bonaventure,A-10,62,1705,205,496,145,321,60,175,96,144,76,201,277,106,68,16,102,145,566
6592,Paul Delaney,2008,2009,Alabama-Birmingham,CUSA,37,1265,191,345,169,283,22,62,162,206,36,132,168,135,77,7,85,74,566
6593,Eric Robertson,2013,2016,South Dakota,Summit,116,1892,214,490,194,414,20,76,118,159,106,203,309,39,45,52,63,254,566
6594,Roburt Sallie,2009,2010,Memphis,CUSA,70,1597,177,410,58,138,119,272,93,131,52,141,193,90,85,30,54,139,566
6595,Donte Thomas,2016,2017,Arkansas State,Sun Belt,58,1731,172,425,156,359,16,66,206,320,44,250,294,323,59,14,165,152,566
6596,Rob Belcore,2009,2012,Pennsylvania,Ivy,108,2914,197,474,115,212,82,262,89,130,114,243,357,213,123,25,152,204,565
6597,Curtis Dennis,2010,2013,Total,Total,97,1424,198,483,110,201,88,282,81,107,58,120,178,68,60,12,64,105,565
6598,Chace Franklin,2016,2018,Jackson State,SWAC,48,1370,187,520,119,303,68,217,123,178,54,180,234,121,61,17,80,113,565
6599,Jamel Fuentes,2012,2015,Norfolk State,MEAC,133,3141,178,499,174,472,4,27,205,361,106,291,397,552,152,9,284,282,565
6600,Martinas Geben,2015,2018,Notre Dame,ACC,108,1554,216,355,215,352,1,3,132,160,162,292,454,76,36,53,99,172,565
6601,Matt Hunter,2013,2014,Central Connecticut State,NEC,40,1405,207,517,166,384,41,133,110,154,65,230,295,91,96,41,128,102,565
6602,Chris Jenkins,2014,2018,Total,Total,98,1714,192,534,28,70,164,464,17,28,11,91,102,45,33,6,48,100,565
6603,Alvin Mofunanya,2009,2010,Fairleigh Dickinson,NEC,56,1573,200,441,196,428,4,13,161,258,91,301,392,60,25,114,186,190,565
6604,Emmanuel Okoroba,2012,2015,Hampton,MEAC,111,1736,188,452,188,452,0,0,189,313,122,248,370,33,36,50,150,271,565
6605,Guilien Smith,2016,2019,Dartmouth,Ivy,75,1528,189,479,132,295,57,184,130,167,24,149,173,84,41,3,100,129,565
6606,Marshall Wood,2013,2017,Total,Total,112,1937,188,489,76,168,112,321,77,124,88,272,360,42,31,36,95,203,565
6607,Omondi Amoke,2009,2012,Total,Total,95,1675,209,418,209,410,0,8,146,263,184,309,493,54,31,40,95,193,564
6608,O'Darien Bassett,2008,2008,Troy,Sun Belt,31,954,186,452,120,259,66,193,126,154,33,87,120,73,40,3,64,53,564
6609,Anthony Bennett,2013,2013,Nevada-Las Vegas,MWC,35,950,202,379,166,283,36,96,124,177,86,199,285,34,24,43,65,80,564
6610,Terrell Brown,2017,2019,Total,Total,59,1369,160,405,77,196,83,209,161,210,27,104,131,87,37,2,86,106,564
6611,Will Bynum,2009,2010,Montana State,Big Sky,57,1691,205,454,197,415,8,39,146,234,39,178,217,129,112,22,123,120,564
6612,R.J. Hall,2009,2012,Marist,MAAC,92,1730,179,475,108,274,71,201,135,187,19,112,131,182,55,3,176,190,564
6613,Cameron Harvey,2013,2017,Total,Total,131,2150,198,568,84,237,114,331,54,76,24,116,140,62,20,3,80,124,564
6614,Madison Jones,2013,2017,Total,Total,129,2918,199,456,183,396,16,60,150,264,43,210,253,359,170,27,255,292,564
6615,Dwane Joshua,2009,2010,North Carolina A&T,MEAC,59,1267,181,478,86,203,95,275,107,156,53,139,192,58,57,2,125,132,564
6616,Matt McMullen,2012,2015,Colgate,Patriot,124,2169,193,448,117,257,76,191,102,134,96,347,443,134,50,43,115,178,564
6617,Bernard Morena,2014,2016,Kennesaw State,A-Sun,91,1705,209,463,188,401,21,62,125,208,108,243,351,76,45,65,161,268,564
6618,Anthony Perez,2013,2016,Mississippi,SEC,120,1860,175,456,100,232,75,224,139,204,121,217,338,68,54,37,111,217,564
6619,Jhamar Youngblood,2008,2011,Total,Total,66,1633,211,540,164,364,47,176,95,160,52,149,201,117,76,4,134,131,564
6620,Trae Berhow,2018,2019,Total,Total,64,1816,195,445,98,203,97,242,76,101,80,296,376,45,30,7,72,167,563
6621,Doug Brooks,2014,2017,Virginia Commonwealth,A-10,128,1889,179,529,71,186,108,343,97,142,48,225,273,139,170,14,93,302,563
6622,Jessie Burton,2008,2009,South Carolina State,MEAC,63,1784,178,455,86,211,92,244,115,143,13,99,112,180,62,5,164,144,563
6623,Brian Fobbs,2019,2019,Towson,CAA,32,1049,208,458,143,281,65,177,82,102,59,129,188,41,21,7,59,58,563
6624,Evan Hilton,2008,2010,Alabama A&M,SWAC,54,1430,178,493,130,328,48,165,159,264,91,144,235,71,55,1,115,135,563
6625,Dejon Jarreau,2017,2019,Total,Total,61,1294,197,433,163,310,34,123,135,202,22,203,225,240,47,37,164,141,563
6626,Chris Johnson,2012,2013,St. Bonaventure,A-10,59,1309,182,432,132,302,50,130,149,182,57,111,168,70,39,5,85,129,563
6627,Jake Kocher,2012,2017,Texas A&M-Corpus Christi,Southland,107,1977,214,460,159,273,55,187,80,119,72,174,246,101,127,7,86,166,563
6628,Brandon McKissic,2018,2019,Missouri-Kansas City,WAC,61,1627,211,462,156,316,55,146,86,143,35,148,183,109,67,8,87,177,563
6629,Nick Vier,2008,2010,Vermont,AEC,98,2302,167,423,90,209,77,214,152,211,41,186,227,276,90,2,208,233,563
6630,Chad Wynn,2008,2011,East Carolina,CUSA,109,1665,232,432,232,432,0,0,99,158,133,220,353,23,31,89,130,264,563
6631,Paul Atkinson,2018,2019,Yale,Ivy,61,1354,216,311,216,310,0,1,130,197,103,189,292,62,36,34,64,134,562
6632,Ed Davis,2009,2010,North Carolina,ACC,61,1357,210,383,210,383,0,0,142,228,149,321,470,44,24,129,86,116,562
6633,Bobby Hunter,2014,2015,Illinois State,MVC,64,1527,179,386,110,202,69,184,135,179,43,143,186,123,71,0,82,132,562
6634,Ben McCauley,2008,2009,North Carolina State,ACC,61,1568,210,421,210,421,0,0,142,197,116,233,349,105,43,27,100,115,562
6635,Lester Medford,2015,2016,Baylor,Big 12,68,2108,185,471,96,234,89,237,103,147,22,103,125,328,105,6,135,170,562
6636,Jarod Oldham,2011,2014,Buffalo,MAC,104,2558,182,497,140,329,42,168,156,234,58,274,332,409,136,35,235,209,562
6637,Greg Paulus,2008,2009,Duke,ACC,70,1521,174,429,54,123,120,306,94,120,20,99,119,157,78,3,84,137,562
6638,Bruce Price,2008,2008,Tennessee State,OVC,32,1089,160,395,106,229,54,166,188,268,29,122,151,160,71,2,128,96,562
6639,Jarrel Smith,2009,2010,Towson,CAA,59,1497,195,458,158,346,37,112,135,180,69,164,233,50,40,16,74,108,562
6640,Leo Vincent,2014,2017,Total,Total,71,1526,188,479,97,201,91,278,95,117,29,108,137,69,46,3,99,104,562
6641,Lebaron Weathers,2009,2010,Arkansas-Pine Bluff,SWAC,65,1368,217,550,172,387,45,163,83,129,108,291,399,32,17,68,95,166,562
6642,Coby White,2019,2019,North Carolina,ACC,35,999,188,444,106,211,82,233,104,130,12,112,124,143,38,11,94,68,562
6643,Taran Brown,2013,2014,UC-Santa Barbara,Big West,61,1721,203,524,107,217,96,307,59,81,80,217,297,105,41,56,97,149,561
6644,Kidani Brutus,2011,2012,Manhattan,MAAC,63,1823,186,466,60,152,126,314,63,81,48,123,171,134,61,10,130,181,561
6645,Rodney Chatman,2017,2018,Chattanooga,Southern,61,1593,182,428,130,266,52,162,145,191,15,174,189,204,60,16,155,162,561
6646,Muusa Dama,2017,2018,Eastern Illinois,OVC,59,1527,221,420,220,417,1,3,118,166,143,321,464,52,34,97,112,197,561
6647,Henry Ellenson,2016,2016,Marquette,Big East,33,1107,194,435,164,331,30,104,143,191,71,250,321,59,28,49,78,84,561
6648,D.J. Felder,2014,2015,Jacksonville State,OVC,61,1340,222,479,210,441,12,38,105,148,107,209,316,40,28,31,76,154,561
6649,Quinton Forrest,2016,2019,Total,Total,75,1547,236,444,211,352,25,92,64,121,117,148,265,68,71,9,84,112,561
6650,Hunter Harris,2013,2014,East Tennessee State,A-Sun,65,1688,206,403,201,376,5,27,144,231,145,206,351,35,61,69,84,212,561
6651,Troy Holston,2015,2019,Total,Total,82,1666,193,569,81,212,112,357,63,101,28,128,156,56,39,14,87,136,561
6652,Kyle Landry,2008,2008,Northern Arizona,Big Sky,32,815,189,323,189,323,0,0,183,259,89,169,258,28,32,27,49,86,561
6653,Sidy N'Dir,2017,2019,Total,Total,72,1737,185,434,125,237,60,197,131,184,49,135,184,123,49,34,99,126,561
6654,Jeff Newberry,2015,2016,Oklahoma State,Big 12,64,1641,183,463,123,281,60,182,135,165,59,165,224,93,78,28,71,129,561
6655,Lijah Thompson,2010,2012,Robert Morris,NEC,94,1512,204,398,204,398,0,0,153,206,172,149,321,37,47,62,87,218,561
6656,Robert Turner,2014,2015,Texas Tech,Big 12,64,1686,198,516,145,333,53,183,112,169,54,122,176,143,68,10,106,104,561
6657,Ronnie Boggs,2012,2013,Jacksonville State,OVC,61,1869,222,440,190,343,32,97,84,122,120,195,315,118,97,27,98,146,560
6658,Chris Bolden,2013,2015,Georgia Tech,ACC,86,1997,209,591,112,279,97,312,45,67,24,160,184,102,59,10,100,156,560
6659,Gary Clark,2008,2011,Wake Forest,ACC,109,1518,198,439,113,243,85,196,79,105,29,93,122,74,68,8,84,135,560
6660,Jeff Coby,2014,2017,Columbia,Ivy,108,1617,193,448,169,367,24,81,150,208,162,262,424,56,38,54,98,249,560
6661,T.J. Douglas,2008,2010,Elon,Southern,93,2063,191,476,34,64,157,412,21,26,53,195,248,69,52,17,49,209,560
6662,Zacarry Douglas,2015,2019,Total,Total,91,1792,208,463,160,313,48,150,96,142,126,371,497,77,44,38,96,166,560
6663,Kentan Facey,2014,2017,Connecticut,AAC,123,2173,222,431,219,425,3,6,113,162,217,348,565,46,24,87,99,255,560
6664,Rayshaun Hammonds,2018,2019,Georgia,SEC,61,1478,201,437,159,310,42,127,116,152,96,237,333,90,39,18,109,172,560
6665,Chris Hooper,2015,2016,St. Francis (NY),NEC,67,1182,217,391,217,389,0,2,126,219,127,182,309,74,52,58,117,179,560
6666,Chris Johnson,2008,2009,Louisiana State,SEC,60,1629,221,453,205,399,16,54,102,129,133,285,418,61,32,161,117,139,560
6667,Tarius Johnson,2013,2014,Eastern Kentucky,OVC,69,1646,193,414,138,267,55,147,119,183,96,175,271,79,47,7,76,203,560
6668,Branford Jones ,2013,2016,Long Beach State,Big West,100,1984,187,479,121,281,66,198,120,158,58,196,254,173,86,1,120,151,560
6669,Jerry Jones,2011,2014,Duquesne,A-10,112,1915,207,483,129,250,78,233,68,106,118,172,290,117,68,27,94,180,560
6670,Josiah Moore,2012,2016,Total,Total,82,1426,187,440,126,261,61,179,125,189,80,187,267,74,33,12,104,151,560
6671,Jareal Smith,2011,2012,Radford,Big South,60,1499,173,511,115,305,58,206,156,210,38,101,139,113,47,5,147,124,560
6672,Louis Adams,2017,2018,Wyoming,MWC,65,1099,166,363,130,262,36,101,191,262,31,139,170,79,35,16,103,146,559
6673,Ogo Adegboye,2010,2011,St. Bonaventure,A-10,62,1879,171,428,84,190,87,238,130,197,17,133,150,197,44,8,127,144,559
6674,Asenso Ampim,2008,2011,Columbia,Ivy,86,1648,211,531,203,495,8,36,129,201,144,297,441,63,60,33,142,184,559
6675,Tony Chennault,2011,2014,Total,Total,114,2315,197,532,176,442,21,90,144,219,48,195,243,230,87,3,184,264,559
6676,Shane Edwards,2008,2009,Little Rock,Sun Belt,62,1413,201,426,173,332,28,94,129,201,102,189,291,64,52,35,107,154,559
6677,Austin Kilpatrick,2008,2010,Idaho State,Big Sky,91,1885,181,549,38,127,143,422,54,79,39,190,229,127,55,64,113,217,559
6678,Chris Lofton,2008,2008,Tennessee,SEC,36,1071,170,426,52,119,118,307,101,120,27,88,115,64,48,3,49,56,559
6679,Brandon McCoy,2018,2018,Nevada-Las Vegas,MWC,33,949,208,382,205,373,3,9,140,193,103,238,341,17,15,60,87,87,559
6680,Dexter Moore,2009,2012,Coastal Carolina,Big South,119,1588,197,493,74,153,123,340,42,59,14,115,129,86,51,9,67,105,559
6681,Tom Pritchard,2009,2012,Indiana,Big Ten,130,2458,225,425,225,423,0,2,109,218,214,269,483,85,46,70,137,353,559
6682,Tony Wroten,2012,2012,Washington,Pac-12,35,1062,198,447,189,391,9,56,154,264,80,96,176,130,66,13,132,93,559
6683,Alade Aminu,2008,2009,Georgia Tech,ACC,63,1367,235,444,235,443,0,1,88,148,138,241,379,39,53,84,95,148,558
6684,Kaven Bernard,2015,2016,Jackson State,SWAC,68,1210,212,478,184,373,28,105,106,150,101,176,277,46,28,25,75,140,558
6685,Carlton Bragg Jr.,2016,2019,Total,Total,93,1341,223,432,219,415,4,17,108,167,151,283,434,46,47,53,94,207,558
6686,Corey Chandler,2008,2009,Rutgers,Big East,60,1362,203,554,147,363,56,191,96,146,67,153,220,102,85,19,165,122,558
6687,Brandon Davis,2011,2012,Lamar,Southland,65,1347,188,471,74,165,114,306,68,87,56,113,169,91,32,6,58,86,558
6688,Zach Finley,2008,2010,Princeton,Ivy,85,1600,227,442,227,442,0,0,104,175,105,226,331,81,48,58,157,230,558
6689,Rapolas Ivanauskas,2018,2019,Total,Total,38,1069,207,402,164,303,43,99,101,130,64,211,275,56,19,21,86,108,558
6690,Matt Kavanaugh,2010,2014,Dayton,A-10,112,1685,213,407,213,407,0,0,132,183,195,202,397,59,29,28,127,247,558
6691,Willie Kemp,2008,2010,Memphis,CUSA,110,2068,184,509,73,185,111,324,79,123,33,114,147,249,109,8,106,120,558
6692,Rashaun Madison,2015,2017,North Carolina Central,MEAC,71,1781,191,511,42,84,149,427,27,47,19,110,129,67,76,0,55,119,558
6693,Clint Mann,2009,2013,Total,Total,100,1537,226,464,214,431,12,33,94,167,135,165,300,57,53,27,125,258,558
6694,Jordan McNeil,2016,2019,Towson,CAA,125,1893,202,496,123,256,79,240,75,120,28,113,141,94,55,10,106,142,558
6695,Kore White,2009,2013,Total,Total,103,1826,231,520,210,460,21,60,75,136,141,231,372,54,52,83,118,211,558
6696,Andrew Bock,2010,2014,Total,Total,106,1721,138,387,92,236,46,151,235,275,24,111,135,176,27,2,113,130,557
6697,Jaylen Key,2016,2019,Northern Illinois,MAC,97,1713,223,484,209,449,14,35,97,143,96,222,318,57,37,34,107,218,557
6698,Francis-Cedric Martel,2009,2012,Richmond,A-10,138,2468,195,460,125,266,70,194,97,153,157,254,411,138,99,45,111,293,557
6699,PJ Savoy,2017,2019,Florida State,ACC,92,1123,173,459,31,66,142,393,69,91,16,89,105,40,33,6,56,87,557
6700,Carleton Scott,2009,2011,Notre Dame,Big East,84,1668,205,426,137,237,68,189,79,93,95,308,403,108,44,97,72,145,557
6701,Gary Springer,2008,2009,Iona,MAAC,49,1087,200,354,200,354,0,0,157,249,146,215,361,19,42,44,114,148,557
6702,Kyrie Sutton,2009,2013,Total,Total,115,1720,233,456,233,455,0,1,91,180,157,254,411,28,22,108,112,220,557
6703,David Blanks,2015,2016,Texas Southern,SWAC,67,1860,179,420,136,283,43,137,155,236,61,203,264,203,52,4,139,117,556
6704,Mario Blessing,2012,2015,South Carolina Upstate,A-Sun,137,3213,194,534,81,195,113,339,55,85,75,178,253,293,97,7,187,288,556
6705,Josh Brown,2011,2012,Louisiana,Sun Belt,51,1371,223,524,197,434,26,90,84,137,115,193,308,41,38,24,79,104,556
6706,Coty Clarke,2013,2014,Arkansas,SEC,65,1384,181,386,147,309,34,77,160,206,115,236,351,116,95,38,83,193,556
6707,Viont'e Daniels,2016,2019,Washington State,Pac-12,102,2280,186,433,49,107,137,326,47,62,36,127,163,175,44,14,76,132,556
6708,Austin Dassent,2017,2018,Savannah State,MEAC,60,1280,181,458,82,162,99,296,95,153,58,160,218,128,61,5,103,131,556
6709,Nate Duhon,2013,2014,Chicago State,Total,60,1488,200,463,181,387,19,76,137,182,52,134,186,80,92,4,102,142,556
6710,Sam Jones,2015,2018,Pennsylvania,Ivy,106,1504,175,461,25,61,150,400,56,68,25,175,200,45,24,13,45,97,556
6711,Darryl Morsell,2018,2019,Maryland,Big Ten,65,1803,212,480,191,393,21,87,111,157,87,157,244,126,41,31,124,129,556
6712,Hanner Mosquera-Perea,2013,2017,Total,Total,110,1611,197,341,197,340,0,1,162,278,125,240,365,39,37,94,99,210,556
6713,Tony Murphy,2008,2008,Norfolk State,MEAC,31,1085,181,493,108,256,73,237,121,146,17,78,95,76,54,3,104,30,556
6714,Alonzo Nelson-Ododa,2013,2016,Total,Total,125,2414,195,447,161,323,34,124,132,220,144,355,499,84,61,208,118,265,556
6715,Darrian Ringo,2018,2019,Miami (OH),MAC,66,1865,183,425,137,259,46,166,144,193,45,166,211,387,158,10,193,172,556
6716,Tyler Stone,2014,2017,Howard,MEAC,128,2204,181,434,169,379,12,55,182,270,141,326,467,39,48,100,117,288,556
6717,Hiram Thompson,2009,2011,Hawaii,WAC,76,2092,166,415,97,233,69,182,155,209,39,147,186,229,86,8,182,137,556
6718,Kendall Wallace,2008,2012,Nevada-Las Vegas,MWC,128,1506,183,481,43,106,140,375,50,66,39,120,159,87,47,5,59,163,556
6719,Noah Allen,2014,2017,Total,Total,101,1511,194,441,146,280,48,161,119,165,49,213,262,104,45,10,106,122,555
6720,Brian Asbury,2008,2009,Miami (FL),ACC,66,1608,185,420,142,284,43,136,142,176,112,188,300,93,54,28,85,98,555
6721,Deuce Bello,2012,2016,Total,Total,125,1739,194,428,155,293,39,135,128,222,87,171,258,78,83,38,142,242,555
6722,Marquis Eaton,2018,2019,Arkansas State,Sun Belt,64,1663,192,507,139,334,53,173,118,150,36,119,155,160,54,17,133,130,555
6723,Willie Gardner,2008,2009,Colorado State,MWC,57,1768,191,429,138,274,53,155,120,145,40,124,164,145,42,14,82,99,555
6724,Travon Harper,2017,2018,Arkansas-Pine Bluff,SWAC,67,1367,207,418,193,365,14,53,127,196,98,176,274,40,37,36,110,218,555
6725,Darington Hobson,2010,2010,New Mexico,MWC,35,1175,193,439,154,331,39,108,130,199,74,250,324,160,44,15,104,68,555
6726,Keon Lawrence,2008,2011,Total,Total,79,1975,206,542,159,387,47,155,96,126,57,188,245,196,56,36,132,129,555
6727,Martell McDuffy,2008,2009,Radford,Big South,41,1298,188,441,122,254,66,187,113,167,29,132,161,69,52,13,116,93,555
6728,Mike Meyers Keitt,2011,2012,Monmouth,NEC,60,1477,192,452,125,269,67,183,104,140,73,144,217,82,39,8,86,78,555
6729,Renado Parker,2012,2013,Portland State,Big Sky,52,1354,218,439,218,438,0,1,119,170,104,161,265,36,33,22,79,136,555
6730,Derek Willis,2014,2017,Kentucky,SEC,103,1543,189,400,81,129,108,271,69,86,76,278,354,51,49,66,60,136,555
6731,Ahmad Abdullah,2013,2016,North Carolina A&T,MEAC,85,2194,188,492,123,311,65,181,113,148,38,170,208,198,52,4,127,127,554
6732,Romelo Banks,2014,2017,North Florida,A-Sun,100,1702,215,414,215,414,0,0,124,249,135,228,363,17,20,92,101,281,554
6733,Tevin Baskin,2011,2014,Total,Total,70,1274,193,438,178,392,15,46,153,219,77,172,249,25,51,55,75,175,554
6734,Jamar Butler,2008,2008,Ohio State,Big Ten,37,1341,184,428,80,157,104,271,82,87,13,96,109,219,49,1,99,47,554
6735,Chris Linton,2008,2009,Savannah State,Ind,60,1702,217,478,191,406,26,72,94,164,100,240,340,72,62,22,132,143,554
6736,Mario Matasovic,2014,2018,Total,Total,104,1600,212,414,179,310,33,104,97,133,121,209,330,59,40,38,120,216,554
6737,Martelle McLemore,2008,2010,Western Michigan,MAC,92,1586,193,480,107,235,86,245,82,121,96,231,327,69,59,13,97,170,554
6738,Ariece Perkins,2009,2010,Grambling,SWAC,56,1533,185,439,130,294,55,145,129,185,56,141,197,156,43,4,111,113,554
6739,Kyisean Reed,2012,2013,Utah State,WAC,52,1386,206,342,206,341,0,1,142,211,106,180,286,47,46,69,72,156,554
6740,Eddie Reese,2018,2019,Southern,SWAC,47,1377,180,429,88,178,92,251,102,147,26,128,154,142,53,20,121,110,554
6741,James Reid,2015,2017,Total,Total,62,1446,170,413,54,98,116,315,98,122,12,135,147,93,34,5,71,149,554
6742,Danny Robison,2013,2016,Montana State,Big Sky,105,1948,181,402,133,254,48,148,144,212,143,216,359,37,39,17,95,252,554
6743,Kamryn Williams,2012,2015,Air Force,MWC,93,1807,204,465,163,338,41,127,105,159,113,251,364,157,67,59,127,162,554
6744,Stacy Wilson,2012,2013,Murray State,OVC,63,1276,201,467,120,231,81,236,71,102,33,111,144,94,51,16,116,119,554
6745,Darius Austin,2015,2018,Total,Total,93,2056,208,552,168,432,40,120,97,175,123,263,386,104,73,42,132,218,553
6746,Jake Babic,2015,2019,Total,Total,121,2117,182,527,81,197,101,330,88,126,54,197,251,204,37,16,136,188,553
6747,LeRon Barnes,2012,2016,Houston,Total,112,2411,202,472,138,291,64,181,85,130,148,335,483,96,66,53,83,253,553
6748,Ojai Black,2015,2017,Texas State,Sun Belt,98,2344,182,444,159,351,23,93,166,224,36,141,177,287,89,22,130,206,553
6749,Jalen Carethers,2012,2015,Radford,Big South,122,1611,216,462,216,459,0,3,121,173,152,227,379,52,52,108,63,266,553
6750,Eric Green,2014,2016,Holy Cross,Patriot,83,2047,234,518,225,476,9,42,76,131,89,187,276,108,113,36,99,130,553
6751,Malcolm Griffin,2010,2011,Toledo,MAC,56,1457,223,476,189,377,34,99,73,125,28,134,162,195,77,2,203,137,553
6752,Jalin Hart,2017,2018,Incarnate Word,Southland,40,1270,195,409,149,282,46,127,117,184,21,107,128,178,54,13,114,101,553
6753,James Hett,2008,2011,Monmouth,NEC,120,3892,200,513,146,283,54,230,99,156,83,262,345,492,138,9,235,274,553
6754,Elliott Lloyd,2010,2012,Northern Colorado,Big Sky,83,2093,174,438,70,185,104,253,101,129,33,165,198,181,58,11,177,176,553
6755,Matthew Pegram,2016,2019,Wofford,Southern,127,1716,231,470,217,424,14,46,77,97,113,240,353,72,34,49,95,307,553
6756,Cadarian Raines,2010,2014,Virginia Tech,ACC,112,1947,234,486,234,486,0,0,85,163,203,240,443,46,46,91,90,248,553
6757,Stallon Saldivar,2010,2013,Northern Arizona,Big Sky,118,3117,188,519,125,299,63,220,114,147,59,339,398,505,103,6,217,156,553
6758,Kazembe Abif,2012,2016,Drexel,CAA,93,2087,201,422,199,407,2,15,148,226,143,296,439,42,33,25,86,238,552
6759,Herbie Allen,2008,2009,Fairfield,MAAC,60,1758,183,460,109,252,74,208,112,144,25,96,121,152,52,1,102,115,552
6760,Devon Clarke,2008,2009,Iona,MAAC,63,1236,172,326,169,319,3,7,205,278,94,142,236,25,44,29,108,155,552
6761,Brian Connelly,2008,2009,Albany (NY),AEC,61,1827,218,471,213,447,5,24,111,153,82,217,299,62,29,9,92,165,552
6762,Daviin Davis,2008,2009,Weber State,Big Sky,61,1462,187,391,167,309,20,82,158,224,36,157,193,132,67,86,137,160,552
6763,Greg Gamble,2008,2009,Buffalo,MAC,63,1771,205,446,201,431,4,15,138,207,89,207,296,202,80,12,160,115,552
6764,Tyler Griffey,2010,2013,Illinois,Big Ten,124,1719,211,480,141,269,70,211,60,82,120,191,311,50,48,38,78,184,552
6765,Dewan Hernandez,2017,2018,Miami (FL),ACC,64,1382,224,400,224,395,0,5,104,154,110,202,312,20,29,56,74,121,552
6766,Mislav Jukic,2008,2011,Saint Francis (PA),NEC,83,1503,205,438,195,408,10,30,132,179,85,175,260,82,21,31,147,217,552
6767,Joseph Katuka,2008,2011,George Washington,A-10,99,1519,215,429,215,429,0,0,122,223,149,213,362,29,44,68,118,264,552
6768,DeMario Mayfield,2010,2013,Total,Total,65,1479,188,433,146,290,42,143,134,222,68,214,282,118,54,11,103,123,552
6769,Sam Neumann,2016,2019,Montana State,Big Sky,124,2360,175,336,121,187,54,149,148,212,163,356,519,137,42,9,80,265,552
6770,Anthony Newell,2008,2009,Ball State,MAC,34,1175,196,486,167,388,29,98,131,216,77,212,289,46,28,10,60,93,552
6771,Paulius Satkus,2014,2017,James Madison,CAA,111,1765,194,358,184,329,10,29,154,215,108,243,351,89,33,18,144,261,552
6772,Daniel Simmons,2017,2018,Southeast Missouri State,OVC,63,1290,191,461,116,271,75,190,95,142,24,154,178,107,48,5,100,106,552
6773,Nick Wright,2010,2013,Old Dominion,CAA,124,1795,188,504,163,412,25,92,151,233,173,195,368,40,41,61,104,172,552
6774,Musa Abdul-Aleem,2013,2015,Total,Total,55,1136,185,463,92,189,93,274,88,113,32,142,174,31,42,5,64,85,551
6775,George Brammeier,2015,2018,Lipscomb,A-Sun,122,1453,212,364,212,364,0,0,127,218,138,180,318,43,32,38,108,258,551
6776,Darryl Clements,2008,2009,Bowling Green State,MAC,63,1916,198,513,135,304,63,209,92,109,35,191,226,173,78,13,162,132,551
6777,Ed Dyson,2014,2015,Austin Peay,OVC,57,1556,183,416,123,243,60,173,125,189,29,143,172,89,52,4,92,131,551
6778,C.J. Gettys,2013,2017,Total,Total,101,1648,222,432,222,432,0,0,107,165,162,262,424,64,28,92,90,261,551
6779,Janari Joesaar,2014,2015,Total,Total,43,1105,166,360,102,188,64,172,155,190,76,148,224,76,43,18,89,90,551
6780,Donnavan Kirk,2010,2014,Total,Total,102,2166,220,476,193,394,27,82,84,124,149,248,397,24,36,132,90,207,551
6781,Alphonso Leary,2011,2013,Howard,MEAC,92,2349,191,437,191,437,0,0,169,273,207,298,505,25,53,75,143,319,551
6782,Luke Martinez,2012,2013,Wyoming,MWC,44,1311,170,427,54,102,116,325,95,116,28,135,163,65,79,10,62,80,551
6783,Mangok Mathiang,2014,2017,Louisville,Total,114,2054,209,413,209,413,0,0,133,222,259,287,546,60,56,146,99,250,551
6784,Justin Orr,2008,2009,Ohio,MAC,65,1665,202,496,119,270,83,226,64,93,63,139,202,94,42,19,101,105,551
6785,Mike Powell,2012,2014,Rhode Island,A-10,69,2128,166,513,101,301,65,212,154,209,45,143,188,229,57,1,189,120,551
6786,Tom Rivard,2014,2018,Total,Total,79,1489,215,459,162,299,53,160,68,116,77,195,272,71,35,32,105,169,551
6787,Matt Ryan,2016,2019,Total,Total,101,1529,179,462,38,76,141,386,52,66,22,148,170,59,25,8,50,141,551
6788,Stef Smith,2018,2019,Vermont,AEC,68,1325,183,457,97,225,86,232,99,129,24,177,201,85,45,5,92,109,551
6789,C.J. Wilkerson,2011,2011,North Carolina Central,Ind,29,1077,160,344,116,232,44,112,187,251,17,81,98,53,30,2,94,73,551
6790,Dallin Bachynski,2010,2015,Total,Total,120,1559,193,358,187,343,6,15,158,229,134,262,396,50,42,63,89,209,550
6791,Don Coleman,2017,2018,University of California,Pac-12,57,1252,169,499,139,372,30,127,182,254,46,83,129,72,46,2,88,112,550
6792,Jerekius Davis,2017,2019,Louisiana,Sun Belt,89,1183,207,455,146,264,61,191,75,102,96,138,234,30,38,19,56,158,550
6793,Chris Early,2009,2012,Chattanooga,Southern,92,1452,200,486,143,309,57,177,93,156,112,274,386,71,41,16,121,207,550
6794,Julian Gamble,2009,2013,Miami (FL),ACC,129,1898,224,412,223,408,1,4,101,193,176,281,457,57,47,132,102,247,550
6795,Tyree Glass,2008,2010,Arkansas-Pine Bluff,SWAC,82,1515,181,452,164,374,17,78,171,293,119,161,280,59,29,26,156,193,550
6796,Jalen Johnson,2017,2018,Saint Louis,A-10,66,1687,176,430,89,202,87,228,111,146,77,199,276,47,35,38,86,164,550
6797,Christ Koumadje,2016,2019,Florida State,ACC,122,1474,239,384,239,382,0,2,72,133,142,265,407,16,17,146,89,232,550
6798,Dominique Major,2012,2015,Saint Francis (PA),NEC,92,1917,177,500,30,89,147,411,49,85,20,68,88,72,54,2,55,122,550
6799,Malik Martin,2015,2019,Total,Total,103,1831,223,448,200,366,23,82,81,152,111,260,371,57,46,69,134,175,550
6800,David Samuels,2014,2015,Long Beach State,Big West,65,1648,213,458,201,407,12,51,112,178,163,254,417,63,29,33,109,164,550
6801,Reggie Scurry,2018,2019,Total,Total,53,1205,215,399,211,385,4,14,116,174,132,149,281,28,24,37,85,136,550
6802,Renardo Sidney,2011,2012,Mississippi State,SEC,48,1137,215,424,193,363,22,61,98,151,73,222,295,30,35,36,90,139,550
6803,Gavin Skelly,2015,2018,Northwestern,Big Ten,127,1926,187,392,141,265,46,127,130,187,144,262,406,108,52,91,126,280,550
6804,Brandon Swannegan,2013,2016,Tulsa,Total,123,1893,201,395,201,395,0,0,148,252,185,238,423,24,42,148,87,303,550
6805,Aaron Bodager,2014,2017,North Florida,A-Sun,101,1979,182,443,34,58,148,385,37,47,65,185,250,100,54,3,96,147,549
6806,Chad Frazier,2014,2014,Alabama-Birmingham,CUSA,31,1095,170,424,109,244,61,180,148,203,17,86,103,132,35,10,123,62,549
6807,Nori Johnson,2011,2014,College of Charleston,Total,107,1754,178,450,59,135,119,315,74,103,41,130,171,60,67,35,82,178,549
6808,Chris Lewis,2008,2010,San Diego,WCC,99,1966,187,401,122,233,65,168,110,154,109,266,375,61,60,18,101,205,549
6809,DeShone McClure,2013,2014,Central Arkansas,Southland,58,1499,207,473,132,254,75,219,60,105,40,71,111,131,71,29,84,112,549
6810,JoJo McGlaston,2014,2018,Total,Total,96,1757,183,497,117,299,66,198,117,186,51,209,260,106,50,48,120,138,549
6811,Juan Pattillo,2009,2011,Total,Total,51,1223,203,399,203,396,0,3,143,215,122,233,355,50,55,75,125,127,549
6812,Dusan Perovic,2015,2018,Binghamton,AEC,94,1364,203,525,126,297,77,228,66,103,29,177,206,48,19,20,81,157,549
6813,Tyson Smith,2016,2019,Total,Total,86,1509,164,443,67,172,97,271,124,156,22,117,139,98,56,16,88,168,549
6814,Trent Steen,2017,2018,Arkansas-Pine Bluff,SWAC,66,1386,222,457,220,446,2,11,103,167,70,184,254,37,63,68,126,202,549
6815,Karim York,2014,2016,Prairie View,SWAC,77,1526,217,480,182,361,35,119,80,135,103,203,306,43,35,30,143,189,549
6816,JoJo Anderson,2017,2018,Northern Arizona,Big Sky,60,1447,132,355,72,170,60,185,224,295,15,137,152,142,35,3,122,101,548
6817,Will Bogan,2009,2013,Total,Total,116,2374,175,438,45,106,130,332,68,85,26,92,118,147,64,6,122,140,548
6818,Ignas Brazdeikis,2019,2019,Michigan,Big Ten,37,1096,188,407,132,264,56,143,116,150,43,158,201,31,26,18,46,79,548
6819,Keelan Garrett,2013,2015,McNeese State,Southland,73,1422,193,534,82,202,111,332,51,69,20,86,106,66,34,1,64,73,548
6820,Ian Kinard,2017,2019,South Carolina State,MEAC,96,1931,159,407,130,300,29,107,201,278,122,240,362,51,39,39,126,286,548
6821,Daniel Kinchen,2018,2019,Southern Illinois-Edwardsville,OVC,60,1268,169,479,71,173,98,306,112,124,18,81,99,106,37,2,88,78,548
6822,Dejounte Murray,2016,2016,Washington,Pac-12,34,1139,202,486,168,368,34,118,110,166,48,155,203,151,62,10,110,90,548
6823,John Puk,2011,2014,Albany (NY),AEC,132,2845,217,471,217,471,0,0,114,162,145,354,499,62,24,112,145,377,548
6824,Tim Shelton,2008,2012,San Diego State,MWC,109,2048,216,454,198,392,18,62,98,171,160,229,389,124,50,23,85,209,548
6825,Parker Van Dyke,2017,2019,Utah,Pac-12,97,1940,191,474,58,111,133,363,33,51,11,130,141,143,61,8,62,115,548
6826,Maurice Acker,2008,2010,Marquette,Big East,102,1995,182,441,86,210,96,231,87,117,24,117,141,250,93,2,102,196,547
6827,Ray Crossland,2017,2018,Eastern Illinois,OVC,59,1737,203,501,163,381,40,120,101,150,117,204,321,83,75,17,123,166,547
6828,Nick Daniels,2009,2010,Purdue-Fort Wayne,Summit,61,1655,185,443,82,198,103,245,74,96,23,153,176,105,40,15,100,144,547
6829,Luguentz Dort,2019,2019,Arizona State,Pac-12,34,1072,174,430,120,254,54,176,145,207,44,101,145,79,52,7,99,102,547
6830,John Garcia,2008,2010,Seton Hall,Big East,91,1859,232,383,232,383,0,0,83,166,209,317,526,42,41,128,79,240,547
6831,Jordan Gathers,2012,2016,Total,Total,124,2054,189,481,106,242,83,239,86,119,43,138,181,180,84,9,111,221,547
6832,T.J. Hallice,2012,2015,Mercer,Total,145,2264,217,431,210,393,7,38,106,197,173,258,431,88,50,56,87,203,547
6833,Jake Nielson,2009,2011,Southern Utah,Summit,88,1623,184,433,161,359,23,74,156,222,58,255,313,177,96,13,184,245,547
6834,Anthony Nieves,2012,2013,Alcorn State,SWAC,48,1363,181,481,123,318,58,163,127,194,47,115,162,86,41,9,151,128,547
6835,Deonte Roberts,2008,2010,Milwaukee,Horizon,79,1832,200,414,198,410,2,4,145,233,107,180,287,156,62,28,179,170,547
6836,Joey Shank,2008,2009,Texas-San Antonio,Southland,60,1596,178,462,39,93,139,369,52,63,19,72,91,36,45,0,64,111,547
6837,Ray Barbosa,2008,2008,Maryland-Baltimore County,AEC,33,1104,179,420,93,189,86,231,102,122,27,108,135,70,29,3,56,65,546
6838,Bradley Beal,2012,2012,Florida,SEC,37,1267,175,393,112,207,63,186,133,173,50,199,249,83,51,31,79,76,546
6839,Colin Borchert,2013,2014,Mississippi State,SEC,62,1651,203,500,130,271,73,229,67,94,64,221,285,80,59,69,133,176,546
6840,James Carlton,2011,2015,Total,Total,82,1379,199,445,179,356,20,89,128,172,86,237,323,39,41,52,108,141,546
6841,Dawon Cummings,2013,2014,Indiana State,MVC,67,1613,185,458,104,203,81,255,95,129,22,173,195,138,81,23,91,137,546
6842,Anthony Fisher,2008,2008,Tennessee Tech,OVC,32,1063,157,370,110,210,47,160,185,243,18,80,98,114,48,1,108,90,546
6843,Marvin Frazier,2012,2015,Northwestern State,Southland,114,1735,202,454,179,384,23,70,119,176,141,274,415,57,59,160,86,222,546
6844,Devin Ginty,2008,2011,San Diego,WCC,122,2496,165,440,57,124,108,316,108,136,30,163,193,199,54,5,135,238,546
6845,Nick Hansen,2009,2010,Weber State,Big Sky,62,1799,170,437,28,64,142,373,64,71,16,157,173,107,59,6,68,87,546
6846,Terrance Mitchell,2010,2011,Maine,AEC,56,1344,137,368,50,118,87,250,185,240,22,112,134,92,33,7,111,152,546
6847,Davide Moretti,2018,2019,Texas Tech,Big 12,73,1576,166,369,71,138,95,231,119,131,9,93,102,122,56,0,75,130,546
6848,David Potter,2008,2010,Clemson,ACC,98,1866,189,494,98,245,91,249,77,106,72,156,228,124,89,26,128,232,546
6849,Skylar Spencer,2013,2016,San Diego State,MWC,144,3104,226,389,226,389,0,0,94,204,269,383,652,45,70,303,93,290,546
6850,Will Thomas,2008,2008,George Mason,CAA,34,1212,208,324,207,323,1,1,129,192,85,268,353,67,31,18,52,60,546
6851,Donnie Tillman,2018,2019,Utah,Pac-12,59,1414,178,391,125,241,53,150,137,175,79,217,296,68,30,18,82,107,546
6852,Shawn Vanzant,2008,2011,Butler,Horizon,138,2292,177,446,110,251,67,195,125,175,42,232,274,154,67,10,108,191,546
6853,Rondale Watson,2015,2019,Total,Total,96,1854,197,467,147,305,50,162,102,149,72,205,277,133,69,18,87,170,546
6854,Darion Atkins,2012,2015,Virginia,ACC,123,1857,236,465,236,464,0,1,73,130,158,264,422,46,56,102,89,205,545
6855,Jarrell Brown,2008,2008,Army,Patriot,30,1091,190,449,89,197,101,252,64,80,16,102,118,58,48,2,51,49,545
6856,Nicolas Claxton,2018,2019,Georgia,SEC,65,1496,181,396,155,310,26,86,157,257,127,276,403,64,39,123,90,147,545
6857,Dwayne Davis,2013,2013,Southern Mississippi,CUSA,34,1026,193,395,134,252,59,143,100,127,21,132,153,87,39,6,114,91,545
6858,Michel Enanga,2013,2017,Coastal Carolina,Total,121,2289,192,467,150,311,42,156,119,213,210,351,561,111,103,47,158,307,545
6859,Joe Furstinger,2015,2018,New Mexico,MWC,117,1932,183,374,178,339,5,35,174,238,116,297,413,120,50,107,100,264,545
6860,Skyler Halford,2014,2015,Brigham Young,WCC,69,1152,178,389,97,188,81,201,108,125,16,95,111,113,39,1,80,114,545
6861,Maurice Jeffers,2014,2017,Total,Total,109,2101,211,424,211,424,0,0,123,217,184,293,477,59,29,80,152,247,545
6862,Troy King,2011,2012,Tennessee-Martin,OVC,63,1453,183,450,105,229,78,221,101,141,51,150,201,58,33,10,125,116,545
6863,Brice Massamba,2009,2012,Nevada-Las Vegas,MWC,127,1885,206,324,206,323,0,1,133,236,145,158,303,67,33,41,97,318,545
6864,Matt Pile,2018,2019,Omaha,Summit,63,1374,238,392,238,392,0,0,69,147,147,236,383,63,29,58,88,148,545
6865,Trent Plaisted,2008,2008,Brigham Young,MWC,35,958,202,373,202,373,0,0,141,260,75,194,269,54,15,34,84,82,545
6866,Justin Ravenel,2016,2017,Florida A&M,MEAC,59,1635,181,455,65,145,116,310,67,86,28,121,149,60,33,2,51,88,545
6867,Richard Roby,2008,2008,Colorado,Big 12,32,1110,189,396,142,273,47,123,120,157,58,156,214,66,33,31,107,104,545
6868,Gabe Stefanini,2018,2019,Columbia,Ivy,55,1248,203,468,136,314,67,154,72,96,37,164,201,143,62,4,116,108,545
6869,David Taylor,2014,2017,Pacific,WCC,109,1886,186,516,84,199,102,317,71,96,24,124,148,110,39,2,112,163,545
6870,Torloft Thomas,2014,2017,Total,Total,89,1924,157,458,68,193,89,265,142,187,36,128,164,144,43,7,137,152,545
6871,Evan Wieck,2017,2019,Navy,Patriot,95,1749,229,356,229,355,0,1,87,138,184,157,341,56,42,21,82,216,545
6872,Michael Carter-Williams,2012,2013,Syracuse,Big East,66,1678,180,452,138,315,42,137,142,209,60,177,237,345,129,27,154,117,544
6873,Kenny Goins,2016,2019,Michigan State,Big Ten,130,2487,204,436,144,262,60,174,76,113,170,493,663,165,50,103,125,238,544
6874,Cody Schwartz,2016,2019,Total,Total,96,1696,178,486,48,117,130,369,58,80,56,165,221,72,31,15,65,187,544
6875,Anthony Simpson,2009,2010,Kent State,MAC,68,1635,214,449,187,380,27,69,89,147,131,284,415,44,65,55,67,117,544
6876,Carlos Taylor,2008,2008,Montana State,Big Sky,30,887,184,402,124,251,60,151,116,144,21,93,114,63,28,7,75,85,544
6877,Amadi Udenyi,2014,2018,Pepperdine,WCC,110,2563,175,541,99,279,76,262,118,190,30,175,205,426,93,3,188,182,544
6878,Devon White,2010,2013,Total,Total,118,1758,225,464,225,463,0,1,94,169,187,284,471,44,64,108,128,299,544
6879,Sammy Yeager,2011,2013,Total,Total,41,1162,203,448,118,239,85,209,53,75,39,139,178,80,37,16,77,102,544
6880,Josh Adeyeye,2015,2016,Jacksonville,A-Sun,63,1258,180,444,62,145,118,299,65,85,27,176,203,36,22,7,62,95,543
6881,Jamal Aytes,2014,2018,Total,Total,85,1067,220,382,219,380,1,2,102,150,80,159,239,30,18,12,78,163,543
6882,Jimmy Conyers,2008,2010,Akron,MAC,97,1714,188,391,163,299,25,92,142,193,150,241,391,92,74,18,127,199,543
6883,Joe Davis,2008,2010,Total,Total,70,1137,194,483,140,281,54,202,101,138,35,68,103,71,31,4,91,106,543
6884,Dom Hoffman,2013,2016,Bucknell,Patriot,117,1731,220,475,197,412,23,63,80,110,135,256,391,97,29,31,88,194,543
6885,Lewis Jones,2010,2013,Evansville,MVC,122,1816,197,475,183,418,14,57,135,217,82,168,250,63,41,12,101,216,543
6886,A.C. Reid,2015,2018,Total,Total,106,2120,181,561,42,106,139,455,42,60,13,190,203,140,56,12,120,195,543
6887,Tre Scott,2017,2019,Cincinnati,AAC,105,1876,211,429,198,386,13,43,108,175,156,301,457,104,61,40,77,123,543
6888,Isaiah Bailey,2018,2019,Bethune-Cookman,MEAC,35,1067,164,386,135,278,29,108,185,237,45,127,172,155,32,9,129,100,542
6889,Nate Bendall,2010,2011,Utah State,WAC,64,1483,213,402,213,400,0,2,116,147,115,246,361,36,30,38,79,166,542
6890,Suleiman Braimoh,2008,2011,Rice,CUSA,124,1679,221,442,221,442,0,0,100,174,192,184,376,45,48,43,138,244,542
6891,Terrell Carter,2015,2018,Fresno State,MWC,112,1427,218,394,218,394,0,0,106,178,106,174,280,28,29,53,124,280,542
6892,Triston Chambers,2017,2018,Samford,Southern,68,1536,179,413,40,90,139,323,45,59,25,102,127,52,42,4,66,139,542
6893,Jaron Cornish,2018,2019,Stony Brook,AEC,60,1574,195,499,140,311,55,188,97,146,40,202,242,195,62,21,146,143,542
6894,Devan Dumes,2009,2010,Indiana,Big Ten,57,1287,171,451,81,195,90,256,110,155,27,110,137,73,53,5,139,135,542
6895,Lew Evans,2014,2017,Total,Total,96,1816,170,457,102,228,68,229,134,198,125,275,400,78,32,17,117,264,542
6896,Trey Gilder,2008,2008,Northwestern State,Southland,33,887,189,394,172,324,17,70,147,192,76,128,204,63,39,22,89,69,542
6897,Micaiah Henry,2017,2019,Tennessee Tech,OVC,95,1662,220,380,220,379,0,1,102,223,146,166,312,38,22,114,146,272,542
6898,Joe Krabbenhoft,2008,2009,Wisconsin,Big Ten,69,2122,190,394,172,333,18,61,144,182,133,320,453,171,56,24,109,152,542
6899,Marcus Lewis,2013,2014,Eastern Kentucky,OVC,69,1672,213,424,179,290,34,134,82,136,46,106,152,79,98,27,71,166,542
6900,Connor Osborne,2010,2014,Northern Colorado,Big Sky,116,1977,210,408,209,404,1,4,121,232,172,240,412,63,24,71,126,265,542
6901,Eric Platt,2008,2011,Total,Total,71,1374,170,394,50,104,120,290,82,113,29,123,152,93,52,19,77,103,542
6902,Ari Stewart,2010,2013,Total,Total,79,1471,201,541,118,273,83,268,57,75,66,197,263,45,26,12,125,137,542
6903,Leon Williams,2008,2008,Ohio,MAC,33,1009,180,293,179,292,1,1,181,247,145,180,325,41,47,23,80,93,542
6904,Warren Edney,2008,2011,Fairfield,MAAC,76,1537,201,472,158,336,43,136,96,133,72,162,234,39,45,16,79,126,541
6905,Luke Fabrizius,2009,2012,Dayton,A-10,116,1335,188,490,42,105,146,385,19,31,45,132,177,45,11,27,46,142,541
6906,John Fowler,2008,2009,Little Rock,Sun Belt,62,1605,149,351,111,236,38,115,205,284,125,167,292,86,56,32,114,174,541
6907,Damarion Geter,2014,2019,Longwood,Big South,129,3253,217,407,204,371,13,36,94,180,187,440,627,179,98,105,162,346,541
6908,Jerami Grant,2013,2014,Syracuse,Total,72,1577,187,385,181,365,6,20,161,251,124,211,335,62,43,36,63,129,541
6909,Abdoulaye Harouna,2016,2019,Miami (OH),MAC,95,1857,170,465,85,208,85,257,116,157,35,161,196,72,74,14,130,227,541
6910,Ognjen Miljkovic,2014,2015,Eastern Washington,Big Sky,59,1277,186,448,105,229,81,219,88,118,49,141,190,46,32,27,95,154,541
6911,Hugh Mingo,2011,2012,Louisiana-Monroe,Sun Belt,60,1736,205,549,143,329,62,220,69,112,59,228,287,75,62,18,120,152,541
6912,Ethan Montalvo,2015,2016,Texas State,Sun Belt,60,1513,168,467,57,133,111,334,94,116,7,91,98,75,46,4,70,76,541
6913,Nick Niernczyk,2011,2013,Southeast Missouri State,OVC,62,1560,188,474,83,192,105,282,60,68,20,127,147,107,49,6,56,138,541
6914,Darryl Smith,2014,2017,Cornell,Ivy,104,2030,209,400,160,283,49,117,74,105,48,215,263,90,68,30,91,141,541
6915,Owen Wignot,2009,2012,Siena,MAAC,122,2313,201,488,125,266,76,222,63,95,89,235,324,123,81,68,93,185,541
6916,Robbie Dreher,2010,2011,Winthrop,Big South,60,1529,174,508,117,305,57,203,135,208,60,129,189,81,68,9,111,127,540
6917,Bateko Francisco,2008,2009,Robert Morris,NEC,69,1756,192,426,116,219,76,207,80,113,48,119,167,131,87,4,114,183,540
6918,Randall Gaskins Jr.,2017,2019,Saint Francis (PA),NEC,93,2339,212,459,173,353,39,106,77,128,64,130,194,128,85,19,88,177,540
6919,Josh Jenkins,2008,2009,Cal State Northridge,Big West,52,1300,166,466,87,231,79,235,129,166,15,91,106,325,79,3,201,113,540
6920,Gabe McCray,2015,2016,South Carolina State,MEAC,66,1372,204,444,180,366,24,78,108,182,94,199,293,41,43,3,91,155,540
6921,Pierre Miller,2011,2012,Presbyterian,Big South,60,1962,189,421,79,148,110,273,52,72,20,141,161,167,30,0,107,77,540
6922,KiShawn Pritchett,2017,2019,Davidson,A-10,95,2286,185,441,84,169,101,272,69,93,79,186,265,244,54,30,150,160,540
6923,James Richardson,2017,2018,South Carolina State,MEAC,59,1242,206,532,138,321,68,211,60,93,38,70,108,68,55,22,90,92,540
6924,Travis Souza,2012,2015,UC-Irvine,Big West,126,1945,163,398,21,56,142,342,72,89,48,179,227,122,44,5,61,74,540
6925,Will Tavares,2017,2018,Fordham,A-10,58,1537,200,486,159,330,41,156,99,152,45,168,213,62,59,13,103,111,540
6926,Denzell Taylor,2014,2017,Old Dominion,CUSA,140,3724,228,407,228,405,0,2,84,202,491,437,928,153,126,95,185,431,540
6927,Koby Thomas,2018,2019,Robert Morris,NEC,53,1265,206,475,185,379,21,96,107,171,95,227,322,31,30,12,90,93,540
6928,Mark Tyndale,2008,2008,Temple,A-10,34,1272,178,365,146,278,32,87,152,214,45,200,245,145,54,21,117,74,540
6929,Jordan Washington,2014,2015,Mississippi Valley State,SWAC,54,1205,176,434,109,250,67,184,121,160,34,79,113,106,59,1,100,109,540
6930,Mark Williams,2014,2017,Temple,AAC,124,1774,197,536,149,350,48,186,98,145,132,210,342,109,18,26,110,247,540
6931,Malik Boothe,2008,2011,St. John's (NY),Big East,119,2816,180,498,147,355,33,143,146,217,44,195,239,370,115,5,229,291,539
6932,Devonte Elliott,2011,2015,Total,Total,131,2026,199,487,191,446,8,41,133,202,129,319,448,54,48,93,121,294,539
6933,Charles Hankerson,2011,2015,Total,Total,117,2066,183,485,103,245,80,240,93,161,32,188,220,157,70,3,108,174,539
6934,Jacob Holmen,2010,2013,North Texas,Sun Belt,94,1493,208,511,170,384,38,127,85,109,100,176,276,49,23,17,74,118,539
6935,D'Angelo Jackson,2010,2011,Mississippi Valley State,SWAC,55,1269,151,387,74,191,77,196,160,202,15,109,124,125,51,3,133,106,539
6936,Casey Mitchell,2010,2011,West Virginia,Big East,65,992,177,454,84,191,93,263,92,106,43,73,116,47,32,7,62,55,539
6937,Uche Ofoegbu,2013,2017,Total,Total,102,1872,189,431,131,274,58,157,103,154,85,221,306,84,64,15,106,176,539
6938,Jordan Session,2015,2018,Georgia State,Sun Belt,128,1885,213,436,196,383,17,53,96,180,134,256,390,59,69,73,96,277,539
6939,Aaron Young,2015,2017,Oral Roberts,Summit,90,1985,175,389,85,172,90,217,99,123,18,114,132,134,49,4,82,172,539
6940,Tre Campbell,2015,2019,Total,Total,116,2235,175,518,72,216,103,302,85,116,30,138,168,193,86,4,95,132,538
6941,Joe Crawford,2008,2008,Kentucky,SEC,30,1009,188,401,125,228,63,173,99,130,31,78,109,64,17,5,83,81,538
6942,Javon Dawson,2012,2014,Total,Total,86,1813,207,468,192,422,15,46,109,161,123,260,383,68,48,12,119,167,538
6943,John Edgar Jr.,2017,2019,UC-Irvine,Big West,96,1662,217,504,164,306,53,198,51,74,62,207,269,61,27,4,100,121,538
6944,Ryan Gesiakowski,2012,2013,Prairie View,SWAC,66,1631,184,541,69,159,115,382,55,82,49,106,155,57,66,3,76,93,538
6945,Louis Graham,2008,2008,Georgia Southern,Southern,32,841,192,400,175,356,17,44,137,186,67,149,216,19,52,54,81,102,538
6946,Kaelon Harris,2017,2019,Citadel,Southern,71,1321,173,407,126,252,47,155,145,226,112,208,320,94,46,25,117,144,538
6947,Josh Jones,2010,2013,Creighton,MVC,108,1654,188,445,82,165,106,280,56,92,26,125,151,131,67,2,84,127,538
6948,Gary McGhee,2008,2011,Pittsburgh,Big East,120,1913,214,367,214,367,0,0,110,215,205,364,569,33,20,114,88,191,538
6949,Doral Moore,2016,2018,Wake Forest,ACC,92,1262,233,357,233,357,0,0,72,144,160,277,437,11,19,112,90,196,538
6950,Donte Pretlow,2013,2016,Morgan State,MEAC,121,2789,199,659,168,502,31,157,109,184,60,225,285,340,135,3,202,215,538
6951,Charles Rhodes,2008,2008,Mississippi State,SEC,31,976,214,381,211,375,3,6,107,159,89,153,242,29,16,42,74,74,538
6952,Colin Voss,2011,2015,Total,Total,92,1983,207,448,204,442,3,6,121,166,139,265,404,83,38,40,104,193,538
6953,Austin Williams,2015,2018,Drexel,CAA,100,1935,237,403,237,401,0,2,64,139,184,346,530,44,26,143,119,275,538
6954,Jordan Andrews,2016,2019,Total,Total,86,1463,163,503,52,156,111,347,100,128,29,137,166,79,50,8,89,162,537
6955,Troymain Crosby,2018,2019,Alcorn State,SWAC,60,1388,190,463,181,398,9,65,148,194,95,181,276,101,54,19,161,169,537
6956,J.R. Giddens,2008,2008,New Mexico,MWC,33,1063,210,407,185,332,25,75,92,157,57,233,290,103,47,39,73,64,537
6957,Matt Glover,2012,2015,Total,Total,97,2529,168,473,128,323,40,150,161,298,139,360,499,249,108,17,175,289,537
6958,Emmanuel Holloway,2008,2009,Illinois State,MVC,69,1714,188,470,107,254,81,216,80,112,56,140,196,143,78,19,96,156,537
6959,Kavon Lacey,2008,2011,Evansville,MVC,117,2585,205,475,191,427,14,48,113,169,40,217,257,282,70,4,188,265,537
6960,Devontavius Payne,2017,2018,East Tennessee State,Southern,68,1309,183,443,66,144,117,299,54,69,31,127,158,62,54,20,62,122,537
6961,Chad Rasmussen,2011,2013,Seattle,Total,85,1759,180,517,42,118,138,399,39,53,40,128,168,100,46,10,99,125,537
6962,Tyrone White,2010,2013,Total,Total,75,1611,188,471,80,177,108,294,53,76,29,158,187,99,45,9,103,123,537
6963,Koch Bar,2017,2019,Bradley,MVC,98,1856,190,381,190,381,0,0,156,231,163,270,433,42,40,95,133,190,536
6964,Johnathan Burroughs-Cook,2014,2017,Total,Total,90,1436,177,440,132,282,45,158,137,204,49,103,152,86,53,6,88,133,536
6965,Soufiyane Diakite,2017,2019,Total,Total,59,1338,213,386,192,334,21,52,89,146,148,294,442,62,49,42,113,142,536
6966,Sean Esposito,2010,2013,IUPUI,Summit,114,1959,181,493,49,138,132,355,42,49,28,155,183,123,54,11,64,141,536
6967,Patrick Good,2017,2019,Total,Total,61,1532,167,404,25,47,142,357,60,75,29,111,140,105,44,4,59,83,536
6968,Jayvon Graves,2018,2019,Buffalo,MAC,72,1483,193,450,110,218,83,232,67,109,83,150,233,104,46,58,60,117,536
6969,Amari Hamilton,2015,2019,North Carolina A&T,MEAC,103,1352,177,496,69,170,108,326,74,101,17,106,123,71,25,3,90,81,536
6970,Chauncey Hawkins,2018,2019,St. Francis (NY),NEC,61,1345,161,466,108,283,53,183,161,211,23,86,109,104,52,9,104,130,536
6971,Eric James,2015,2018,Duquesne,A-10,115,1605,193,457,146,276,47,181,103,169,118,214,332,80,72,20,112,151,536
6972,Elston Jones,2015,2019,Total,Total,130,1991,227,436,227,436,0,0,82,173,216,395,611,85,44,119,124,308,536
6973,Bryan Mullins,2008,2009,Southern Illinois,MVC,53,1828,175,420,91,220,84,200,102,137,30,100,130,278,111,3,113,138,536
6974,Alex Osborne,2010,2014,Loyola Marymount,WCC,125,2119,218,428,218,428,0,0,100,200,202,289,491,45,117,46,104,305,536
6975,Matt Shrigley,2014,2017,San Diego State,MWC,113,2003,179,527,41,107,138,420,40,59,30,153,183,79,59,32,65,146,536
6976,Gavin Thurman,2013,2015,Missouri State,MVC,86,1507,202,570,138,359,64,211,68,89,37,171,208,55,18,13,88,96,536
6977,Gary Trent Jr.,2018,2018,Duke,ACC,37,1253,177,427,80,186,97,241,85,97,31,126,157,52,43,5,38,62,536
6978,Wes VanBeck,2015,2018,Houston,AAC,98,1496,159,365,56,126,103,239,115,141,62,149,211,99,38,6,86,180,536
6979,Khalil Alford,2013,2016,Rider,MAAC,121,1507,208,481,158,327,50,154,69,101,100,142,242,54,28,26,87,179,535
6980,Roy Bright,2008,2008,Delaware State,MEAC,28,1014,195,458,117,238,78,220,67,83,36,113,149,18,20,17,38,73,535
6981,Alex Fountain,2014,2017,Houston Baptist,Southland,110,1678,180,423,136,303,44,120,131,167,83,161,244,81,33,33,71,179,535
6982,Alex Johnson,2011,2012,Total,Total,65,1590,161,452,53,127,108,325,105,138,20,118,138,170,61,0,115,82,535
6983,Garrett Leffelman,2008,2011,Brown,Ivy,86,1693,193,445,118,245,75,200,74,92,38,132,170,63,36,21,55,81,535
6984,Tyshawn Patterson,2010,2012,Stetson,A-Sun,82,1430,183,465,134,265,49,200,120,188,26,114,140,120,67,10,155,122,535
6985,Eulis Stephens,2008,2010,Detroit Mercy,Horizon,88,1851,200,482,173,372,27,110,108,169,69,162,231,79,51,25,96,151,535
6986,Niem Stevenson,2017,2018,Texas Tech,Big 12,67,1410,183,439,123,284,60,155,109,168,49,179,228,114,36,11,67,97,535
6987,Jamie Vanderbeken,2009,2011,Iowa State,Big 12,70,1432,188,405,80,150,108,255,51,76,71,210,281,55,22,78,54,154,535
6988,James Walker,2013,2014,Saint Mary's (CA),WCC,63,1666,170,426,84,202,86,224,109,154,53,159,212,73,78,9,82,121,535
6989,Mamadi Diane,2008,2009,Virginia,ACC,57,1370,187,448,115,254,72,194,88,128,75,119,194,52,35,32,86,108,534
6990,Paul Egwuonwu,2013,2014,Montana State,Big Sky,57,1594,205,429,205,424,0,5,124,171,91,290,381,65,51,37,101,155,534
6991,Amdy Fall,2014,2016,St. Francis (NY),NEC,93,2001,171,369,171,369,0,0,192,288,175,311,486,50,58,210,121,250,534
6992,Chase Grabau,2011,2012,Idaho State,Big Sky,56,1741,179,369,130,237,49,132,127,177,91,182,273,148,90,23,102,156,534
6993,Keithan Hancock,2008,2009,Northwestern State,Southland,60,1193,180,505,78,188,102,317,72,94,42,69,111,72,63,1,100,107,534
6994,Kaleb Johnson,2016,2019,Georgetown,Big East,124,1892,184,338,155,260,29,78,137,219,122,208,330,98,53,32,96,217,534
6995,Kevin Johnson,2018,2019,Nicholls State,Southland,63,2052,194,505,134,309,60,196,86,110,48,158,206,243,125,5,102,136,534
6996,Kosta Koufos,2008,2008,Ohio State,Big Ten,37,1003,222,437,200,374,22,63,68,100,98,149,247,19,16,67,55,81,534
6997,Robert Owens,2009,2010,San Jose State,WAC,61,1474,171,432,46,118,125,314,67,81,27,83,110,57,25,7,63,79,534
6998,Adrian Satchell,2010,2013,Maryland-Baltimore County,AEC,110,2167,233,504,230,493,3,11,65,140,154,272,426,73,51,35,107,275,534
6999,Mike Smith,2008,2010,Little Rock,Sun Belt,65,1590,203,420,200,407,3,13,125,216,111,231,342,59,36,20,118,174,534
7000,Cervante Burrell,2011,2012,Seattle,Ind,55,1420,195,481,194,465,1,16,142,185,48,117,165,223,72,2,152,89,533
7001,Emanuel Chapman,2011,2014,North Carolina Central,Total,122,3158,194,480,132,299,62,181,83,113,49,296,345,617,173,34,276,184,533
7002,Kyle Clarke,2016,2019,Kennesaw State,A-Sun,117,2281,211,531,210,514,1,17,110,166,62,206,268,213,99,16,216,228,533
7003,Xavier Ford,2012,2015,Buffalo,MAC,104,1474,190,428,171,372,19,56,134,217,155,213,368,42,63,28,113,190,533
7004,Kaiser Gates,2016,2018,Xavier,Big East,97,1813,166,409,59,109,107,300,94,132,92,274,366,58,42,21,57,195,533
7005,Austin Johnson,2010,2013,Rutgers,Big East,126,1913,214,413,214,413,0,0,105,175,108,179,287,62,41,27,131,291,533
7006,Xavier Johnson-Blount,2012,2013,Montana State,Big Sky,48,1363,165,431,110,265,55,166,148,207,48,133,181,78,55,4,85,100,533
7007,Corey Kispert,2018,2019,Gonzaga,WCC,72,1647,190,425,89,148,101,277,52,68,70,192,262,64,34,23,54,108,533
7008,Jack Liles,2008,2009,Youngstown State,Horizon,60,1417,216,421,216,421,0,0,101,178,113,179,292,48,20,61,83,186,533
7009,JayDee Luster,2008,2012,Total,Total,117,2776,146,436,94,241,52,195,189,282,62,180,242,374,97,1,205,273,533
7010,Mike McKee,2008,2010,Kent State,MAC,103,1729,165,449,41,94,124,355,79,111,56,115,171,99,40,6,78,150,533
7011,Ed Morrow,2016,2019,Total,Total,87,1468,225,398,225,398,0,0,83,137,187,242,429,23,25,69,121,204,533
7012,Brandon Murphy,2015,2018,Indiana State,MVC,114,1706,179,354,179,354,0,0,175,285,196,228,424,32,28,48,116,255,533
7013,Paul Reed,2018,2019,DePaul,Big East,63,1205,214,387,196,337,18,50,87,115,121,262,383,43,52,66,75,137,533
7014,Devontae Shuler,2018,2019,Mississippi,SEC,65,1664,193,470,112,227,81,243,66,82,51,173,224,134,88,9,84,83,533
7015,Anthony Thomas,2011,2014,Total,Total,75,1868,217,479,197,395,20,84,79,142,110,209,319,84,47,42,134,146,533
7016,Charles Bain,2018,2019,Robert Morris,NEC,68,1426,192,450,121,243,71,207,77,109,106,156,262,31,34,17,114,140,532
7017,Trivante Bloodman,2013,2015,Mississippi State,SEC,97,2336,152,371,130,280,22,91,206,285,63,153,216,221,92,2,196,183,532
7018,D.J. Boney,2008,2011,Delaware,CAA,122,2465,156,464,63,160,93,304,127,167,98,122,220,101,48,16,102,198,532
7019,Mouhammad Faye,2008,2010,Total,Total,56,1390,187,457,129,282,58,175,100,149,85,189,274,50,34,29,101,108,532
7020,Shai Gilgeous-Alexander,2018,2018,Kentucky,SEC,37,1248,183,377,160,320,23,57,143,175,33,120,153,189,61,18,100,62,532
7021,Mike Green,2016,2017,Northern Arizona,Big Sky,58,1420,187,505,91,237,96,268,62,88,15,121,136,126,43,0,139,64,532
7022,Brandon James,2010,2013,Colgate,Patriot,100,1467,185,441,128,258,57,183,105,144,95,289,384,82,43,20,134,197,532
7023,Warren Jones,2015,2017,Total,Total,50,1113,151,399,79,178,72,221,158,217,15,100,115,98,65,9,70,89,532
7024,Steven Kaspar,2012,2015,Bucknell,Patriot,133,2610,181,442,155,352,26,90,144,252,39,336,375,413,108,34,205,244,532
7025,Asim McQueen,2008,2010,Tulane,CUSA,92,1998,202,453,195,434,7,19,121,173,147,208,355,59,46,36,130,188,532
7026,Jeremy Miller,2016,2019,Northeastern,CAA,105,1490,190,376,134,213,56,163,96,130,96,198,294,39,26,56,62,221,532
7027,Kenny Mitchell,2010,2011,Charleston Southern,Big South,62,1308,212,416,212,408,0,8,108,159,117,180,297,43,49,42,95,173,532
7028,Broderick Newbill,2014,2017,Total,Total,90,1396,199,406,173,323,26,83,108,165,77,148,225,38,51,28,92,125,532
7029,Billy Robinson,2008,2010,Longwood,Ind,90,1571,219,462,209,398,10,64,84,128,121,216,337,43,44,26,105,188,532
7030,Rickey Scott,2011,2014,Arkansas,SEC,100,1628,195,487,170,375,25,112,117,204,48,169,217,163,58,12,94,121,532
7031,Zaire Taylor,2009,2010,Missouri,Big 12,72,1930,175,437,108,246,67,191,115,159,82,140,222,214,118,20,84,175,532
7032,Brian Walsh,2009,2013,Total,Total,96,1731,176,430,88,199,88,231,92,122,69,196,265,94,71,9,64,130,532
7033,Trey Davis,2013,2016,Richmond,A-10,134,3410,200,457,176,364,24,93,107,219,123,460,583,256,123,31,153,318,531
7034,Jordy Kuiper,2014,2018,North Carolina-Greensboro,Southern,125,2164,208,451,155,289,53,162,62,98,166,259,425,76,44,18,102,248,531
7035,Dre Marin,2018,2019,Southern Utah,Big Sky,65,1929,163,382,92,187,71,195,134,167,30,196,226,163,57,10,107,187,531
7036,Larry McKnight,2018,2019,North Carolina Central,MEAC,68,1512,185,448,130,269,55,179,106,149,72,122,194,43,39,8,92,148,531
7037,Jon Montgomery,2008,2011,Total,Total,89,1696,178,546,86,226,92,320,83,111,32,137,169,96,61,5,105,170,531
7038,Jose Perez,2019,2019,Gardner-Webb,Big South,35,1101,176,392,123,253,53,139,126,179,35,164,199,105,27,8,69,62,531
7039,Lafayette Rutledge,2017,2018,Nicholls State,Southland,51,1082,161,409,7,18,154,391,55,70,10,55,65,19,25,0,24,72,531
7040,Jessie Sapp,2008,2009,Georgetown,Big East,65,1697,177,430,78,181,99,249,78,105,57,195,252,160,85,19,125,121,531
7041,Brandon Wiley,2009,2011,Idaho,WAC,68,1788,218,385,216,377,2,8,93,166,121,226,347,82,60,64,115,160,531
7042,Deven Williams,2013,2014,Savannah State,MEAC,58,1003,190,468,103,229,87,239,64,79,14,38,52,48,24,1,76,70,531
7043,Alex Austin,2013,2017,Total,Total,99,1684,176,422,100,188,76,234,102,137,22,173,195,84,59,2,69,130,530
7044,Amidou Bamba,2017,2019,Coastal Carolina,Sun Belt,101,1580,227,404,227,404,0,0,76,153,132,241,373,39,15,66,87,193,530
7045,Larry Bastfield,2009,2012,Total,Total,124,3429,177,526,138,382,39,144,137,214,45,179,224,353,77,7,248,289,530
7046,Folarin Campbell,2008,2008,George Mason,CAA,34,1117,161,384,101,219,60,165,148,202,27,127,154,112,39,16,102,86,530
7047,Bishop Daniels,2013,2016,Total,Total,63,1613,198,503,168,405,30,98,104,147,30,154,184,146,58,28,162,123,530
7048,Deshawn Delaney,2014,2015,New Mexico,MWC,64,1551,207,407,175,316,32,91,84,137,83,213,296,114,62,27,74,101,530
7049,Brian Fitzpatrick,2010,2014,Total,Total,115,1589,206,373,199,357,7,16,111,152,107,243,350,49,11,22,98,165,530
7050,Kinard Gadsden-Gilliard,2013,2014,East Tennessee State,A-Sun,65,1810,185,464,153,365,32,99,128,174,53,242,295,145,54,21,144,198,530
7051,Justin Hammonds,2012,2015,Air Force,MWC,99,1758,196,361,176,311,20,50,118,205,57,257,314,111,64,31,110,248,530
7052,Darnell Harris,2008,2008,La Salle,A-10,32,1063,176,389,53,132,123,257,55,72,6,66,72,65,36,8,36,59,530
7053,Martavious Irving,2010,2013,Kansas State,Big 12,130,2117,190,485,111,261,79,224,71,113,44,135,179,171,72,5,106,174,530
7054,Agunwa Okolie,2013,2016,Harvard,Ivy,105,1997,208,392,201,366,7,26,107,187,120,230,350,101,65,41,109,141,530
7055,Derrick Roland,2008,2010,Texas A&M,Big 12,80,1817,194,450,146,278,48,172,94,141,61,130,191,117,30,21,114,126,530
7056,Ryan Rosburg,2013,2016,Missouri,SEC,127,2106,213,353,213,353,0,0,104,204,142,241,383,40,24,61,92,281,530
7057,Dane Suttle,2009,2012,Pepperdine,WCC,91,1448,175,443,79,191,96,252,84,124,46,131,177,54,28,11,95,107,530
7058,Nate Austin,2012,2016,Brigham Young,WCC,153,2780,205,388,192,339,13,49,106,178,289,503,792,100,77,89,99,425,529
7059,Malik Beasley,2016,2016,Florida State,ACC,34,1014,185,393,130,251,55,142,104,128,44,136,180,51,32,6,59,75,529
7060,Tyrell Corbin,2012,2015,Total,Total,95,1883,151,430,113,299,38,131,189,241,48,151,199,229,84,2,204,100,529
7061,Donavan Foster,2009,2012,Detroit Mercy,Horizon,128,2140,185,499,144,364,41,135,118,186,41,141,182,193,109,7,159,211,529
7062,Byron Fulton,2011,2014,Weber State,Big Sky,102,1463,204,449,129,280,75,169,46,70,63,227,290,39,17,16,65,183,529
7063,Marcus Ginyard,2008,2010,North Carolina,ACC,75,2146,190,450,153,339,37,111,112,171,136,208,344,181,85,7,130,140,529
7064,Demetri Goodson,2009,2011,Gonzaga,WCC,103,2123,191,414,178,350,13,64,134,212,56,158,214,206,73,13,145,202,529
7065,Lucas O'Rear,2008,2011,Northern Iowa,MVC,120,2255,198,354,191,323,7,31,126,200,179,338,517,126,83,30,97,267,529
7066,Adam Teague,2008,2009,Navy,Patriot,60,1585,185,425,59,117,126,308,33,51,62,208,270,72,45,20,79,151,529
7067,Jonah Travis,2012,2015,Harvard,Ivy,113,1492,175,319,175,318,0,1,179,249,153,170,323,42,56,33,85,198,529
7068,Draelon Burns,2008,2008,DePaul,Big East,30,962,173,430,110,248,63,182,119,147,27,74,101,74,51,3,54,54,528
7069,Ezekiel Charles,2018,2019,New Orleans,Southland,54,1380,180,404,87,180,93,224,75,102,67,170,237,68,43,19,62,79,528
7070,LaDavius Draine,2018,2019,Southern Mississippi,CUSA,61,1098,189,394,81,151,108,243,42,60,45,137,182,26,20,4,20,108,528
7071,Jamell Harris,2010,2013,Eastern Michigan,MAC,128,2697,203,442,202,439,1,3,121,232,177,359,536,60,78,167,136,296,528
7072,Jeremy Jacob,2008,2012,Total,Total,89,1493,219,477,218,473,1,4,89,142,106,233,339,28,21,15,78,151,528
7073,Jayrn Johnson,2015,2016,Prairie View,SWAC,64,1207,181,454,116,273,65,181,101,133,33,77,110,49,79,23,73,138,528
7074,Chris Kellermann,2008,2010,Central Michigan,MAC,68,1123,177,422,99,187,78,235,96,129,98,154,252,31,30,15,72,167,528
7075,Cody Kelley,2017,2019,Total,Total,93,2027,173,440,69,158,104,282,78,110,31,183,214,231,75,4,122,195,528
7076,Romeo Langford,2019,2019,Indiana,Big Ten,32,1091,177,395,143,270,34,125,140,194,45,127,172,75,25,26,68,60,528
7077,Grant Lozoya,2015,2016,Stetson,A-Sun,62,1374,190,472,110,208,80,264,68,95,8,172,180,83,47,6,95,182,528
7078,Jamuni McNeace,2016,2019,Oklahoma,Big 12,120,1721,223,385,223,384,0,1,82,165,126,305,431,28,32,117,106,266,528
7079,Tevin Prescott,2013,2017,Winthrop,Big South,100,1807,214,365,214,364,0,1,100,176,149,186,335,22,61,47,66,252,528
7080,Steve Rossiter,2008,2010,Davidson,Southern,102,2058,193,364,187,342,6,22,136,208,183,325,508,141,90,46,111,277,528
7081,Calvin Williams,2008,2009,Southeast Missouri State,OVC,50,1149,186,372,182,362,4,10,152,232,99,222,321,37,36,71,122,125,528
7082,Mike Allison,2010,2013,Maine,AEC,109,2107,196,397,194,385,2,12,133,209,176,340,516,25,33,134,85,234,527
7083,Jair Bolden,2017,2018,George Washington,A-10,67,1671,190,520,108,266,82,254,65,97,28,131,159,164,40,18,128,99,527
7084,David Booker,2009,2011,Tulane,CUSA,89,1756,183,413,159,325,24,88,137,207,126,181,307,32,55,20,90,215,527
7085,Coy Custer,2008,2011,Lamar,Southland,101,1527,190,369,176,325,14,44,133,203,151,198,349,49,26,93,96,213,527
7086,Anthony Dallier,2014,2017,Yale,Ivy,111,2097,169,437,99,229,70,208,119,174,54,233,287,198,63,15,121,170,527
7087,Kyle Duncan,2008,2009,Austin Peay,OVC,68,1765,189,395,96,188,93,207,56,89,81,154,235,85,72,14,83,188,527
7088,Austin Hill,2010,2011,Illinois State,MVC,61,1253,197,431,175,358,22,73,111,151,30,108,138,94,34,7,116,122,527
7089,Chad Holley,2014,2015,Massachusetts-Lowell,AEC,55,1827,149,425,77,206,72,219,157,203,10,128,138,161,50,2,108,130,527
7090,Dale Hughes,2009,2012,Total,Total,63,549,174,476,58,150,116,326,63,95,23,59,82,39,32,1,82,80,527
7091,JR Inman,2008,2009,Rutgers,Big East,61,1658,197,480,163,374,34,106,99,151,107,258,365,43,30,36,123,128,527
7092,Brady Jardine,2009,2012,Utah State,WAC,94,1512,208,393,207,391,1,2,110,171,155,330,485,55,41,70,95,184,527
7093,Charles Little,2008,2009,Dayton,A-10,65,1500,208,418,208,417,0,1,111,207,116,166,282,73,25,17,90,134,527
7094,Anas Mahmoud,2015,2018,Louisville,ACC,119,1945,227,407,227,407,0,0,73,155,152,259,411,85,71,218,112,215,527
7095,David Marek,2008,2009,Southern Utah,Summit,61,1981,169,357,85,152,84,205,105,133,17,89,106,202,52,1,128,136,527
7096,Josh Martin,2015,2019,Total,Total,88,1811,174,461,123,312,51,149,128,215,105,390,495,92,29,50,130,180,527
7097,Joe Mooney,2017,2019,UC-Davis,Big West,75,1539,180,453,74,160,106,293,61,79,22,112,134,72,55,6,71,117,527
7098,DeLuis Ramirez,2008,2009,Sam Houston State,Southland,61,1571,203,415,194,363,9,52,112,174,127,179,306,106,57,8,139,123,527
7099,Austin Rivers,2012,2012,Duke,ACC,34,1129,174,402,116,243,58,159,121,184,21,94,115,71,33,1,79,76,527
7100,Marcus Sheffield,2016,2019,Stanford,Pac-12,86,1467,173,452,103,253,70,199,111,143,24,120,144,92,52,7,89,111,527
7101,Kevin Smith,2008,2011,Richmond,A-10,134,3044,193,401,172,324,21,77,120,194,117,300,417,299,130,72,183,323,527
7102,Nigel Spikes,2010,2013,Marshall,CUSA,122,2170,183,353,183,352,0,1,161,310,233,397,630,41,61,123,112,302,527
7103,Deshaun Sunderhaus,2013,2015,Seattle,WAC,56,1204,213,411,206,388,7,23,94,139,129,189,318,43,23,50,95,150,527
7104,Aaron Armstead,2012,2015,Total,Total,91,1661,179,465,108,249,71,216,97,129,53,136,189,59,56,10,97,187,526
7105,Charles Glover,2015,2018,Total,Total,116,2043,168,443,77,183,91,260,99,137,19,210,229,122,66,8,154,221,526
7106,Travis King,2008,2011,Total,Total,89,1722,187,425,108,218,79,207,73,106,30,156,186,112,75,9,111,135,526
7107,Robert Mansell,2011,2014,Binghamton,AEC,66,1476,169,462,132,339,37,123,151,207,38,114,152,62,35,10,112,87,526
7108,Darryl Merthie,2008,2010,Marshall,CUSA,94,1764,169,497,100,257,69,240,119,182,40,149,189,214,81,6,141,166,526
7109,Oskar Michelsen,2015,2018,Davidson,A-10,119,1829,174,445,61,109,113,336,65,92,50,176,226,92,35,25,61,205,526
7110,Pete Miller,2014,2017,Princeton,Ivy,118,1911,224,428,223,427,1,1,77,166,138,286,424,136,43,103,126,232,526
7111,Keith Stone,2017,2019,Florida,SEC,85,1553,176,415,107,240,69,175,105,154,103,185,288,52,45,45,93,171,526
7112,Devonta Walker,2015,2016,Louisiana,Sun Belt,70,1204,175,339,171,326,4,13,172,225,131,199,330,51,38,23,103,136,526
7113,Brian Benson,2009,2012,New Hampshire,AEC,105,2185,199,438,158,313,41,125,86,179,218,407,625,21,35,77,100,241,525
7114,Staphon Blair,2013,2016,Central Florida,Total,118,1776,214,368,214,367,0,1,97,177,149,210,359,9,21,112,91,222,525
7115,Anthony D'Orazio,2011,2015,Total,Total,127,2075,200,506,126,274,74,232,51,97,65,212,277,144,102,20,100,185,525
7116,Dionte Ferguson,2011,2015,Total,Total,97,1453,178,337,178,335,0,2,169,250,149,198,347,27,41,71,113,179,525
7117,James Gist,2008,2008,Maryland,ACC,33,1056,194,391,172,320,22,71,115,156,60,200,260,45,42,77,90,101,525
7118,Zach Hanson,2014,2017,Creighton,Big East,109,1190,218,347,218,345,0,2,89,146,112,142,254,15,23,44,80,195,525
7119,Michael Lee,2008,2008,St. Bonaventure,A-10,30,1088,193,397,161,313,32,84,107,152,68,172,240,43,44,16,86,64,525
7120,Johnny Mayhane,2008,2011,Tulane,CUSA,115,1716,181,507,82,212,99,295,64,92,39,142,181,87,37,7,112,105,525
7121,Jeffery McClain,2009,2011,Murray State,OVC,99,2142,174,331,173,328,1,3,176,264,187,271,458,78,79,19,124,208,525
7122,Frank Otis,2009,2013,Total,Total,107,1808,219,362,219,362,0,0,87,158,138,285,423,106,70,31,140,223,525
7123,Devonne Pinkard,2014,2017,Delaware,CAA,118,2389,174,519,71,182,103,337,74,111,71,250,321,77,36,23,79,267,525
7124,Franklin Porter,2016,2019,Total,WCC,86,1768,182,433,120,262,62,171,99,136,29,223,252,123,42,18,113,149,525
7125,Tracy Rankins,2009,2010,Savannah State,Ind,52,1389,170,453,106,258,64,195,121,167,28,82,110,84,35,3,107,62,525
7126,Maurice Strong,2014,2015,Alabama State,SWAC,61,1670,203,452,203,448,0,4,119,213,154,285,439,56,39,56,109,170,525
7127,Xavier Talton,2013,2016,Colorado,Pac-12,135,2417,171,475,89,245,82,230,101,134,34,208,242,190,72,12,152,221,525
7128,Andre Walker,2008,2012,Total,Total,120,2527,212,442,207,424,5,18,96,159,181,325,506,227,79,79,147,262,525
7129,D.J. Williams,2016,2019,Total,Total,77,1509,199,494,167,378,32,116,95,147,44,159,203,54,31,18,92,79,525
7130,Kendal Williams,2014,2015,Delaware State,MEAC,63,1634,188,477,120,298,68,179,81,108,39,114,153,177,35,1,95,110,525
7131,Kevin Baker,2017,2018,Troy,Sun Belt,70,1712,151,494,34,110,117,384,105,149,20,159,179,216,67,0,125,140,524
7132,Lonzo Ball,2017,2017,UCLA,Pac-12,36,1263,189,343,109,149,80,194,66,98,33,183,216,274,66,28,89,65,524
7133,Donovon Jack,2013,2016,Penn State,Big Ten,117,1671,193,415,159,297,34,118,104,164,114,217,331,42,35,100,69,309,524
7134,Brandon Johnson,2017,2018,Western Michigan,MAC,61,1524,211,423,199,382,12,41,90,146,131,213,344,43,25,35,67,156,524
7135,Lukas Meisner,2016,2018,Columbia,Ivy,75,1525,193,405,107,187,86,218,52,92,90,309,399,84,25,37,95,172,524
7136,Anthony Minor,2008,2011,Hartford,AEC,121,2052,218,373,216,364,2,9,86,181,128,174,302,135,94,48,142,348,524
7137,Marcus Palmer,2008,2009,Central Connecticut State,NEC,58,1449,196,412,157,308,39,104,93,120,79,232,311,58,27,18,80,99,524
7138,Geoff Reeves,2008,2010,Cornell,Ivy,90,1682,188,413,81,165,107,248,41,49,43,98,141,86,52,13,77,129,524
7139,Joey van Zegeren,2012,2016,Total,Total,104,1711,216,396,216,394,0,2,92,233,180,218,398,21,33,113,117,269,524
7140,Tavaris Washington,2009,2010,Arkansas-Pine Bluff,SWAC,64,1687,202,353,197,319,5,34,115,194,94,183,277,113,114,36,193,191,524
7141,Kevin Brown,2011,2015,Total,Total,85,1588,164,457,74,197,90,260,105,148,29,109,138,86,67,7,103,148,523
7142,Daniel Bryant,2009,2011,Arkansas State,Sun Belt,60,1052,182,473,94,211,88,262,71,110,25,97,122,101,46,1,93,120,523
7143,Jay Copeland,2011,2016,Total,Total,79,1613,187,343,187,343,0,0,149,240,168,208,376,16,46,48,114,247,523
7144,Dwayne Curtis,2008,2008,Mississippi,SEC,35,1089,212,335,212,335,0,0,99,147,154,183,337,35,28,10,58,82,523
7145,Russell Hicks,2008,2009,Florida International,Sun Belt,48,1075,212,415,211,414,1,1,98,157,118,160,278,24,14,91,82,142,523
7146,Green Hill,2012,2014,Alabama A&M,SWAC,89,1896,158,406,133,317,25,89,182,244,61,109,170,178,69,0,145,186,523
7147,Stanley Johnson,2015,2015,Arizona,Pac-12,38,1081,174,390,131,274,43,116,132,178,75,172,247,63,57,15,82,100,523
7148,Jelan Kendrick,2012,2015,Total,Total,82,1882,194,490,147,349,47,141,88,150,39,212,251,170,70,20,125,132,523
7149,Mark Lohuis,2008,2010,Stetson,A-Sun,91,2148,176,521,46,124,130,397,41,48,87,203,290,90,64,16,85,230,523
7150,Kendall Marshall,2011,2012,North Carolina,ACC,73,2101,181,406,133,275,48,131,113,163,12,159,171,581,83,9,193,106,523
7151,Kelvin McNeil,2010,2013,Total,Total,114,2229,194,454,189,420,5,34,130,249,157,414,571,72,42,19,130,244,523
7152,Shane Rector,2014,2017,Total,Total,84,1488,175,415,134,289,41,126,132,184,24,126,150,170,70,15,134,138,523
7153,Ryan Reid,2008,2010,Florida State,ACC,91,1976,195,404,194,403,1,1,132,209,167,210,377,77,59,55,168,182,523
7154,Tanner Schmit,2016,2019,Central Arkansas,Southland,125,1669,221,533,196,450,25,83,56,84,89,188,277,44,27,34,72,251,523
7155,David Simmons,2008,2012,Central Connecticut State,NEC,96,2093,208,367,208,367,0,0,107,208,189,286,475,50,89,22,108,198,523
7156,Lance Thomas,2008,2010,Duke,ACC,109,2295,189,367,189,367,0,0,145,241,220,212,432,63,60,30,123,313,523
7157,Quintrell Thomas,2009,2013,Total,Total,124,1432,182,350,182,350,0,0,159,240,170,265,435,28,24,72,93,216,523
7158,Kirk Williams,2008,2008,Longwood,Ind,31,1017,195,438,159,321,36,117,97,152,69,131,200,72,53,12,109,101,523
7159,Monty Brown,2011,2014,Mercer,A-Sun,132,1332,180,333,180,333,0,0,162,234,117,175,292,26,13,62,111,222,522
7160,Jordan Bruner,2017,2019,Yale,Ivy,56,1399,199,390,165,271,34,119,90,130,106,283,389,120,39,101,95,105,522
7161,T.J. Carter,2008,2008,North Carolina-Wilmington,CAA,33,1061,173,403,140,278,33,125,143,167,55,126,181,135,44,14,93,91,522
7162,Jarvis Davis,2011,2015,Total,Total,104,1449,165,397,86,175,79,222,113,131,38,151,189,74,64,3,96,123,522
7163,Ryan Howley,2010,2013,UC-Davis,Big West,107,2322,208,433,158,272,50,161,56,107,125,371,496,110,56,26,108,201,522
7164,Josh Hunter,2009,2010,Appalachian State,Southern,68,1585,178,351,177,344,1,7,165,274,162,272,434,84,38,11,120,182,522
7165,Rashann London,2015,2019,Total,Total,84,2228,199,545,155,382,44,163,80,123,40,131,171,172,36,5,143,160,522
7166,Eric McGill,2016,2019,Total,Total,67,1847,185,447,110,240,75,207,77,132,54,207,261,136,101,2,94,117,522
7167,Zavion Neely,2009,2011,Illinois-Chicago,Horizon,55,1384,188,483,163,394,25,89,121,163,30,76,106,88,71,6,83,127,522
7168,Marcus Roper,2015,2016,Tennessee State,OVC,60,1245,175,453,71,148,104,305,68,99,28,104,132,32,41,15,57,96,522
7169,Marreese Speights,2008,2008,Florida,SEC,36,874,216,346,216,346,0,0,90,130,93,197,290,34,15,49,62,82,522
7170,Carlos Anderson,2016,2017,Southern Illinois-Edwardsville,OVC,58,1635,184,480,145,332,39,148,114,162,54,170,224,108,49,4,113,132,521
7171,Jordan Blount,2018,2019,Illinois-Chicago,Horizon,66,1635,214,429,195,339,19,90,74,115,105,309,414,140,77,27,174,238,521
7172,Greg Bowie,2018,2019,Texas-Rio Grande Valley,WAC,64,1444,179,462,89,210,90,252,73,97,28,115,143,79,47,3,97,109,521
7173,Dwayne Brown Jr.,2018,2019,Utah State,MWC,69,1298,197,413,153,274,44,139,83,114,72,184,256,68,39,12,95,141,521
7174,Dwight Buycks,2010,2011,Marquette,Big East,68,1769,194,438,140,288,54,150,79,115,52,155,207,189,75,3,137,109,521
7175,Tim Clifford,2008,2008,Holy Cross,Patriot,29,928,205,359,191,317,14,42,97,124,85,73,158,35,21,67,73,100,521
7176,Tobias Harris,2011,2011,Tennessee,SEC,34,993,185,402,162,326,23,76,128,170,67,180,247,44,24,29,62,70,521
7177,Calvin Henry,2008,2009,Mercer,A-Sun,52,1644,190,393,164,332,26,61,115,150,94,283,377,120,37,116,123,82,521
7178,Brook Lopez,2008,2008,Stanford,Pac-10,27,831,184,393,184,387,0,6,153,194,77,144,221,37,16,56,58,66,521
7179,Brandon Moore,2010,2011,Mercer,A-Sun,55,1233,188,364,176,329,12,35,133,218,99,184,283,53,41,40,106,142,521
7180,C.J. Neumann,2013,2016,Wofford,Southern,129,2662,197,375,194,365,3,10,124,186,196,342,538,82,64,26,99,274,521
7181,Jalen Pickett,2019,2019,Siena,MAAC,33,1225,184,421,119,234,65,187,88,118,43,109,152,221,65,29,80,77,521
7182,Bryant Rucker,2013,2016,Denver,Total,101,1752,180,367,109,195,71,172,90,121,13,127,140,126,49,2,97,152,521
7183,Naadir Tharpe,2012,2014,Kansas,Big 12,103,1892,175,457,91,215,84,242,87,104,15,123,138,304,55,0,143,149,521
7184,Mike Tuitt,2010,2012,Hampton,MEAC,88,1880,170,442,143,327,27,115,154,280,63,148,211,262,107,6,184,168,521
7185,Nate Grimes,2017,2019,Fresno State,MWC,73,1240,219,369,215,352,4,17,78,136,158,309,467,29,35,87,75,142,520
7186,Dominique Lee,2014,2015,Northern Colorado,Big Sky,61,1272,201,324,190,298,11,26,107,179,134,206,340,37,58,42,57,158,520
7187,Mike Myers,2015,2015,Maryland-Eastern Shore,MEAC,33,871,169,285,168,279,1,6,181,282,87,145,232,45,39,12,105,111,520
7188,Justin Baker,2010,2011,Utah Valley,GWC,59,1250,201,393,190,364,11,29,106,149,122,172,294,33,20,35,92,185,519
7189,Jibri Blount,2016,2019,Total,Total,83,1458,189,402,161,308,28,94,113,167,89,175,264,69,69,28,140,165,519
7190,Donnie Carson,2008,2010,Idaho State,Big Sky,90,1895,197,523,180,458,17,65,108,156,114,160,274,98,66,34,101,161,519
7191,Joe Coleman,2012,2015,Total,Total,73,1623,190,408,179,370,11,38,128,181,76,160,236,94,60,18,121,108,519
7192,Tyler Herro,2019,2019,Kentucky,SEC,37,1207,186,403,126,234,60,169,87,93,15,151,166,92,40,12,60,47,519
7193,Jayon James,2011,2014,Total,Total,66,1814,199,460,195,418,4,42,117,233,67,270,337,267,74,31,213,165,519
7194,Aleks Maric,2008,2008,Nebraska,Big 12,33,968,191,332,190,326,1,6,136,207,131,204,335,64,44,57,79,80,519
7195,Walter Pitchford,2012,2015,Total,Total,75,1576,192,454,107,206,85,248,50,82,66,226,292,31,22,33,49,158,519
7196,JaJuan Smith,2008,2008,Tennessee,SEC,36,992,174,377,81,134,93,243,78,102,26,108,134,81,61,1,61,88,519
7197,Jannson Williams,2018,2019,Marshall,CUSA,71,1462,175,384,86,147,89,237,80,107,74,228,302,22,40,97,47,150,519
7198,Connor Atchley,2008,2009,Texas,Big 12,72,1669,194,396,131,220,63,176,67,92,116,191,307,45,49,125,61,186,518
7199,Landon Atterberry,2014,2015,Long Island University,NEC,56,1236,209,444,175,341,34,103,66,110,79,158,237,20,28,24,65,141,518
7200,Tyrone Brazelton,2008,2008,Western Kentucky,Sun Belt,36,986,174,389,105,228,69,161,101,150,21,78,99,134,39,2,101,108,518
7201,Josh Cleveland,2011,2014,Texas-Rio Grande Valley,Total,121,1809,206,413,206,413,0,0,106,219,146,166,312,55,35,44,112,282,518
7202,Hallice Cooke,2014,2018,Total,Total,101,1935,174,395,71,163,103,232,67,90,16,175,191,165,58,10,89,169,518
7203,Reggie Fuller,2008,2009,Binghamton,AEC,61,1737,206,344,205,341,1,3,105,151,145,244,389,54,56,90,78,173,518
7204,Jordan Garnett,2015,2018,Northern Kentucky,Total,112,2401,179,393,115,228,64,165,96,138,120,197,317,148,70,32,100,247,518
7205,Marcellus Garrick,2018,2019,Cal Poly,Big West,56,1249,173,446,86,202,87,244,85,110,29,97,126,32,26,2,46,80,518
7206,Hector Harold,2011,2015,Total,Total,107,1669,184,488,118,273,66,215,84,137,49,207,256,66,40,38,122,204,518
7207,Matt Hodgson,2010,2014,Total,Total,124,1731,200,366,197,354,3,12,115,182,138,257,395,27,25,156,154,287,518
7208,Elijah Macon,2015,2017,West Virginia,Big 12,103,1456,203,393,203,393,0,0,112,210,144,195,339,65,30,45,103,207,518
7209,Xavier McDaniel Jr.,2017,2018,Texas-Rio Grande Valley,WAC,64,1234,185,477,131,312,54,165,94,130,78,187,265,57,36,37,89,180,518
7210,Chamberlain Oguchi,2009,2009,Illinois State,MVC,34,1076,162,394,72,165,90,229,104,127,34,151,185,44,34,14,52,86,518
7211,Jordan Stevens,2010,2013,Holy Cross,Patriot,105,1997,190,494,106,252,84,242,54,85,72,135,207,149,46,19,105,144,518
7212,Jay Brown,2008,2009,Lamar,Southland,55,1062,194,404,172,328,22,76,107,154,93,231,324,55,34,78,86,136,517
7213,Drew Buggs,2018,2019,Hawaii,Big West,61,1764,189,435,153,313,36,122,103,149,73,171,244,276,74,12,135,157,517
7214,Brent Calhoun,2014,2017,Purdue-Fort Wayne,Summit,98,1396,225,426,224,424,1,2,66,107,124,273,397,62,25,109,135,222,517
7215,Chris Dixon,2013,2014,North Carolina-Wilmington,CAA,61,1561,181,486,124,288,57,198,98,138,30,157,187,161,46,4,139,98,517
7216,Djimon Henson,2017,2019,Morehead State,OVC,84,1586,182,509,87,225,95,284,58,78,45,119,164,56,19,14,64,104,517
7217,Jalyn Hinton,2018,2019,Jacksonville,A-Sun,64,1461,215,343,215,343,0,0,87,166,99,229,328,55,46,91,60,117,517
7218,Marsharee Neely,2008,2010,Old Dominion,CAA,95,1470,199,496,130,290,69,206,50,83,62,170,232,94,54,9,83,86,517
7219,Matt Nelson,2008,2008,Boise State,WAC,33,971,202,312,202,311,0,1,113,181,82,159,241,70,21,8,74,98,517
7220,Billy Reader,2011,2015,Total,Total,86,1431,217,417,216,415,1,2,82,123,137,173,310,51,20,45,88,195,517
7221,Ramell Taylor,2011,2012,Southern Utah,Summit,58,1351,208,454,201,429,7,25,94,142,83,139,222,52,24,29,141,130,517
7222,Michael Teller,2009,2011,Lipscomb,A-Sun,90,1942,178,492,59,148,119,344,42,74,88,215,303,115,69,9,62,123,517
7223,Rashad West,2008,2008,Hampton,MEAC,30,945,160,421,98,227,62,194,135,187,20,73,93,86,39,0,102,49,517
7224,Justin Crosgile,2010,2014,Total,Total,71,1571,168,485,69,183,99,302,81,113,51,151,202,147,58,0,135,93,516
7225,Romeo Garcia,2008,2011,Navy,Patriot,96,2491,172,455,114,257,58,198,114,162,122,254,376,142,91,47,113,260,516
7226,Collin Gillespie,2018,2019,Villanova,Big East,67,1490,156,372,54,106,102,266,102,123,16,109,125,131,58,4,66,139,516
7227,Randall Hanke,2008,2009,Providence,Big East,62,1037,218,339,218,339,0,0,80,107,101,128,229,10,15,48,61,119,516
7228,Frankie Hughes,2017,2019,Total,Total,62,1389,171,535,54,147,117,388,57,96,33,114,147,85,51,10,77,87,516
7229,Killian Larson,2014,2014,Grand Canyon,WAC,30,980,180,333,179,330,1,3,155,210,115,233,348,24,14,6,76,96,516
7230,Chris Mast,2011,2012,Texas A&M-Corpus Christi,Southland,57,1501,188,452,168,358,20,94,120,193,89,159,248,59,40,11,125,132,516
7231,Charlie Moore,2017,2019,Total,Total,69,1438,171,474,106,271,65,203,109,145,20,82,102,164,58,2,130,124,516
7232,Cale Nelson,2008,2009,Saint Francis (PA),NEC,58,1895,166,488,64,173,102,315,82,103,22,78,100,259,51,1,184,131,516
7233,Jean-Paul Olukemi,2011,2013,Oklahoma State,Big 12,49,1147,153,345,129,266,24,79,186,244,63,144,207,44,42,8,87,116,516
7234,Terrence Samuel,2014,2018,Total,Total,125,2362,162,393,143,325,19,68,173,226,55,253,308,221,81,2,157,133,516
7235,Jamari Traylor,2013,2016,Kansas,Big 12,143,2122,197,370,197,370,0,0,122,193,167,297,464,88,82,126,159,303,516
7236,Chad Jackson,2013,2015,Northern Kentucky,A-Sun,57,1581,187,362,187,353,0,9,141,223,104,211,315,113,65,13,118,163,515
7237,Jordan Jackson,2014,2016,Total,Total,80,1319,165,354,158,320,7,34,178,268,42,159,201,133,61,26,110,115,515
7238,Andrew Jones,2017,2019,Texas,Big 12,45,1157,171,386,109,210,62,176,111,145,19,137,156,138,48,16,99,89,515
7239,Quinterian McConico,2016,2017,Alabama A&M,SWAC,46,1178,224,375,223,372,1,3,66,108,76,199,275,24,13,20,61,102,515
7240,Yanick Moreira,2014,2015,Southern Methodist,AAC,57,1138,197,365,197,365,0,0,121,187,106,203,309,42,29,53,84,91,515
7241,Jason Morris,2011,2014,Georgia Tech,ACC,89,1651,185,507,119,311,66,196,79,115,61,172,233,60,45,26,123,152,515
7242,Gavin Peppers,2018,2019,Total,Total,58,1212,166,410,89,198,77,212,106,120,26,86,112,92,38,3,84,83,515
7243,Kris Thomas,2008,2009,Stetson,A-Sun,61,1506,187,486,118,266,69,220,72,123,26,141,167,58,81,29,91,124,515
7244,Christian Wilson,2015,2016,Texas-San Antonio,CUSA,49,1180,159,446,134,334,25,112,172,252,35,109,144,147,55,7,96,100,515
7245,Charles Wilson-Fisher,2015,2018,Hampton,MEAC,114,1575,211,413,202,374,9,39,84,123,163,277,440,38,33,66,114,272,515
7246,Will Yeguete,2011,2014,Florida,SEC,127,2347,189,383,184,358,5,25,132,238,211,415,626,110,117,28,124,232,515
7247,Stephen Albrecht,2010,2013,Total,Total,55,1418,177,485,65,186,112,299,48,74,14,130,144,98,38,7,83,68,514
7248,Charles Callison,2016,2017,Washington State,Pac-12,58,1514,194,455,128,281,66,174,60,80,14,83,97,148,69,14,96,131,514
7249,Trey Dickerson,2015,2018,Total,Total,76,1268,179,444,130,289,49,155,107,160,17,97,114,170,50,4,114,136,514
7250,DeAndre Dishman,2017,2019,Total,Total,58,1318,195,334,195,333,0,1,124,203,107,200,307,52,47,35,84,124,514
7251,Corey Godzinski,2008,2010,Wofford,Southern,87,1668,191,434,129,227,62,207,70,105,44,165,209,78,40,23,61,138,514
7252,Matt Haarms,2018,2019,Purdue,Big Ten,73,1455,204,332,196,300,8,32,98,154,98,214,312,64,19,153,74,182,514
7253,Brandon Randolph,2018,2019,Arizona,Pac-12,63,1284,183,477,129,299,54,178,94,122,27,104,131,58,34,13,63,112,514
7254,Frank Rogers,2013,2016,Total,Total,68,1357,187,416,139,274,48,142,92,146,99,225,324,65,33,37,95,184,514
7255,Steve Rogers,2015,2018,Alabama State,SWAC,107,1974,163,508,70,209,93,299,95,136,49,111,160,98,49,9,98,181,514
7256,Mark Sanchez,2008,2009,Boise State,WAC,65,1220,201,398,181,343,20,55,92,134,88,222,310,94,20,29,89,83,514
7257,Shaquille White-Miller,2011,2014,Texas-Arlington,Total,121,2745,152,476,97,294,55,182,155,226,50,157,207,455,76,1,294,201,514
7258,Victor Bailey Jr.,2018,2019,Oregon,Pac-12,73,1305,173,417,94,211,79,206,88,99,37,99,136,65,39,5,60,83,513
7259,Jibri Bryan,2012,2016,Mercer,Total,102,1706,164,441,72,161,92,280,93,130,56,231,287,69,72,10,86,168,513
7260,Marcus Bryan,2014,2018,Total,Total,130,2092,200,443,199,442,1,1,112,197,192,330,522,62,35,70,84,253,513
7261,Laron Buggs,2011,2012,Gardner-Webb,Big South,64,1614,167,434,129,309,38,125,141,210,44,137,181,113,66,6,121,138,513
7262,Gary Franklin,2011,2014,Total,Total,115,2105,163,483,44,121,119,362,68,101,16,107,123,185,53,3,116,151,513
7263,John Gage,2011,2014,Stanford,Total,121,1305,169,415,54,118,115,297,60,72,62,129,191,31,34,27,58,152,513
7264,William Graves,2008,2010,North Carolina,ACC,92,1284,173,454,71,177,102,277,65,83,96,174,270,62,35,12,67,112,513
7265,Garrett Green,2008,2012,Total,Total,121,1793,210,450,201,418,9,32,84,189,163,269,432,43,42,43,114,221,513
7266,Dejan Kravic,2013,2014,Texas Tech,Big 12,63,1345,213,417,212,415,1,2,86,137,130,178,308,63,36,82,94,115,513
7267,Javon McKay,2011,2015,Tennessee Tech,OVC,121,2077,171,378,146,282,25,96,146,199,125,204,329,111,72,49,118,237,513
7268,Chris McNeal,2016,2018,Total,Total,68,1765,159,453,69,155,90,298,105,144,27,170,197,227,45,1,131,117,513
7269,Sterling Melville,2009,2012,Colgate,Patriot,103,1466,170,363,156,312,14,51,159,280,80,157,237,63,54,23,120,171,513
7270,Ibrahim Sylla,2016,2019,Total,Total,94,1414,206,367,206,367,0,0,101,205,135,244,379,22,48,85,104,238,513
7271,Terry Bembry,2009,2012,Total,Total,67,1431,200,453,200,453,0,0,112,222,107,214,321,38,41,28,88,141,512
7272,Kevin Bland,2008,2009,UC-Irvine,Big West,65,1727,209,437,189,367,20,70,74,109,85,322,407,120,81,15,105,226,512
7273,Bam Bowman,2018,2019,Miami (OH),MAC,65,1299,181,397,132,250,49,147,101,139,101,184,285,30,22,21,64,157,512
7274,Lafayette Dorsey,2018,2019,Pacific,WCC,56,1041,175,411,125,253,50,158,112,131,23,128,151,47,28,4,84,105,512
7275,J'hared Hall,2009,2012,Loyola (MD),MAAC,107,1318,174,420,81,175,93,245,71,97,31,93,124,60,49,19,92,98,512
7276,Cameron Healy,2019,2019,Albany (NY),AEC,32,1103,166,392,62,142,104,250,76,86,11,110,121,78,22,3,70,54,512
7277,Emmitt Holt,2015,2019,Total,Total,68,1248,190,351,169,288,21,63,111,174,94,165,259,37,29,47,58,153,512
7278,Xavier Johnson,2019,2019,Pittsburgh,ACC,33,1028,159,383,122,278,37,105,157,209,38,90,128,149,43,4,132,89,512
7279,Jimbo Lull,2017,2019,San Francisco,WCC,94,1338,210,358,206,332,4,26,88,124,117,220,337,45,20,41,90,192,512
7280,Danny Nieman,2010,2012,Coastal Carolina,Big South,87,2314,178,427,103,222,75,205,81,134,39,199,238,244,74,2,127,134,512
7281,Omar Sanders,2011,2012,South Carolina State,MEAC,59,1406,200,412,185,347,15,65,97,179,149,226,375,36,27,79,103,127,512
7282,D.J. Stephens,2010,2013,Memphis,CUSA,129,1703,207,330,190,284,17,46,81,128,159,277,436,45,65,150,49,163,512
7283,Marcus Van,2008,2009,Central Michigan,MAC,56,1285,197,379,197,379,0,0,118,206,155,218,373,10,26,70,70,146,512
7284,Brandon Walters,2017,2018,Middle Tennessee,CUSA,66,1110,212,334,211,328,1,6,87,122,141,139,280,25,32,49,73,200,512
7285,Tamas Bruce,2017,2018,Arkansas State,Sun Belt,62,1170,210,372,210,371,0,1,91,175,153,203,356,20,46,44,81,210,511
7286,Dontae Caldwell,2016,2019,Maryland-Eastern Shore,MEAC,87,1584,184,460,119,250,65,210,78,115,70,220,290,68,50,22,103,159,511
7287,Devin Coleman,2012,2016,Total,Total,92,1488,185,498,91,232,94,266,47,72,49,152,201,64,37,8,58,81,511
7288,Oscar Da Silva,2018,2019,Stanford,Pac-12,66,1722,189,390,132,226,57,164,76,115,99,250,349,96,37,70,115,177,511
7289,Joe Eberhard,2012,2013,Sacramento State,Big Sky,57,1930,176,391,101,213,75,178,84,111,85,231,316,79,33,10,68,114,511
7290,Igor Hadziomerovic,2012,2015,Boise State,MWC,109,2365,184,456,141,316,43,140,100,161,75,229,304,219,67,14,150,198,511
7291,Jon Horford,2011,2015,Total,Total,138,1706,205,393,191,332,14,61,87,119,152,312,464,42,32,89,66,238,511
7292,Chief Kickingstallionsims,2008,2009,Alabama State,SWAC,63,1148,218,363,218,363,0,0,75,136,70,169,239,19,9,120,85,168,511
7293,Maliik Love,2011,2015,Cal Poly,Big West,125,2567,188,445,173,396,15,49,120,203,130,156,286,210,71,16,133,176,511
7294,Doug Scott,2008,2010,Southern,SWAC,80,1910,182,439,160,347,22,92,125,222,140,322,462,97,47,35,143,157,511
7295,Darrell Arthur,2008,2008,Kansas,Big 12,40,989,214,394,212,382,2,12,80,114,92,158,250,33,20,53,75,118,510
7296,Diogo Brito,2017,2019,Utah State,MWC,87,1786,179,411,112,216,67,195,85,131,49,235,284,151,72,7,112,122,510
7297,Chaz Glotta,2015,2018,Total,Total,82,1345,172,453,49,98,123,355,43,66,6,86,92,70,32,5,62,127,510
7298,Mark Henniger,2011,2014,Kent State,MAC,123,1858,179,327,179,323,0,4,152,219,192,177,369,32,34,64,91,292,510
7299,Keaton Jackson,2014,2015,Southern Illinois-Edwardsville,OVC,59,1132,202,313,200,310,2,3,104,161,132,190,322,26,17,123,82,201,510
7300,Tim Pollitz,2008,2008,Miami (OH),MAC,33,1171,215,402,209,384,6,18,74,111,78,156,234,101,39,18,91,84,510
7301,Jabbar Singleton,2014,2018,Total,Total,127,2688,157,449,58,172,99,277,97,155,26,143,169,255,72,3,158,165,510
7302,Kyle Williams,2017,2018,Norfolk State,MEAC,65,1485,169,430,62,149,107,281,65,92,41,158,199,71,39,12,87,95,510
7303,Anthony Booker,2009,2013,Total,Total,121,1616,204,462,179,374,25,88,76,139,146,256,402,37,48,85,107,280,509
7304,Yamene Coleman,2008,2010,Total,Total,93,1675,219,409,219,409,0,0,71,137,129,301,430,19,48,53,80,161,509
7305,AJ Green,2019,2019,Northern Iowa,MVC,34,1017,184,449,113,245,71,204,70,81,13,90,103,77,21,2,94,69,509
7306,Dino Gregory,2008,2011,Maryland,ACC,107,2131,200,433,199,431,1,2,108,148,154,252,406,46,51,106,82,238,509
7307,Dayton Gumm,2018,2019,Austin Peay,OVC,52,1318,176,400,117,234,59,166,98,151,34,121,155,90,55,3,73,94,509
7308,Abdulai Jalloh,2008,2009,James Madison,CAA,36,1010,153,394,92,226,61,168,142,177,48,139,187,89,55,12,138,115,509
7309,Lucas O'Brien,2014,2017,Texas-San Antonio,CUSA,95,1513,187,423,135,259,52,164,83,114,104,196,300,37,23,26,57,201,509
7310,Dominik Olejniczak,2016,2019,Total,Total,95,1545,216,355,216,355,0,0,77,110,112,193,305,46,37,71,98,220,509
7311,Michael Patton,2008,2011,Northern Illinois,MAC,108,1688,171,507,67,182,104,325,63,90,18,79,97,96,48,2,127,156,509
7312,Christian Salecich,2010,2014,Total,Total,98,2169,169,457,86,176,83,281,88,122,27,156,183,164,61,13,111,162,509
7313,M.J. Walker,2018,2019,Florida State,ACC,70,1566,166,464,81,211,85,253,92,120,21,116,137,94,51,11,108,170,509
7314,Sonny Weems,2008,2008,Arkansas,SEC,34,1067,197,425,143,279,54,146,61,76,56,96,152,89,45,8,96,74,509
7315,Tony Danridge,2009,2009,New Mexico,MWC,34,1091,176,364,170,336,6,28,150,201,36,103,139,91,41,4,73,75,508
7316,Delino Dear,2011,2015,Total,Total,98,1828,193,373,193,373,0,0,122,211,133,220,353,30,24,53,104,195,508
7317,Nnamdi Enechionyia,2014,2018,Total,Total,117,2178,168,461,66,170,102,291,70,98,80,161,241,84,54,36,88,185,508
7318,Quinton Everett,2016,2017,Montana State,Big Sky,60,1365,178,455,122,291,56,164,96,165,85,188,273,75,60,22,72,159,508
7319,Dwayne Harmason,2008,2009,Mississippi Valley State,SWAC,64,1837,163,449,146,395,17,54,165,209,39,149,188,225,85,3,125,151,508
7320,Cody Helgeland,2017,2018,Jacksonville,A-Sun,63,1706,165,423,53,120,112,303,66,78,46,152,198,72,38,19,83,135,508
7321,David Jean-Baptiste,2018,2019,Chattanooga,Southern,64,1743,185,439,100,203,85,236,53,75,40,108,148,127,46,5,78,86,508
7322,DeQuan Jones,2009,2012,Miami (FL),ACC,111,1606,201,457,191,398,10,59,96,152,73,140,268,53,52,51,123,101,508
7323,Xavier Keeling,2009,2010,Detroit Mercy,Horizon,41,1220,156,339,125,255,31,84,165,237,78,134,212,86,57,6,117,127,508
7324,Lee Moore,2016,2016,Texas-El Paso,CUSA,33,1053,156,345,107,212,49,133,147,198,50,128,178,116,46,10,70,70,508
7325,Broderick Robinson,2017,2018,Missouri-Kansas City,WAC,66,1774,163,424,62,155,101,269,81,118,61,229,290,119,82,6,95,127,508
7326,Chron Tatum,2008,2010,Idaho State,Big Sky,87,1523,204,378,199,358,5,20,95,148,78,209,287,23,28,10,71,193,508
7327,Troy Thompson,2017,2018,Prairie View,SWAC,59,1167,164,400,59,125,105,275,75,103,46,74,120,43,36,16,71,86,508
7328,Lamar Trice,2009,2012,Mount St. Mary's,NEC,83,1181,178,428,108,234,70,194,82,124,26,101,127,120,47,2,158,136,508
7329,Giordan Watson,2008,2008,Central Michigan,MAC,31,1028,168,403,104,237,64,166,108,144,17,57,74,138,58,7,84,74,508
7330,Aaron Wright,2012,2016,UC-Irvine,Big West,138,2151,154,397,113,275,41,122,159,254,45,243,288,235,96,8,193,288,508
7331,Adama Adams,2013,2014,South Carolina State,MEAC,55,1462,163,424,111,258,52,166,129,171,21,108,129,148,36,7,164,145,507
7332,Willie Bell,2008,2009,Virginia Military Institute,Big South,60,1676,186,385,160,304,26,81,109,157,161,181,342,145,124,40,118,191,507
7333,Mislav Brzoja,2013,2016,Total,Total,83,1648,166,395,115,241,51,154,124,165,69,200,269,194,59,13,138,149,507
7334,Tevin Calhoun,2013,2014,Troy,Sun Belt,64,1369,174,458,100,213,74,245,85,133,66,136,202,32,17,20,60,91,507
7335,Jalen Gibbs,2018,2019,Total,Total,63,1377,186,457,125,249,61,208,74,105,26,187,213,62,31,0,78,70,507
7336,Connor Kern,2016,2019,Total,Total,101,1863,164,402,44,94,120,308,59,75,32,175,207,59,42,11,62,144,507
7337,Darshawn McClellan,2008,2012,Total,Total,126,2072,171,405,118,256,53,149,112,173,133,266,399,112,37,40,145,205,507
7338,Travis Pinick,2008,2009,Yale,Ivy,55,1470,201,374,196,341,5,33,100,181,121,210,331,138,85,26,108,106,507
7339,Frank Robinson,2008,2008,Cal State Fullerton,Big West,32,983,175,388,122,233,53,155,104,141,68,152,220,80,39,16,74,87,507
7340,Brandon Rush,2008,2008,Kansas,Big 12,38,1127,180,414,100,223,80,191,67,86,57,138,195,81,32,32,69,60,507
7341,Adam Templeton,2009,2010,Drake,MVC,66,1759,171,406,80,170,91,236,74,95,99,271,370,64,38,16,75,165,507
7342,Brian Warren,2019,2019,Texas-Arlington,Sun Belt,33,986,176,443,124,272,52,171,103,128,15,71,86,119,39,3,71,98,507
7343,Kenderek Washington,2011,2012,Alabama State,SWAC,48,1246,177,409,117,238,60,171,93,145,88,128,216,42,48,16,81,117,507
7344,Jalen Adaway,2018,2019,Miami (OH),MAC,63,1691,197,397,164,285,33,112,79,117,71,243,314,52,29,12,61,95,506
7345,Bryce Barnes,2017,2019,Milwaukee,Horizon,92,1749,171,458,123,316,48,142,116,168,26,139,165,143,72,7,134,158,506
7346,Eddie Davis,2015,2019,Total,Total,97,1451,183,410,137,265,46,145,94,127,116,180,296,45,25,28,95,203,506
7347,Derrick Griffin,2016,2017,Texas Southern,SWAC,40,1361,201,298,200,292,1,6,103,196,207,233,440,21,27,71,41,115,506
7348,Kenny Hall,2010,2013,Tennessee,SEC,116,1717,198,361,198,355,0,6,110,173,156,234,390,30,25,60,114,243,506
7349,Jamar Hurdle,2016,2017,Green Bay,Horizon,66,1069,205,417,179,358,26,59,70,99,95,141,236,34,42,66,70,162,506
7350,Eric McKnight,2011,2015,Total,Total,106,1780,210,343,210,342,0,1,86,175,110,259,369,24,34,95,116,242,506
7351,Alex McLean,2008,2008,Liberty,Big South,32,1047,197,352,195,342,2,10,110,156,90,192,282,31,13,14,62,75,506
7352,Bryson Pope,2010,2013,Total,Total,102,1895,167,422,140,315,27,107,145,245,99,197,296,124,64,18,135,182,506
7353,Hugh Robertson,2011,2012,South Florida,Big East,69,2018,198,436,164,317,34,119,76,108,82,215,297,106,57,24,95,120,506
7354,Perry Stevenson,2008,2010,Kentucky,SEC,101,2025,194,344,191,333,3,11,115,162,133,286,419,86,62,133,134,196,506
7355,Alex Tyler,2008,2010,Cornell,Ivy,84,1574,196,402,196,401,0,1,114,160,95,200,295,73,37,62,101,179,506
7356,Frank Williams,2014,2015,Missouri-Kansas City,WAC,61,1765,187,503,92,203,95,300,37,51,17,129,146,88,39,17,63,55,506
7357,Tamarcio Wilson,2015,2016,Alcorn State,SWAC,56,1383,178,433,130,268,48,165,102,149,22,119,141,75,32,5,112,70,506
7358,Devon Andrews,2019,2019,Florida International,CUSA,33,866,179,363,143,262,36,101,111,156,40,127,167,46,56,15,60,82,505
7359,Deondre Burns,2016,2019,Little Rock,Sun Belt,76,1328,170,397,115,237,55,160,110,137,20,109,129,70,33,5,92,126,505
7360,Charvez Davis,2010,2011,Alabama,SEC,69,1618,175,468,50,130,125,338,30,42,17,104,121,74,34,6,67,73,505
7361,De'Ron Davis,2017,2019,Indiana,Big Ten,79,1164,182,327,182,327,0,0,141,225,105,141,246,74,39,64,83,181,505
7362,Jayden Gardner,2019,2019,East Carolina,AAC,31,949,166,337,164,327,2,10,171,228,93,169,262,39,24,14,75,88,505
7363,Shane Gatling,2017,2019,Total,Total,69,1318,156,435,67,162,89,273,104,129,12,82,94,79,41,7,64,86,505
7364,Malik Hairston,2008,2008,Oregon,Pac-10,31,976,176,335,124,215,52,120,101,138,45,105,150,66,19,26,55,90,505
7365,Dash Harris,2009,2012,Texas A&M,Big 12,124,2967,163,510,107,300,56,210,123,232,40,261,301,379,140,7,215,199,505
7366,Aaron Hines,2016,2018,Saint Louis,A-10,89,2082,173,555,104,312,69,243,90,135,16,155,171,184,69,2,123,175,505
7367,Todd Johnson,2013,2016,Northern Kentucky,Total,98,1839,160,422,39,96,121,326,64,94,36,165,201,136,87,5,90,167,505
7368,Tremayne Johnson,2011,2012,Eastern Washington,Big Sky,62,1258,168,431,136,306,32,125,137,187,102,177,279,34,39,57,108,139,505
7369,Alex King,2018,2019,Army,Patriot,62,1236,184,450,108,239,76,211,61,87,50,154,204,55,32,28,94,129,505
7370,Devin Liggeons,2016,2019,Wagner,NEC,105,1863,163,418,112,232,51,186,128,176,121,246,367,66,57,33,123,197,505
7371,Isaiah Morton,2012,2014,Marist,MAAC,72,2007,159,462,74,181,85,281,102,158,21,118,139,224,56,2,179,93,505
7372,Mark Porter,2008,2008,Wagner,NEC,31,1160,151,380,111,241,40,139,163,210,18,132,150,172,59,28,126,55,505
7373,Jermaine Sanders,2012,2015,Cincinnati,Total,130,2114,176,449,97,200,79,249,74,127,112,199,311,103,44,17,69,110,505
7374,Keith Shivers,2016,2017,Coppin State,MEAC,59,1664,196,504,154,339,42,165,71,126,69,144,213,112,70,11,99,153,505
7375,Sam Atupem,2008,2009,Mount St. Mary's,NEC,67,1657,210,403,210,402,0,1,84,120,127,158,285,62,36,92,98,194,504
7376,Kevin Blake,2012,2015,Elon,Total,119,1756,168,371,138,270,30,101,138,230,101,148,249,89,55,6,88,176,504
7377,Troy Green,2018,2019,New Orleans,Southland,65,1410,174,401,164,356,10,45,146,209,41,122,163,154,63,13,125,165,504
7378,C.J. Hailey,2009,2010,Gardner-Webb,Big South,54,1083,186,421,149,325,37,96,95,120,35,79,114,58,18,5,93,133,504
7379,Daniel Harris,2016,2017,Quinnipiac,MAAC,61,1518,175,453,64,154,111,299,43,60,68,184,252,106,69,14,72,123,504
7380,Jarrett Mann,2009,2012,Stanford,Total,123,2614,150,431,142,378,8,53,196,369,91,242,333,353,84,9,256,209,504
7381,Biggie Minnis,2012,2016,Total,Total,110,2174,195,441,176,378,19,63,95,187,53,220,273,255,78,16,192,250,504
7382,Terrance Motley,2013,2014,Sam Houston State,Southland,66,1081,202,424,198,417,4,7,96,155,114,190,304,25,43,26,79,202,504
7383,Alex Opacic,2008,2009,Furman,Southern,60,1294,182,388,168,335,14,53,126,178,90,171,261,52,19,17,93,127,504
7384,Craig Williams,2008,2012,Total,Total,93,1281,174,431,85,184,89,247,67,95,63,193,256,49,17,18,59,171,504
7385,Conor Clifford,2016,2017,Washington State,Pac-12,62,1046,215,353,215,352,0,1,73,87,41,109,150,36,2,31,94,158,503
7386,Qiydar Davis,2015,2018,Total,Total,70,1336,181,404,142,290,39,114,102,136,88,175,263,48,72,31,80,166,503
7387,Bryan Geffen,2008,2009,Quinnipiac,NEC,61,1579,179,459,83,195,96,264,49,73,30,104,134,161,54,9,98,108,503
7388,LaDaris Green,2010,2011,Kennesaw State,A-Sun,62,1622,203,436,166,303,37,133,60,90,190,318,508,77,43,106,114,182,503
7389,Javan Johnson,2018,2019,Troy,Sun Belt,63,1446,179,425,91,195,88,230,57,84,57,168,225,67,22,43,89,114,503
7390,Andris Misters,2015,2017,Jacksonville,A-Sun,58,1275,164,378,94,198,70,180,105,127,26,136,162,71,43,4,78,79,503
7391,Clay Mounce,2018,2019,Furman,Southern,63,1330,193,364,135,213,58,151,59,83,84,187,271,79,49,45,64,117,503
7392,Cedric Russell,2018,2019,Louisiana,Sun Belt,66,1354,168,418,52,117,116,301,51,65,12,86,98,69,33,6,52,105,503
7393,Nathan Scheer,2011,2014,Missouri State,MVC,132,2416,157,423,53,115,104,308,85,116,39,186,225,97,51,12,91,230,503
7394,J.R. Sims,2011,2014,Eastern Michigan,MAC,113,1949,165,493,99,257,66,236,107,145,52,123,175,96,99,4,113,156,503
7395,Cedric Smith,2010,2013,Savannah State,Total,108,2520,188,444,185,411,3,33,124,255,133,233,366,129,130,6,154,155,503
7396,Andre Yates,2013,2016,Total,Total,90,1704,187,497,129,303,58,194,71,116,48,85,133,107,77,8,108,202,503
7397,Jason Dawson,2009,2012,Total,Total,93,1764,155,445,52,160,103,285,89,125,20,135,155,181,67,0,137,113,502
7398,Jamel Fields,2011,2015,Total,MAAC,129,2059,141,379,97,231,44,148,176,288,37,151,188,158,94,25,140,211,502
7399,Sundiata Gaines,2008,2008,Georgia,SEC,34,1144,175,423,132,280,43,143,109,180,72,132,204,143,61,3,89,83,502
7400,Jon Goode,2008,2008,Detroit Mercy,Horizon,26,895,171,378,92,201,79,177,81,103,16,60,76,70,24,0,75,57,502
7401,Kevin Hartley,2012,2013,Gardner-Webb,Big South,66,1696,173,402,66,142,107,260,49,74,116,233,349,63,91,18,109,203,502
7402,Meyers Leonard,2011,2012,Illinois,Big Ten,65,1290,198,349,197,337,1,12,105,144,83,220,303,48,20,73,94,144,502
7403,Juevol Myles,2011,2013,Total,Total,49,1060,148,373,92,213,56,160,150,175,12,98,110,98,39,0,67,76,502
7404,Eric Nottage,2016,2017,Florida International,CUSA,63,1609,168,388,97,196,71,192,95,122,50,191,241,184,58,3,141,153,502
7405,Darius Perkins,2015,2016,Utah State,MWC,62,1672,171,419,65,163,106,256,54,78,12,131,143,157,34,3,104,93,502
7406,Louie Pillari,2017,2019,Monmouth,MAAC,91,1246,170,407,100,203,70,204,92,114,25,91,116,55,18,11,70,96,502
7407,Dylan Poston,2013,2016,Total,Total,84,1345,165,464,47,116,118,348,54,75,25,119,144,52,50,10,56,100,502
7408,Brandan Walton,2012,2014,North Texas,Total,64,1351,160,417,64,152,96,265,86,129,49,98,147,53,49,2,66,137,502
7409,Denzel Brito,2011,2015,Total,Total,112,2489,152,487,99,281,53,206,144,196,27,217,244,248,67,2,178,114,501
7410,Wendell Carter Jr.,2018,2018,Duke,ACC,37,997,179,319,160,273,19,46,124,168,109,226,335,74,30,76,75,105,501
7411,Rob Delaney,2009,2012,Lafayette,Patriot,92,1688,179,445,110,247,69,198,74,118,26,178,204,192,55,8,123,156,501
7412,Khalil Hartwell,2008,2009,Chattanooga,Southern,62,1619,185,326,185,325,0,1,131,265,161,251,412,59,32,23,104,146,501
7413,Matt Holba,2017,2019,Total,Total,64,1454,172,353,83,144,89,209,68,97,62,199,261,70,30,36,86,129,501
7414,Malik Jackson,2013,2014,Bethune-Cookman,MEAC,66,1279,174,451,94,210,80,241,73,91,46,175,221,33,36,29,60,198,501
7415,Kyree Jones,2011,2014,Total,Total,40,1231,145,437,66,184,79,253,132,151,24,73,97,88,38,3,71,52,501
7416,Max Joseph,2015,2018,Valparaiso,Total,115,2031,169,389,125,253,44,136,119,188,76,203,279,172,95,15,116,199,501
7417,Matt Kennedy,2011,2014,Charleston Southern,Big South,90,1390,173,358,110,222,63,136,92,103,20,100,120,70,32,7,66,85,501
7418,Michael Kolawole,2016,2019,Total,Total,98,1654,179,443,159,348,20,95,123,188,67,200,267,130,55,5,136,111,501
7419,D.J. Magley,2008,2012,Total,Total,131,2118,208,408,208,408,0,0,85,139,189,299,488,75,59,50,108,377,501
7420,Kahlil McDonald,2011,2012,Western Kentucky,Sun Belt,66,1568,143,473,42,132,101,341,114,144,21,110,131,112,27,6,106,141,501
7421,Drew Neitzel,2008,2008,Michigan State,Big Ten,36,1137,165,407,68,163,97,244,74,86,15,75,90,145,35,2,51,56,501
7422,Angel Nunez,2012,2016,Total,Total,97,1365,180,430,145,294,35,136,106,152,66,243,309,50,30,41,106,115,501
7423,Gary Ricks,2013,2015,Drake,MVC,68,1526,174,415,67,149,107,266,46,58,10,151,161,118,42,5,53,100,501
7424,Jaylen Stowe,2016,2019,Mercer,Southern,114,1585,179,365,157,289,22,76,121,181,64,237,301,68,58,6,87,171,501
7425,Martynas Bareika,2012,2015,Chattanooga,Southern,98,1323,165,430,85,187,80,243,90,133,63,137,200,57,33,4,105,121,500
7426,Scott Brittain,2008,2009,Boston University,AEC,57,1489,165,351,165,349,0,2,170,247,111,210,321,55,45,57,107,187,500
7427,Nathan Cayo,2018,2019,Richmond,A-10,65,1440,196,345,194,331,2,14,106,183,64,128,192,70,38,40,68,139,500
7428,Mahamoud Jabbi,2010,2011,Binghamton,AEC,62,1927,204,425,171,336,33,89,59,80,179,275,454,54,52,91,61,175,500
7429,Keldon Johnson,2019,2019,Kentucky,SEC,37,1137,173,374,128,256,45,118,109,155,49,168,217,61,28,6,60,83,500
7430,James Karnik,2018,2019,Lehigh,Patriot,61,1391,198,374,198,374,0,0,104,160,121,263,384,27,20,26,88,196,500
7431,Keala King,2011,2013,Total,Total,64,1410,178,404,152,310,26,94,118,185,86,158,244,142,52,5,147,142,500
7432,Wayne Langston,2015,2016,Murray State,OVC,64,1331,193,309,193,309,0,0,114,174,116,176,292,48,32,21,67,173,500
7433,Prokop Slanina,2017,2018,Fordham,A-10,52,1332,196,400,146,255,50,145,58,80,77,144,221,56,51,54,69,170,500
7434,LaDarrien Williams,2014,2015,Abilene Christian,Southland,47,1221,175,451,129,314,46,137,104,135,42,177,219,124,47,7,98,113,500
7435,Spike Albrecht,2013,2017,Total,Big Ten,144,2277,159,398,74,174,85,224,96,111,26,165,191,271,71,4,82,147,499
7436,Louis Birdsong,2008,2010,George Mason,CAA,97,1938,198,402,185,363,13,39,90,131,133,175,308,66,58,88,88,196,499
7437,Deividas Busma,2009,2011,Idaho State,Big Sky,68,1464,204,405,204,405,0,0,91,144,127,190,317,29,24,86,92,159,499
7438,Joe Ford,2008,2010,Pacific,Big West,100,2069,202,331,202,331,0,0,95,173,171,252,423,223,113,56,142,293,499
7439,Darius Gatson,2012,2013,Sam Houston State,Southland,65,1983,152,445,76,225,76,220,119,173,16,187,203,254,75,4,138,139,499
7440,Chris Kading,2013,2016,North Dakota State,Summit,129,2350,197,379,169,266,28,113,77,126,162,251,413,39,37,112,37,248,499
7441,Cameron Lard,2018,2019,Iowa State,Big 12,53,1066,220,353,220,353,0,0,59,97,122,178,300,29,17,92,71,157,499
7442,Eric McAlister,2011,2014,Stony Brook,AEC,124,1867,200,398,186,349,14,49,85,119,122,214,336,47,36,75,71,232,499
7443,Shawn Morgan,2008,2009,Arkansas State,Sun Belt,59,1581,194,371,194,370,0,1,111,183,160,216,376,111,87,29,114,161,499
7444,Axel Mpoyo,2018,2019,Grambling,SWAC,65,1550,191,393,163,317,28,76,89,140,116,244,360,23,46,43,107,171,499
7445,Dai-Jon Parker,2012,2014,Vanderbilt,SEC,92,2177,172,437,86,200,86,237,69,104,37,244,281,183,52,23,125,147,499
7446,Patrick Sanders,2008,2008,UC-Irvine,Big West,33,1029,178,388,138,290,40,98,103,124,37,124,161,41,13,36,90,79,499
7447,Jamar Smith,2008,2008,Morgan State,MEAC,30,899,191,410,163,325,28,85,89,125,60,103,163,37,29,17,60,74,499
7448,Devon Baker,2019,2019,North Carolina-Asheville,Big South,31,1050,182,458,146,339,36,119,98,120,32,53,85,93,46,5,89,55,498
7449,Shon Briggs,2017,2018,Cal State Bakersfield,WAC,58,1319,174,407,169,382,5,25,145,228,89,208,297,82,40,15,98,125,498
7450,Jaylen Brown,2016,2016,University of California,Pac-12,34,939,163,378,133,276,30,102,142,217,36,146,182,68,27,22,105,108,498
7451,Dave Buchberger,2008,2010,Lehigh,Patriot,88,1912,164,397,86,190,78,207,92,111,101,165,266,94,50,12,67,123,498
7452,Mario Chalmers,2008,2008,Kansas,Big 12,39,1170,164,318,91,162,73,156,97,130,14,106,120,169,97,23,75,99,498
7453,Derek Elston,2010,2013,Indiana,Big Ten,115,1485,194,404,164,324,30,80,80,126,109,229,338,37,45,34,91,187,498
7454,James Ford,2013,2016,Quinnipiac,Total,98,1725,157,453,66,191,91,262,93,136,82,169,251,92,34,11,86,179,498
7455,Devante Jackson,2018,2019,Grambling,SWAC,62,1230,169,380,151,331,18,49,142,204,77,175,252,56,16,38,99,157,498
7456,Demetrius Jemison,2008,2011,Total,Total,83,1899,201,443,200,438,1,5,95,135,141,309,450,78,37,44,111,153,498
7457,Chris Jones,2009,2010,Prairie View,SWAC,57,1915,157,352,128,272,29,80,155,209,90,161,251,278,113,7,140,104,498
7458,Jordan Jones,2015,2018,Kennesaw State,A-Sun,117,2113,214,452,214,450,0,2,70,118,115,330,445,99,40,65,80,272,498
7459,Kendall Knorr,2013,2016,Navy,Patriot,109,2100,169,446,89,181,80,265,80,96,80,219,299,138,77,5,75,154,498
7460,Kyle Noreen,2012,2015,Radford,Big South,132,3037,189,442,119,205,70,237,50,97,142,253,395,183,78,34,73,261,498
7461,Alex Peacock,2018,2019,Texas State,Sun Belt,65,1721,172,378,115,211,57,167,97,132,106,254,360,130,65,29,101,152,498
7462,Dulani Robinson,2015,2017,Total,Total,64,1544,154,460,64,194,90,266,100,122,32,131,163,163,68,2,93,111,498
7463,Ishmail Wainright,2014,2017,Baylor,Big 12,132,2458,175,419,116,241,59,178,89,135,152,274,426,259,108,29,142,263,498
7464,Henry Walker,2008,2008,Kansas State,Big 12,31,846,181,389,146,275,35,114,101,137,79,117,196,59,27,17,81,101,498
7465,Ernest Aflakpui,2016,2019,Temple,AAC,112,1950,204,345,204,345,0,0,89,157,207,340,547,47,42,34,108,304,497
7466,John Brown,2009,2011,Total,Total,59,1558,219,404,219,399,0,5,59,116,183,331,514,62,89,20,137,149,497
7467,Will Coleman,2010,2011,Memphis,CUSA,69,1454,198,312,198,312,0,0,101,168,120,248,368,21,25,105,75,183,497
7468,Colin Cunningham,2008,2009,Holy Cross,Patriot,60,1781,154,386,101,222,53,164,136,182,85,192,277,174,92,17,138,127,497
7469,Mike Green,2008,2008,Butler,Horizon,34,1144,141,327,108,238,33,89,182,240,41,179,220,172,44,4,100,84,497
7470,Maurice Harkless,2012,2012,St. John's (NY),Big East,32,1155,193,427,176,348,17,79,94,139,88,188,276,47,51,45,80,74,497
7471,Lance Hurdle,2008,2009,Miami (FL),ACC,65,1560,146,438,89,271,57,167,148,188,23,97,120,171,42,5,107,152,497
7472,Arthur Johnson,2018,2019,Alabama A&M,SWAC,48,1229,176,440,111,244,65,196,80,121,61,156,217,64,42,3,116,120,497
7473,Jayce Johnson,2017,2019,Utah,Pac-12,91,1531,197,349,197,349,0,0,103,211,167,357,524,25,21,81,93,225,497
7474,Gerard Martin,2016,2019,Grand Canyon,WAC,119,2628,168,435,73,143,95,292,66,105,60,295,355,236,113,36,132,253,497
7475,Rashaad Richardson,2011,2014,Georgia State,Total,116,1687,186,473,85,178,101,295,24,37,41,127,168,53,71,2,52,154,497
7476,Preston Ross,2011,2013,Western Carolina,Southern,101,1574,187,384,165,313,22,71,101,150,127,210,337,55,67,24,77,223,497
7477,Jamal Shuler,2008,2008,Virginia Commonwealth,CAA,32,1058,172,391,94,202,78,189,75,94,26,123,149,40,48,8,49,56,497
7478,Nikolas Skouen,2012,2014,Pepperdine,WCC,88,1567,163,421,49,117,114,304,57,69,25,113,138,51,33,5,75,113,497
7479,Jon Teske,2017,2019,Michigan,Big Ten,98,1598,191,368,168,289,23,79,92,158,137,269,406,50,52,108,34,158,497
7480,Russell Westbrook,2008,2008,UCLA,Pac-10,39,1318,182,391,156,314,26,77,107,150,61,92,153,167,63,7,96,93,497
7481,Martin Zeno,2008,2008,Texas Tech,Big 12,31,1062,166,351,161,322,5,29,160,212,31,109,140,91,43,17,87,56,497
7482,Michael Dunigan,2009,2010,Oregon,Pac-10,57,1144,173,332,173,331,0,1,150,251,104,167,271,19,41,65,82,150,496
7483,Simuel Frazier,2012,2013,Howard,MEAC,58,1707,161,437,115,282,46,155,128,195,32,132,164,212,75,3,207,132,496
7484,Jonathan Inman,2008,2011,Alabama A&M,SWAC,83,1438,167,323,167,322,0,1,162,265,115,223,338,51,40,59,94,209,496
7485,Jeff Ledbetter,2010,2011,Idaho,WAC,62,1261,154,367,32,81,122,286,66,83,18,110,128,87,64,4,87,107,496
7486,Amadou Mbodji,2008,2010,Jacksonville State,OVC,84,1678,205,372,203,365,2,7,84,138,186,271,457,48,30,139,108,216,496
7487,Malachi Richardson,2016,2016,Syracuse,ACC,37,1272,152,412,73,188,79,224,113,157,19,139,158,77,42,10,79,91,496
7488,Josiah Wallace,2019,2019,Eastern Illinois,OVC,32,1045,173,421,112,248,61,173,89,111,20,105,125,92,25,7,80,48,496
7489,Cameron Baskerville,2010,2013,Georgia Southern,Southern,120,2212,176,399,161,345,15,54,128,170,140,240,380,41,68,33,165,310,495
7490,Charles Bassey,2019,2019,Western Kentucky,CUSA,34,1067,188,300,179,280,9,20,110,143,99,241,340,24,27,81,97,88,495
7491,Ricky Doyle,2015,2019,Total,Total,105,1521,194,329,194,327,0,2,107,174,114,167,281,34,23,44,78,187,495
7492,Michael Nunnally,2008,2010,Pacific,Big West,66,1459,199,364,199,363,0,1,97,193,94,195,289,36,23,23,91,159,495
7493,Michael Obacha,2013,2016,Appalachian State,Total,115,2361,156,310,156,310,0,0,183,342,261,337,598,53,64,28,118,345,495
7494,Justin Patton,2011,2013,Total,Total,52,1122,171,433,155,366,16,67,137,227,74,194,268,53,50,9,108,113,495
7495,Zigmars Raimo,2017,2019,Hawaii,Big West,84,1410,191,367,191,359,0,8,113,203,123,163,286,65,58,17,89,158,495
7496,Milan Stanojevic,2008,2009,Eastern Washington,Big Sky,60,1479,155,389,38,79,117,310,68,81,10,97,107,91,56,0,69,137,495
7497,Amos Studivant,2009,2012,Mississippi Valley State,SWAC,128,2317,210,451,210,449,0,2,75,200,212,261,473,52,57,54,150,295,495
7498,Steve Tecker,2011,2013,South Dakota,Total,88,1703,194,393,159,298,35,95,72,96,88,209,297,116,59,7,81,112,495
7499,Bam Adebayo,2017,2017,Kentucky,SEC,38,1145,170,284,170,284,0,0,154,236,118,186,304,32,26,57,64,99,494
7500,Lenny Antwi,2012,2015,North Dakota,Total,116,1796,167,445,67,168,100,277,60,80,13,121,134,83,32,2,74,107,494
7501,Craig Austrie,2008,2009,Connecticut,Big East,67,1601,144,395,84,207,60,188,146,172,36,87,123,135,38,14,65,69,494
7502,Antonio Biglow,2013,2014,Montana State,Big Sky,55,1422,169,423,133,302,36,121,120,168,31,81,112,154,76,3,101,111,494
7503,Isaiah Brown,2017,2019,Northern Iowa,MVC,91,2047,173,482,104,250,69,232,79,101,29,228,257,111,65,26,114,175,494
7504,P.J. Gaynor,2009,2012,Central Florida,CUSA,121,1832,186,386,164,306,22,80,100,144,122,231,353,86,39,51,135,249,494
7505,Derrious Gilmore,2012,2013,Wyoming,MWC,58,1459,160,435,69,186,91,249,83,107,9,67,76,127,53,3,117,105,494
7506,Xavier Green,2018,2019,Old Dominion,CUSA,66,1752,177,451,108,273,69,178,71,101,26,171,197,123,48,8,94,135,494
7507,Kurt Huelsman,2008,2010,Dayton,A-10,106,2325,181,382,181,382,0,0,132,229,183,258,441,69,36,52,147,220,494
7508,Jaron Johnson,2013,2014,Louisiana Tech,Total,71,1308,167,349,123,206,44,143,116,159,104,127,231,36,34,20,53,126,494
7509,Immanuel King,2017,2018,Texas State,Sun Belt,69,1533,204,356,204,356,0,0,86,169,142,217,359,54,30,64,84,159,494
7510,Jean Louisme,2012,2013,North Carolina A&T,MEAC,69,1443,154,447,73,160,81,287,105,142,51,141,192,76,53,6,97,141,494
7511,Ryan McMahon,2017,2019,Louisville,ACC,91,1282,142,369,28,64,114,305,96,106,10,72,82,121,46,8,81,127,494
7512,Ron Mvouika,2014,2016,Total,Total,65,1438,163,398,89,207,74,191,94,151,57,189,246,112,37,10,105,146,494
7513,DeMarcus Nelson,2008,2008,Duke,ACC,34,1051,172,351,132,248,40,103,110,183,49,148,197,100,53,11,84,77,494
7514,Cully Payne,2010,2013,Total,Total,62,1895,154,439,77,202,77,237,109,151,12,138,150,244,43,0,186,94,494
7515,Mark Rutledge,2011,2012,Central Arkansas,Southland,57,1623,181,421,149,304,32,117,100,177,62,161,223,131,50,14,107,127,494
7516,Donte Smith,2009,2011,Southern California,Pac-10,87,1666,163,459,58,138,105,321,63,78,10,93,103,105,50,2,111,149,494
7517,Nigel Snipes,2012,2016,Western Kentucky,Total,104,1546,169,420,85,196,84,224,72,92,60,169,229,60,41,21,103,194,494
7518,Ryan Brimley,2010,2011,Southern Utah,Summit,57,1357,151,425,60,166,91,259,100,120,22,103,125,66,35,4,69,119,493
7519,Greg Brown,2008,2011,Navy,Patriot,79,1214,157,429,71,177,86,252,93,118,36,155,191,39,61,33,89,159,493
7520,David Burrell,2017,2018,East Tennessee State,Southern,68,1315,191,379,142,237,49,142,62,103,83,189,272,49,30,39,66,116,493
7521,Myles Cale,2018,2019,Seton Hall,Big East,68,1606,180,422,113,233,67,189,66,101,38,157,195,63,48,8,77,117,493
7522,Ray Ona Embo,2017,2018,Tulane,AAC,60,1739,167,414,108,236,59,178,100,134,28,137,165,164,45,9,90,140,493
7523,Clint Hopf,2008,2011,Evansville,MVC,114,1580,170,332,169,330,1,2,152,211,121,205,326,22,34,23,82,179,493
7524,Anthony Jones,2008,2009,Savannah State,Ind,60,1421,183,481,153,367,30,114,97,143,47,93,140,59,62,15,139,155,493
7525,Dashawn King,2016,2017,Missouri-Kansas City,WAC,65,1177,173,396,142,294,31,102,116,172,58,114,172,96,56,10,107,138,493
7526,Derrick Low,2008,2008,Washington State,Pac-10,35,1164,166,384,74,145,92,239,69,88,8,54,62,55,50,3,43,60,493
7527,Tyler Morris,2008,2010,Boston University,AEC,59,1811,149,431,69,193,80,238,115,144,34,149,183,183,85,8,136,178,493
7528,Brevin Pritzl,2016,2019,Wisconsin,Big Ten,91,1818,156,380,66,132,90,248,91,110,59,172,231,52,43,10,33,110,493
7529,Mykal Riley,2008,2008,Alabama,SEC,33,1039,168,375,65,137,103,238,54,72,46,124,170,58,54,19,58,68,493
7530,Jeff Robinson,2010,2013,Xavier,A-10,108,1798,201,399,195,359,6,40,85,128,132,226,358,26,37,52,89,250,493
7531,Chaz Thomas,2008,2009,Cal Poly,Big West,52,1451,174,468,115,257,59,211,86,134,19,132,151,129,72,2,89,101,493
7532,Marvin Williams,2012,2015,Total,Total,70,1372,205,413,203,404,2,9,81,132,117,177,294,24,28,47,95,157,493
7533,Sam Cassell,2015,2017,Total,Total,71,1444,159,442,57,148,102,294,72,87,17,124,141,127,41,3,59,73,492
7534,Antwain Johnson,2017,2018,Middle Tennessee,CUSA,67,1178,164,387,107,234,57,153,107,139,22,79,101,94,38,6,62,125,492
7535,Shawn Olden,2015,2019,Total,Total,88,1637,146,400,68,155,78,245,122,166,32,101,133,103,63,15,88,135,492
7536,Jason Rich,2008,2008,Florida State,ACC,34,1155,183,410,152,321,31,89,95,123,39,109,148,69,39,9,96,97,492
7537,Jamaal Trice,2010,2013,Total,Total,72,1490,155,407,77,202,78,205,104,150,36,107,143,52,20,7,97,101,492
7538,Javan White,2016,2019,Total,Total,89,1459,201,392,195,376,6,16,84,151,164,275,439,63,44,55,84,188,492
7539,Justise Winslow,2015,2015,Duke,ACC,39,1135,173,356,127,246,46,110,100,156,49,203,252,82,52,34,71,108,492
7540,Tristan Blackwood,2008,2008,Central Connecticut State,NEC,30,1078,158,390,53,106,105,284,70,81,23,58,81,155,36,3,107,57,491
7541,Devan Carter,2008,2010,Elon,Southern,90,1784,196,492,169,381,27,111,72,128,40,107,147,86,71,5,125,146,491
7542,Marc Davis,2008,2009,Maryland-Eastern Shore,MEAC,59,1705,135,455,112,338,23,117,198,299,28,117,145,191,71,1,194,158,491
7543,Aaron Falzon,2016,2019,Northwestern,Big Ten,80,1516,153,426,35,89,118,337,67,86,55,131,186,56,26,22,47,136,491
7544,LJ Figueroa,2019,2019,St. John's (NY),Big East,34,1087,199,388,148,255,51,133,42,67,52,164,216,57,61,7,45,85,491
7545,Anthony Gaston,2017,2019,Grambling,SWAC,71,1523,167,434,117,266,50,168,107,145,43,144,187,74,66,8,94,140,491
7546,Malik Gill,2013,2016,Dartmouth,Ivy,99,1659,146,410,95,247,51,163,148,208,28,134,162,252,163,6,176,169,491
7547,DeAndre Harris,2015,2017,Total,Total,47,896,155,381,110,231,45,150,136,197,21,102,123,64,45,6,105,120,491
7548,Quinard Jackson,2009,2012,North Carolina-Asheville,Big South,123,1959,205,388,196,365,9,23,72,174,138,201,339,83,56,33,108,257,491
7549,Spencer Laurie,2008,2009,Missouri State,MVC,60,1703,171,476,60,180,111,296,38,62,23,101,124,171,64,5,122,95,491
7550,Tim Rowe,2016,2019,Southern Mississippi,CUSA,98,1651,189,384,173,330,16,54,97,160,77,224,301,40,26,69,112,221,491
7551,Omar Sherman,2015,2017,Total,Total,69,1273,203,390,177,293,26,97,59,92,76,173,249,44,22,56,64,132,491
7552,Luiz Toledo,2010,2011,Idaho,WAC,59,1508,194,335,194,334,0,1,103,167,96,150,246,33,35,15,103,126,491
7553,Arnaldo Toro,2017,2019,George Washington,A-10,75,1593,171,401,157,342,14,59,135,192,166,278,444,63,50,50,87,141,491
7554,D.J. Wilson,2015,2017,Michigan,Big Ten,69,1337,192,366,143,231,49,135,58,71,62,165,227,58,25,70,52,97,491
7555,Bo Amusa,2010,2011,Alabama A&M,SWAC,55,1204,184,390,171,360,13,30,109,166,93,180,273,36,42,87,59,108,490
7556,Noah Baumann,2018,2019,San Jose State,MWC,61,1383,164,403,43,138,121,265,41,58,18,121,139,94,28,4,113,77,490
7557,Quavius Copeland,2016,2019,Total,Total,97,1455,190,449,134,260,56,189,54,74,13,88,101,136,40,1,104,75,490
7558,Larry Cunningham,2008,2008,UC-Riverside,Big West,30,890,162,402,109,238,53,164,113,137,4,86,90,42,44,9,78,61,490
7559,Max DiLeo,2012,2015,Monmouth,Total,116,1803,155,367,103,216,52,151,128,174,71,146,217,107,120,20,75,189,490
7560,Zach Fong,2014,2017,Navy,Patriot,108,1345,159,445,35,89,124,356,48,63,12,90,102,62,25,4,61,111,490
7561,Jay Gavin,2008,2010,Total,Total,49,1046,148,382,60,149,88,233,106,145,30,90,120,60,29,6,88,82,490
7562,Jack Hobbs,2015,2018,Hartford,AEC,111,1956,168,452,58,103,110,349,44,74,78,246,324,58,58,34,61,213,490
7563,Jeremiah Ingram,2015,2016,North Carolina Central,MEAC,65,1394,168,349,148,294,20,55,134,223,101,190,291,49,37,26,126,202,490
7564,Willie Jackson,2017,2019,Total,Total,63,1382,197,376,194,367,3,9,93,145,134,308,442,76,29,24,99,110,490
7565,Kyle Lofton,2019,2019,St. Bonaventure,A-10,34,1272,177,401,139,286,38,115,98,117,30,55,85,127,48,2,64,72,490
7566,Matt Marseille,2010,2014,Total,Total,101,1486,170,381,133,277,37,104,113,188,95,215,310,47,52,25,112,212,490
7567,Makol Mawien,2018,2019,Kansas State,Big 12,71,1496,204,364,199,345,5,19,77,105,104,188,292,21,35,65,97,197,490
7568,Cordell Pemsl,2017,2019,Iowa,Big Ten,68,1210,183,306,183,305,0,1,124,200,101,220,321,86,32,35,103,142,490
7569,Lis Shoshi,2016,2017,Little Rock,Sun Belt,62,1460,192,395,174,335,18,60,88,125,122,238,360,68,24,80,69,178,490
7570,JaQuail Townser,2015,2016,Jacksonville State,OVC,56,1615,167,442,100,258,67,184,89,120,29,151,180,194,68,8,118,140,490
7571,Gerald Blackshear,2016,2019,Detroit Mercy,Horizon,110,1712,201,326,201,326,0,0,87,163,183,262,445,32,55,47,111,296,489
7572,James Bourne,2012,2016,Total,Total,113,2189,170,309,170,307,0,2,149,244,147,214,361,23,39,13,116,246,489
7573,Freddie Goldstein,2012,2013,South Alabama,Sun Belt,48,1460,161,462,57,159,104,303,63,82,24,99,123,120,47,4,152,110,489
7574,Reggie Groves,2010,2014,Total,Total,125,2150,153,496,65,192,88,304,95,142,55,171,226,211,89,13,157,193,489
7575,Nathan Hawkins,2014,2018,Total,Total,118,2092,181,508,107,237,74,271,53,99,42,202,244,155,73,9,137,208,489
7576,Joshua Henley,2009,2011,Gardner-Webb,Big South,90,2139,219,423,218,418,1,5,50,122,233,469,702,104,53,7,128,209,489
7577,Donte Hill,2010,2013,Total,Total,80,1804,169,436,116,245,53,191,98,164,90,142,232,148,79,26,122,149,489
7578,Nick Honor,2019,2019,Fordham,A-10,32,1154,174,467,104,256,70,211,71,87,18,58,76,95,28,0,54,60,489
7579,Jeff Johnson,2011,2014,Eastern Kentucky,OVC,131,2101,178,415,108,204,70,211,63,89,101,235,336,159,51,27,113,264,489
7580,Daryl McCoy,2010,2013,Drexel,CAA,128,2784,203,418,203,418,0,0,83,140,304,560,864,96,41,48,142,409,489
7581,Chris Vann,2008,2008,Mount St. Mary's,NEC,34,1001,168,394,80,165,88,229,65,78,19,81,100,40,20,0,44,81,489
7582,Julian Allen,2008,2009,Georgia Southern,Southern,52,1179,189,420,172,363,17,57,93,120,129,155,284,57,63,24,84,95,488
7583,Marcus Cousin,2008,2009,Houston,CUSA,62,1390,176,350,176,349,0,1,136,185,131,260,391,30,25,91,49,131,488
7584,Kelvin Davis,2008,2010,San Diego State,MWC,74,1393,173,422,94,163,79,259,63,107,35,110,145,64,68,9,105,140,488
7585,Dallas Green,2008,2010,Robert Morris,NEC,96,1648,177,332,176,331,1,1,133,188,152,217,369,53,62,69,105,223,488
7586,Storm Murphy,2018,2019,Wofford,Southern,69,1822,169,357,78,144,91,213,59,70,11,126,137,247,54,2,95,103,488
7587,Aaron Scott,2008,2009,UC-Riverside,Big West,55,1455,194,384,194,382,0,2,100,145,131,203,334,60,65,7,106,155,488
7588,Shannon Shorter,2008,2011,Total,Total,92,1865,157,351,147,284,10,67,164,216,82,215,297,149,41,6,145,165,488
7589,Jayson Tatum,2017,2017,Duke,ACC,29,966,165,365,125,248,40,117,118,139,39,174,213,62,39,33,76,86,488
7590,Dion Wiley,2015,2019,Total,Total,110,1690,164,447,58,132,106,315,54,82,31,124,155,63,31,19,77,118,488
7591,Dre' Winston ,2011,2014,Total,Total,82,1620,162,354,140,266,22,88,142,195,59,137,196,135,65,4,101,109,488
7592,DuShawn Brooks,2011,2012,Youngstown State,Horizon,61,1447,190,499,119,298,71,201,36,61,63,211,274,71,43,33,72,155,487
7593,Jorden Duffy,2018,2019,North Texas,CUSA,51,1233,166,418,87,183,79,235,76,102,26,168,194,83,25,2,71,84,487
7594,George Goode,2009,2012,Total,Total,88,1302,200,412,198,400,2,12,85,122,87,208,295,55,28,73,68,139,487
7595,Myck Kabongo,2012,2013,Texas,Big 12,45,1449,138,345,105,239,33,106,178,249,29,128,157,237,66,2,139,99,487
7596,Ben Lawson,2014,2017,Western Kentucky,Total,110,1747,176,306,175,301,1,5,134,206,106,231,337,43,40,184,101,245,487
7597,Anthony Mason,2008,2010,St. John's (NY),Big East,44,1242,181,447,130,290,51,157,74,106,72,139,211,95,40,26,89,98,487
7598,Rozell Nunn,2014,2015,Southern Illinois-Edwardsville,OVC,54,1348,173,395,126,273,47,122,94,128,53,186,239,72,50,0,102,115,487
7599,Tim Peete,2011,2014,Tulsa,CUSA,129,2456,170,446,117,271,53,175,94,147,62,276,338,188,103,15,140,163,487
7600,Llewchean Radford,2008,2009,Wagner,NEC,61,1217,179,345,165,294,14,51,115,175,118,215,333,64,53,12,127,200,487
7601,Martin Seiferth,2011,2014,Total,Total,74,1429,206,324,206,324,0,0,75,169,154,221,375,17,19,115,72,154,487
7602,Justin Smith,2018,2019,Indiana,Big Ten,66,1330,204,395,194,353,10,42,69,119,104,150,254,35,28,25,99,142,487
7603,Channing Toney,2008,2009,Alabama-Birmingham,CUSA,52,1512,164,369,120,254,44,115,115,142,62,122,184,60,18,13,61,143,487
7604,Shawn Valentine,2013,2016,Rider,MAAC,128,2359,166,448,101,237,65,211,90,138,113,225,338,125,86,39,144,252,487
7605,Kane Williams,2018,2019,Georgia State,Sun Belt,67,1409,149,297,135,254,14,43,175,248,47,104,151,158,85,17,101,124,487
7606,Josh Bonney,2009,2013,Elon,Southern,118,1707,180,533,156,401,24,132,102,152,23,114,137,258,48,0,201,148,486
7607,P.J. Boutte,2012,2016,Total,Total,126,1986,163,468,118,294,45,174,115,171,85,174,259,328,115,2,192,177,486
7608,Matej Buovac,2013,2017,Total,Total,93,1508,148,417,38,92,110,325,80,102,46,144,190,40,23,10,51,101,486
7609,Michael Calder,2015,2016,Purdue-Fort Wayne,Summit,65,1364,158,401,84,208,74,193,96,144,25,168,193,121,29,4,127,115,486
7610,Darnell Dunn,2018,2019,Pepperdine,WCC,66,1378,174,379,135,273,39,106,99,137,80,118,198,64,26,14,81,125,486
7611,Nate Garner,2008,2009,Evansville,MVC,61,1668,168,337,168,337,0,0,150,235,138,213,351,86,70,4,112,176,486
7612,Justin Hare,2008,2008,Belmont,A-Sun,33,931,156,367,94,202,62,165,112,122,22,75,97,92,32,3,65,36,486
7613,Joey Henley,2009,2009,Sacred Heart,NEC,31,949,196,313,196,312,0,1,94,146,73,136,209,43,23,40,63,78,486
7614,Kameron Langley,2018,2019,North Carolina A&T,MEAC,67,1955,177,366,155,299,22,67,110,170,49,178,227,385,108,7,152,117,486
7615,Javon Levi,2018,2019,Texas-Rio Grande Valley,WAC,67,1880,161,428,142,347,19,81,145,223,34,183,217,325,144,3,119,152,486
7616,Joshua Lowery,2010,2012,Pepperdine,WCC,90,1977,142,398,101,265,41,133,161,212,38,184,222,199,56,12,123,159,486
7617,Jeremiah Paige,2016,2017,Colorado State,MWC,70,1744,154,429,86,229,68,200,110,142,18,133,151,137,44,30,97,135,486
7618,Raheem Singleton,2011,2012,Maine,AEC,59,1455,153,377,111,232,42,145,138,199,22,132,154,209,52,1,130,148,486
7619,McKay Cannon,2016,2019,Total,Total,128,2364,155,387,60,122,95,265,80,112,30,160,190,237,93,5,110,214,485
7620,Luciano de Souza,2009,2010,Idaho,WAC,63,1288,156,377,49,89,107,288,66,86,40,115,155,36,36,6,52,132,485
7621,DeMar DeRozan,2009,2009,Southern California,Pac-10,35,1168,192,367,186,331,6,36,95,147,84,117,201,51,31,13,73,73,485
7622,Mark Dunn,2009,2010,Eastern Washington,Big Sky,60,1525,184,381,156,305,28,76,89,118,86,152,238,40,18,11,70,133,485
7623,Naofall Folahan,2011,2014,Wagner,NEC,121,2118,192,353,192,353,0,0,101,154,189,271,460,25,17,230,102,354,485
7624,Kai Healy,2015,2018,Santa Clara,WCC,112,1951,161,387,93,205,68,182,95,123,30,228,258,94,41,12,90,163,485
7625,Calvin Lee,2009,2010,Towson,CAA,58,1392,191,429,184,407,7,22,96,131,109,157,266,55,27,59,84,169,485
7626,Maarty Leunen,2008,2008,Oregon,Pac-10,32,1110,157,281,98,161,59,120,112,142,69,224,293,90,28,11,50,78,485
7627,Jack Lopez,2014,2017,Montana,Big Sky,112,1974,165,365,58,116,107,249,48,71,47,203,250,76,42,26,76,220,485
7628,Michael Lusk,2008,2009,Lipscomb,A-Sun,61,1743,152,327,81,161,71,166,110,174,36,168,204,197,68,13,120,142,485
7629,Cam Reddish,2019,2019,Duke,ACC,36,1069,154,432,65,165,89,267,88,114,20,113,133,70,56,21,96,86,485
7630,Darius Roy,2017,2019,Total,Total,47,1127,174,398,127,278,47,120,90,110,22,117,139,125,42,7,99,82,485
7631,Steve Tchiengang,2009,2012,Vanderbilt,SEC,127,1978,162,371,117,244,45,127,116,165,127,254,381,52,38,40,135,295,485
7632,JoJo Zamora,2017,2019,Total,Total,67,1182,173,398,94,184,79,214,60,78,27,75,102,68,30,12,68,84,485
7633,Trip Day,2018,2019,North Florida,A-Sun,57,969,193,357,168,277,25,80,73,101,80,118,198,46,37,27,84,128,484
7634,Sanchez Hughley,2008,2010,Florida Atlantic,Sun Belt,59,1282,170,409,124,283,46,126,98,143,73,118,191,49,63,4,98,178,484
7635,Angel Matias,2014,2015,Georgia Southern,Total,61,1543,194,387,185,336,9,51,87,156,142,237,379,69,42,20,97,138,484
7636,Nakye Sanders,2016,2019,Total,Total,94,1599,178,319,173,306,5,13,123,218,146,305,451,65,36,77,109,287,484
7637,Josh Vaughan,2009,2010,North Dakota State,Summit,62,1541,161,400,73,172,88,228,74,103,29,188,217,148,46,16,85,116,484
7638,Rodrick Caldwell,2017,2018,Bowling Green State,MAC,63,1352,144,394,75,193,69,201,126,174,18,95,113,135,39,2,78,102,483
7639,Dejuan Goodwin,2008,2011,Marist,MAAC,99,2071,169,476,93,263,76,213,69,115,51,177,228,119,69,7,154,209,483
7640,Travis Hallam,2009,2012,Denver,Sun Belt,120,2710,173,393,97,198,76,195,61,90,26,187,213,194,81,25,122,226,483
7641,Xavier Henry,2010,2010,Kansas,Big 12,36,990,162,354,93,189,69,165,90,115,43,114,157,53,54,18,69,66,483
7642,Anthony Horton,2011,2014,Total,Total,78,1234,186,379,138,240,48,139,63,98,53,145,198,51,25,33,83,159,483
7643,Brian Lillis,2008,2008,Albany (NY),AEC,30,964,177,376,168,342,9,34,120,173,46,134,180,106,48,22,98,95,483
7644,Anthony Randolph,2008,2008,Louisiana State,SEC,31,1016,183,394,181,375,2,19,115,166,86,177,263,38,35,70,92,85,483
7645,Jalen Ray,2018,2019,Hofstra,CAA,66,1460,146,386,47,135,99,251,92,119,20,102,122,75,48,11,47,130,483
7646,Jordan Scott,2015,2018,Idaho,Big Sky,119,2446,175,383,140,287,35,96,98,156,160,281,441,129,31,42,114,252,483
7647,Avi Toomer,2017,2019,Bucknell,Patriot,86,1867,161,369,80,145,81,224,80,130,59,185,244,112,89,11,95,245,483
7648,Jarrod West,2018,2019,Marshall,CUSA,72,2205,157,415,48,127,109,288,60,87,26,164,190,167,134,2,94,150,483
7649,David Burrell,2008,2010,Texas Southern,SWAC,96,2210,184,443,143,302,41,141,73,122,73,207,280,233,172,22,187,237,482
7650,Chauncey Collins,2015,2016,Texas Christian,Big 12,58,1234,130,353,47,124,83,229,139,180,22,95,117,86,29,4,81,117,482
7651,Marquel Curtis,2014,2016,Tulsa,Total,75,1815,176,408,142,283,34,125,96,144,86,180,266,128,49,11,108,120,482
7652,Joe Hoban,2008,2011,Colgate,Patriot,95,1778,159,395,102,221,57,174,107,170,56,216,272,191,102,6,162,197,482
7653,A.J. Jackson,2008,2008,Robert Morris,NEC,34,968,172,404,123,280,49,124,89,112,62,130,192,30,38,27,64,90,482
7654,DeAntre Jefferson,2010,2011,Chattanooga,Southern,65,1277,176,282,176,281,0,1,130,230,122,235,357,36,22,24,115,173,482
7655,Jeremy Nash,2008,2010,Northwestern,Big Ten,85,2115,156,398,98,205,58,193,112,143,73,182,255,166,111,30,93,224,482
7656,Jakub Niziol,2017,2019,Cal Poly,Big West,79,1356,154,444,51,118,103,326,71,92,32,185,217,61,23,27,62,105,482
7657,Taaj Ridley,2012,2013,Iona,MAAC,65,1392,191,383,185,354,6,29,94,133,109,202,311,45,35,16,83,162,482
7658,Patrick Swilling ,2011,2014,Total,Total,69,1387,158,438,51,141,107,297,59,98,9,108,117,90,29,2,97,110,482
7659,Shaddean Aaron,2008,2008,Mercer,A-Sun,30,984,168,377,114,225,54,152,91,111,52,85,137,48,40,19,55,69,481
7660,Bobby Capobianco,2010,2014,Total,Total,121,1605,172,348,139,257,33,91,104,166,136,234,370,74,42,35,105,248,481
7661,Chivarsky Corbett,2015,2017,Delaware,CAA,62,1362,165,400,80,163,85,237,66,94,51,180,231,43,36,25,50,94,481
7662,DJ Evans,2013,2014,Albany (NY),AEC,67,1476,155,401,97,232,58,169,113,147,21,122,143,110,55,3,87,98,481
7663,William Gates,2014,2018,Total,Total,87,1660,189,434,147,302,42,132,61,121,24,104,128,48,35,5,95,100,481
7664,Tyrone Hamilton,2008,2008,Centenary (LA),Summit,30,,153,392,67,174,86,218,89,120,,,101,81,37,1,112,,481
7665,Davon Hayes,2015,2017,Total,Total,54,1130,160,411,91,220,69,191,92,126,32,119,151,71,35,9,102,87,481
7666,Matt Jackson,2015,2019,Grand Canyon,WAC,116,1848,176,427,122,259,54,168,75,114,75,254,329,105,34,28,80,173,481
7667,Josh Langford,2011,2015,Total,Total,89,1396,189,399,164,325,25,74,78,129,94,133,227,40,37,21,108,238,481
7668,Eddie Miller,2008,2008,Fresno State,WAC,32,1112,156,380,43,101,113,279,56,70,17,77,94,33,31,15,39,37,481
7669,Mike Parks Jr.,2018,2019,Memphis,AAC,69,1285,203,354,200,338,3,16,72,116,119,144,263,29,20,43,88,143,481
7670,Oliver Powell,2017,2019,Louisiana Tech,CUSA,92,1804,180,359,177,345,3,14,118,184,114,260,374,56,30,37,102,153,481
7671,Leslie Robinson,2008,2008,Florida A&M,MEAC,32,,159,382,56,118,103,264,60,72,20,83,103,37,36,4,65,60,481
7672,Xavier Tillman,2018,2019,Michigan State,Big Ten,73,1204,181,292,174,266,7,26,112,156,128,241,369,75,46,87,72,141,481
7673,Marko Vasic,2013,2016,American,Patriot,112,2081,194,414,159,279,35,135,58,97,70,282,352,157,58,14,96,201,481
7674,Jarvis Williams,2008,2009,Alcorn State,SWAC,56,1419,170,444,132,341,38,103,103,131,63,139,202,50,39,13,104,190,481
7675,Jake Zuilhof,2014,2016,Total,Total,77,1729,180,336,180,336,0,0,121,204,143,253,396,50,36,91,135,213,481
7676,Korey Bauer,2008,2011,Marist,MAAC,104,1944,177,423,154,344,23,79,103,166,141,289,430,31,24,37,96,224,480
7677,Eric Boateng,2008,2010,Arizona State,Pac-10,98,1542,197,306,197,305,0,1,86,181,140,250,390,42,29,43,121,175,480
7678,Jesus M. Delgado,2012,2013,Texas-Rio Grande Valley,GWC,64,1589,170,391,153,317,17,74,123,182,61,128,189,105,64,7,107,111,480
7679,Marcus Dickinson,2017,2019,Boise State,MWC,91,2007,149,375,69,156,80,219,102,123,17,176,193,128,52,1,76,140,480
7680,Corey Edwards,2012,2015,George Mason,Total,124,2316,149,395,75,189,74,206,108,147,14,181,195,284,137,1,207,212,480
7681,Levi Giese,2010,2013,Lafayette,Patriot,116,1807,172,441,82,170,90,271,46,83,72,192,264,54,49,109,92,270,480
7682,Desmond Holloway,2011,2011,Coastal Carolina,Big South,26,832,162,323,138,255,24,68,132,173,42,138,180,45,34,9,63,57,480
7683,Dale Lamberth,2008,2008,Missouri State,MVC,33,956,176,363,118,218,58,145,70,86,72,102,174,33,18,0,34,58,480
7684,Travon Langston,2015,2016,Southern Utah,Big Sky,57,1258,160,356,135,274,25,82,135,193,36,189,225,95,52,6,108,135,480
7685,Chris Miles,2008,2010,Brigham Young,MWC,103,1604,187,356,187,356,0,0,106,196,106,201,307,96,45,59,96,226,480
7686,Mac Peterson,2008,2010,San Jose State,WAC,84,1748,142,362,44,103,98,259,98,117,40,128,168,94,31,0,63,71,480
7687,Johnnie Shuler,2015,2018,La Salle,A-10,109,1925,148,438,46,132,102,306,82,112,37,162,199,160,62,0,120,141,480
7688,Phil Taylor ,2011,2012,Florida International,Sun Belt,41,1155,141,372,68,179,73,193,125,158,20,61,81,105,37,0,95,84,480
7689,Dujuanta Weaver,2016,2019,Eastern Kentucky,OVC,67,1621,160,442,34,89,126,353,34,49,32,124,156,147,69,3,88,135,480
7690,Ramon Clemente,2008,2009,Wichita State,MVC,64,1710,183,338,183,337,0,1,113,195,175,303,478,70,50,19,85,152,479
7691,Allyn Cooks,2010,2011,South Alabama,Sun Belt,60,1678,164,427,106,268,58,159,93,140,17,105,122,170,60,5,123,132,479
7692,Roland Fitch,2008,2009,Alabama State,SWAC,59,984,205,368,199,345,6,23,63,106,71,133,204,30,27,15,67,143,479
7693,Donte Fitzpatrick-Dorsey,2016,2019,Total,Total,69,1135,159,357,117,241,42,116,119,159,51,138,189,69,34,10,107,109,479
7694,Kentrell Gransberry,2008,2008,South Florida,Big East,30,953,183,353,183,353,0,0,113,220,109,216,325,46,18,43,69,85,479
7695,P.J. Hardy,2017,2019,Louisiana,Sun Belt,91,1464,159,409,44,104,115,305,46,65,21,120,141,90,50,12,69,123,479
7696,Aloysius Henry,2011,2012,North Carolina-Greensboro,Southern,63,1197,170,383,167,371,3,12,136,213,103,173,276,19,20,40,86,163,479
7697,Drae Murray,2009,2011,Sam Houston State,Southland,94,1801,159,440,68,170,91,270,70,95,27,145,172,323,89,3,132,137,479
7698,Khufu Najee,2014,2015,IUPUI,Summit,54,1569,184,421,162,344,22,77,89,110,31,123,154,88,45,10,97,102,479
7699,Saul Phiri,2017,2019,La Salle,A-10,77,1801,146,409,50,125,96,284,91,118,48,202,250,94,61,27,76,142,479
7700,Jamorko Pickett,2018,2019,Georgetown,Big East,61,1557,163,440,71,182,92,258,61,88,37,192,229,87,36,49,124,117,479
7701,Shawn Reid,2011,2012,Montana State,Big Sky,59,1198,161,421,81,195,80,226,77,115,55,114,169,42,34,8,71,70,479
7702,Joe Reitz,2008,2008,Western Michigan,MAC,32,925,146,257,145,256,1,1,186,260,93,161,254,28,10,3,76,104,479
7703,"Peter ""PJ"" Roberson",2011,2013,Grambling,SWAC,87,1989,197,522,196,516,1,6,84,136,146,329,475,29,24,160,98,230,479
7704,Jared Samuelson,2017,2019,North Dakota State,Summit,95,1737,149,348,16,43,133,305,48,55,10,139,149,76,31,2,32,124,479
7705,DaMetrius Upchurch,2010,2013,North Carolina A&T,MEAC,117,1559,184,370,183,366,1,4,110,208,165,228,393,37,41,50,124,219,479
7706,Joy Williamson,2013,2014,Texas A&M-Corpus Christi,Southland,59,1593,162,358,130,258,32,100,123,169,71,162,233,67,62,6,95,121,479
7707,Ruben Arroyo-Felix,2015,2018,Presbyterian,Big South,122,1617,195,450,157,312,38,138,50,93,84,165,249,40,23,18,86,112,478
7708,Ka'Darryl Bell,2013,2016,Bradley,MVC,116,2060,155,441,107,287,48,154,120,176,34,148,182,128,102,13,172,264,478
7709,Max Bielfeldt,2013,2016,Total,Big Ten,104,1241,190,389,150,284,40,105,58,89,125,192,317,42,42,26,64,138,478
7710,Ramel Bradley,2008,2008,Kentucky,SEC,30,1052,139,330,81,177,58,153,142,171,17,109,126,101,48,6,100,81,478
7711,Devin Brooks,2014,2015,Creighton,Big East,67,1324,158,406,132,304,26,102,136,190,89,199,288,196,55,5,138,83,478
7712,Rasheed Brooks,2016,2017,Mississippi,SEC,65,1617,175,483,89,212,86,271,42,61,41,150,191,105,69,16,74,110,478
7713,Chris Caird,2014,2015,Drake,MVC,62,1385,157,363,61,126,96,237,68,79,32,134,166,72,18,4,78,114,478
7714,Darnell Dodson,2010,2012,Total,Total,59,959,161,394,88,188,73,206,83,106,56,149,205,24,36,22,45,85,478
7715,Stan Dulaire,2009,2012,Sacred Heart,NEC,114,1970,175,333,175,330,0,3,128,231,163,175,338,80,83,32,109,151,478
7716,Lance Hill,2008,2009,Centenary (LA),Summit,48,,179,349,151,285,28,64,92,132,,,157,26,25,4,70,,478
7717,Craig Hinton,2014,2018,Total,Total,114,1593,166,383,72,127,94,256,52,79,95,229,324,58,36,45,81,184,478
7718,Matt Husek,2014,2017,Holy Cross,Patriot,96,1422,184,417,121,237,63,180,47,73,37,168,205,70,34,66,63,168,478
7719,Laurence Jolicoeur,2008,2011,Total,Total,99,1561,145,381,119,286,26,95,162,214,103,179,282,29,24,31,93,233,478
7720,Mark McAndrew,2008,2008,Brown,Ivy,29,966,140,297,74,141,66,156,132,160,22,124,146,63,38,1,78,64,478
7721,Nick Osborne,2013,2016,Total,Total,89,1437,194,421,172,357,22,64,68,97,114,246,360,38,29,31,83,243,478
7722,Austin Quick,2012,2015,UC-Riverside,Big West,119,2074,158,440,79,180,79,260,83,121,30,183,213,202,94,7,162,174,478
7723,Deante Strickland,2018,2019,Portland State,Big Sky,65,1370,165,404,66,149,99,255,49,76,43,97,140,164,75,1,83,118,478
7724,Trevor Welcher,2008,2011,Delaware State,MEAC,117,2603,172,410,140,286,32,124,102,138,56,139,195,206,108,8,128,161,478
7725,Turner Botz,2014,2017,Green Bay,Horizon,112,1808,145,407,46,130,99,277,88,118,58,224,282,70,41,9,56,154,477
7726,Lysander Bracey,2017,2019,Hampton,Total,97,1556,152,434,44,105,108,329,65,79,31,111,142,67,36,15,61,86,477
7727,Rakeem Brookins,2011,2013,Siena,MAAC,48,1545,163,475,114,301,49,174,102,134,22,68,90,165,83,10,147,109,477
7728,Justin Brown,2018,2019,South Florida,AAC,69,1517,162,416,64,133,98,283,55,72,87,99,186,55,31,6,69,112,477
7729,Everett Duncan,2016,2019,Vermont,AEC,95,1965,148,329,49,87,99,242,82,94,56,245,301,48,34,13,38,154,477
7730,Tim Green,2008,2009,Texas A&M-Corpus Christi,Southland,62,1379,164,417,117,259,47,158,102,171,35,93,128,116,65,1,131,116,477
7731,Randy Haynes,2017,2018,Old Dominion,CUSA,60,1266,178,486,102,242,76,244,45,67,44,116,160,94,56,13,64,113,477
7732,Rob Haynes,2008,2009,Cal State Northridge,Big West,60,1524,168,384,73,149,95,235,46,61,41,101,142,57,32,6,82,128,477
7733,Trevor John,2016,2019,Total,Total,87,1372,153,378,23,50,130,328,41,43,22,77,99,45,27,1,24,72,477
7734,Christiaan Jones,2018,2019,Stetson,A-Sun,62,1144,175,423,106,209,69,214,58,94,58,128,186,52,36,11,63,43,477
7735,Travis Jones,2011,2012,Texas State,Southland,61,1385,168,416,74,161,94,255,47,76,60,151,211,47,42,8,63,148,477
7736,Brett Lauer,2008,2009,UC-Irvine,Big West,65,1389,147,327,34,76,113,251,70,85,22,95,117,81,38,3,64,129,477
7737,T.J. Marion,2009,2010,Eastern Illinois,OVC,61,1704,169,368,169,365,0,3,139,213,57,171,228,190,48,33,144,140,477
7738,Bryan Smithson,2008,2008,North Carolina-Asheville,Big South,29,1049,157,349,95,198,62,151,101,121,20,95,115,120,54,4,70,50,477
7739,Patrick Tape,2017,2019,Columbia,Ivy,69,1220,198,323,197,322,1,1,80,122,127,222,349,59,48,76,99,193,477
7740,Eric Terry,2018,2019,Texas State,Sun Belt,67,1200,189,289,189,289,0,0,99,145,91,123,214,47,21,48,103,171,477
7741,Manuale Watkins,2014,2017,Arkansas,SEC,112,1960,202,381,189,345,13,36,60,102,84,232,316,172,110,4,74,181,477
7742,Mladen Armus,2018,2019,East Tennessee State,Southern,67,1406,188,333,187,322,1,11,99,174,176,266,442,62,49,49,121,159,476
7743,Marquis Gilstrap,2010,2010,Iowa State,Big 12,32,1029,162,372,119,258,43,114,109,163,88,210,298,45,29,30,87,74,476
7744,Trevin Harris,2012,2014,Pacific,Total,94,1575,160,364,72,142,88,222,68,92,81,159,240,125,35,15,62,140,476
7745,Matt Holland,2008,2009,Air Force,MWC,61,1426,168,357,70,116,98,241,42,52,39,131,170,54,44,18,72,106,476
7746,Michael Kidd-Gilchrist,2012,2012,Kentucky,SEC,40,1245,160,326,147,275,13,51,143,192,103,194,297,75,39,37,87,97,476
7747,Malcolm Lemmons,2011,2013,Niagara,MAAC,85,1722,153,417,115,273,38,144,132,177,109,158,267,72,58,16,113,178,476
7748,Kaimondre Owes,2008,2009,Maine,AEC,47,1083,146,344,115,254,31,90,153,206,56,55,111,65,22,0,112,79,476
7749,Devon Walker,2014,2015,Maryland-Eastern Shore,MEAC,57,1317,165,391,57,115,108,276,38,48,30,111,141,53,45,9,52,110,476
7750,Myles Walker,2011,2012,Indiana State,MVC,67,1596,199,435,199,435,0,0,78,156,129,204,333,23,30,61,96,177,476
7751,Anthony Wright,2008,2011,Total,Total,114,1818,159,467,52,125,107,342,51,81,76,201,277,101,47,15,116,121,476
7752,Maurice Aniefiok,2012,2015,Total,Total,87,1612,163,429,70,171,93,258,56,81,31,189,220,69,45,8,82,173,475
7753,Kevin Bleeker,2012,2016,Canisius,MAAC,113,1854,178,410,140,286,38,124,81,112,137,265,402,81,38,72,105,247,475
7754,Jermaine Bolden,2008,2009,Morgan State,MEAC,65,1806,170,474,126,352,44,122,91,126,33,115,148,252,84,1,145,157,475
7755,Everett Clemons,2016,2017,Indiana State,MVC,63,1834,172,358,166,334,6,24,125,186,90,303,393,229,84,3,109,119,475
7756,Gary Dixon,2010,2011,Southeastern Louisiana,Southland,55,1278,156,395,73,154,83,241,80,107,24,59,83,56,44,9,82,101,475
7757,Ahmad Grant,2010,2011,North Carolina-Wilmington,CAA,60,1537,169,417,89,203,80,214,57,74,30,116,146,70,21,40,78,113,475
7758,Brandon Hollins,2017,2018,Portland State,Big Sky,60,1187,193,337,188,303,5,34,84,150,115,220,335,33,54,13,61,159,475
7759,Carlin Hughes,2008,2009,Saint Mary's (CA),WCC,67,1433,161,411,66,110,95,301,58,68,16,93,109,195,68,3,99,105,475
7760,Alec Kobre,2015,2016,Pacific,WCC,53,1126,151,335,46,76,105,259,68,74,8,53,61,33,12,1,36,116,475
7761,Connor Miller,2012,2014,Samford,Southern,89,2471,155,440,48,138,107,302,58,92,43,227,270,168,60,13,122,193,475
7762,Aaron Moore,2013,2014,Portland State,Big Sky,37,1119,184,360,183,352,1,8,106,148,78,174,252,56,25,31,75,106,475
7763,Evan Neisler,2008,2010,Drexel,CAA,92,1700,175,385,175,382,0,3,125,187,162,273,435,28,32,51,138,220,475
7764,Sean Ogirri,2009,2009,Wyoming,MWC,33,1191,152,343,43,85,109,258,62,72,12,64,76,73,31,4,66,76,475
7765,Lorenzo Phillips,2019,2019,Longwood,Big South,34,1064,148,366,74,150,74,216,105,118,10,149,159,129,33,1,83,81,475
7766,Paul Rowley,2016,2019,William & Mary,CAA,92,1491,165,372,59,120,106,252,39,53,37,158,195,94,35,56,71,196,475
7767,Deionte Simmons,2017,2018,Chicago State,WAC,58,1074,173,314,173,312,0,2,129,194,119,171,290,8,36,25,74,165,475
7768,Will Taylor,2010,2012,Cal Poly,Big West,64,1217,188,374,188,372,0,2,99,147,145,231,376,33,50,20,76,203,475
7769,Obi Toppin,2019,2019,Dayton,A-10,33,873,201,302,190,281,11,21,62,87,50,136,186,61,21,28,63,70,475
7770,Evan Wiley,2017,2019,Alabama A&M,SWAC,89,1739,178,433,108,241,70,192,49,73,91,160,251,59,38,15,84,158,475
7771,Bryant Allen,2010,2013,Total,Total,65,1445,170,445,82,193,88,252,46,59,27,64,91,83,46,6,59,94,474
7772,Brandon Austin,2016,2019,Total,Total,70,1345,165,412,68,151,97,261,47,71,26,152,178,24,40,11,39,87,474
7773,Sidy Djitte,2014,2017,Clemson,ACC,127,1854,174,327,173,325,1,2,125,203,264,332,596,36,60,73,105,303,474
7774,Will Donahue,2010,2012,Cal Poly,Big West,69,1696,170,341,169,334,1,7,133,206,140,308,448,81,35,28,110,196,474
7775,Adrian Fields,2011,2014,McNeese State,Southland,108,1784,157,478,107,299,50,179,110,156,71,143,214,56,47,17,96,123,474
7776,DeMondre Harvey,2014,2016,Louisiana-Monroe,Sun Belt,99,1765,175,306,175,306,0,0,124,197,164,255,419,67,40,47,80,179,474
7777,Tyrel Hunt,2013,2016,Alcorn State,SWAC,100,1516,166,376,159,356,7,20,135,208,64,151,215,43,36,26,79,138,474
7778,Jai Lucas,2008,2011,Total,Total,94,1747,171,402,110,243,61,159,71,103,22,83,105,151,29,3,98,113,474
7779,Emondre Rickman,2016,2019,Indiana State,MVC,120,1555,195,416,195,416,0,0,84,175,112,264,376,33,32,116,103,218,474
7780,Jalen Sanders,2018,2019,Northern Colorado,Big Sky,55,1516,180,325,156,250,24,75,90,124,75,211,286,74,50,66,75,129,474
7781,Bryan Sherrer,2009,2010,South Alabama,Sun Belt,61,1566,146,335,102,213,44,122,138,154,19,84,103,104,26,3,81,124,474
7782,David Williams,2011,2013,North Carolina-Greensboro,Southern,93,2059,175,356,162,321,13,35,111,232,161,250,411,104,137,40,184,318,474
7783,Chad Brown,2016,2019,Central Florida,AAC,116,1709,158,319,158,318,0,1,157,268,166,288,454,23,34,97,79,216,473
7784,Lacey James,2016,2019,Total,Total,78,1537,168,377,157,347,11,30,126,190,166,233,399,35,39,32,108,216,473
7785,Michael Jenkins,2008,2008,Winthrop,Big South,34,1083,166,399,92,198,74,201,67,94,31,110,141,85,38,14,63,79,473
7786,Deven Mitchell,2008,2008,Missouri State,MVC,33,923,156,289,154,282,2,7,159,178,69,133,202,25,47,18,76,94,473
7787,Cullen Russo,2016,2017,Fresno State,MWC,60,1528,164,400,142,293,22,107,123,202,80,267,347,122,102,37,89,186,473
7788,Tyler Tiedeman,2008,2008,Boise State,WAC,34,1074,153,289,69,117,84,172,83,111,22,92,114,105,17,10,85,92,473
7789,Aaron Walker,2017,2018,Manhattan,MAAC,55,1057,163,408,127,287,36,121,111,178,32,89,121,99,61,9,120,120,473
7790,Deshaunt Walker,2013,2014,Stephen F. Austin,Southland,60,957,169,441,75,160,94,281,41,51,20,51,71,49,26,1,37,65,473
7791,Dwayne Anderson,2008,2009,Villanova,Big East,61,1442,172,368,120,201,52,167,76,101,124,210,334,70,94,26,74,148,472
7792,Shamile Cabell,2011,2012,Jacksonville,A-Sun,61,1049,152,398,104,270,48,128,120,170,26,53,79,101,38,6,106,145,472
7793,Jason Duty,2008,2010,Duquesne,A-10,90,1994,151,391,42,93,109,298,61,77,24,120,144,100,41,3,61,157,472
7794,Justin Fuehrmeyer,2008,2010,Missouri State,MVC,91,2350,138,378,75,183,63,195,133,165,53,153,206,305,93,1,140,152,472
7795,Jordan Heading,2019,2019,California Baptist,WAC,31,1003,175,380,115,214,60,166,62,75,14,106,120,81,19,1,87,72,472
7796,Jestin Lewis,2015,2016,Mercer,Southern,58,1097,163,384,81,162,82,222,64,88,13,130,143,64,62,1,54,61,472
7797,Princeton Onwas,2014,2016,Total,Total,62,1346,167,354,149,266,18,88,120,218,41,134,175,98,49,14,110,168,472
7798,Joel Vander Pol,2011,2014,Liberty,Big South,118,1645,165,311,165,311,0,0,142,229,142,276,418,24,25,72,110,244,472
7799,Devon Baulkman,2015,2016,Tennessee,SEC,65,1390,154,410,66,156,88,254,75,93,78,111,189,79,54,16,69,91,471
7800,Tyler Dierkers,2008,2009,Miami (OH),MAC,62,2065,187,355,182,336,5,19,92,136,153,273,426,143,88,33,112,142,471
7801,CJ Elleby,2019,2019,Washington State,Pac-12,32,992,168,385,115,257,53,128,82,124,51,176,227,96,33,18,97,82,471
7802,Edward Hardt,2018,2019,Houston Baptist,Southland,57,1132,180,328,178,324,2,4,109,187,78,156,234,31,30,15,98,144,471
7803,Demario Hines,2012,2013,Purdue-Fort Wayne,Summit,61,1346,186,354,186,354,0,0,99,178,120,193,313,59,31,53,108,165,471
7804,Isaiah Joe,2019,2019,Arkansas,SEC,34,1024,148,358,35,85,113,273,62,82,21,74,95,60,52,5,42,64,471
7805,Blake Metcalf,2010,2013,Albany (NY),AEC,133,2536,207,372,207,370,0,2,57,170,226,371,597,86,61,73,124,283,471
7806,Nick Muszynski,2019,2019,Belmont,OVC,32,797,198,328,190,307,8,21,67,86,40,145,185,87,19,70,50,65,471
7807,Bryan Streeter,2009,2011,Citadel,Southern,97,1936,195,396,195,390,0,6,81,179,156,243,399,65,57,25,88,208,471
7808,Tristan Thompson,2011,2011,Texas,Big 12,36,1104,172,315,172,315,0,0,127,261,138,144,282,45,34,86,64,100,471
7809,Phil Beans,2010,2013,Holy Cross,Patriot,91,1495,167,388,107,233,60,155,76,93,75,168,243,37,17,27,83,182,470
7810,Cam Davis,2018,2019,Navy,Patriot,63,1478,162,387,102,226,60,161,86,113,15,91,106,76,23,3,61,74,470
7811,Raul Frias,2016,2019,Long Island University,NEC,116,1455,164,434,46,100,118,334,24,31,41,155,196,33,49,24,45,99,470
7812,Aaron Gordon,2014,2014,Arizona,Pac-12,38,1187,189,382,173,337,16,45,76,180,102,201,303,75,34,39,55,90,470
7813,Daquan Holiday,2012,2015,NJIT,Total,104,1679,179,310,179,310,0,0,112,180,160,259,419,58,70,132,99,240,470
7814,Rod Melvin,2009,2011,Jackson State,SWAC,95,2593,147,396,116,284,31,112,145,199,57,212,269,330,92,9,207,204,470
7815,Antoine Pittman,2016,2019,Bradley,MVC,79,1579,164,426,118,268,46,158,96,146,47,106,153,75,50,12,117,162,470
7816,Makur Puou,2017,2018,New Orleans,Southland,65,1683,191,373,191,371,0,2,88,139,112,219,331,63,31,68,108,145,470
7817,Jaylen Shead,2016,2019,Total,Total,73,1797,165,400,126,269,39,131,101,150,54,215,269,295,68,9,130,156,470
7818,Kaj-Bjorn Sherman,2014,2015,Texas-San Antonio,CUSA,57,1340,151,279,151,279,0,0,168,220,116,185,301,37,31,21,89,139,470
7819,Azar Swain,2018,2019,Yale,Ivy,61,1206,156,377,48,107,108,270,50,67,19,140,159,71,26,3,54,79,470
7820,Dave Barnett,2009,2012,Buffalo,MAC,90,1985,180,431,123,255,57,176,52,104,124,239,363,112,53,27,126,146,469
7821,David Caraher,2018,2018,Houston Baptist,Southland,29,908,162,356,106,202,56,154,89,121,70,138,208,56,24,4,69,83,469
7822,Aaron Ellis,2008,2011,Wichita State,MVC,136,2243,197,452,189,418,8,34,67,107,141,289,430,52,34,37,92,281,469
7823,Chris Hayes,2008,2009,Detroit Mercy,Horizon,57,1397,177,415,150,334,27,81,88,158,84,207,291,59,54,38,110,174,469
7824,Marcanvis Hymon,2015,2018,Mississippi,SEC,106,2022,192,360,192,360,0,0,85,178,191,321,512,63,64,97,89,288,469
7825,Christian Juzang,2017,2019,Harvard,Ivy,72,1789,146,366,69,148,77,218,100,120,29,149,178,158,35,6,121,112,469
7826,Jack Leasure,2008,2008,Coastal Carolina,Big South,28,1044,155,368,44,99,111,269,48,55,23,98,121,64,24,3,57,43,469
7827,Akolda Manyang,2016,2018,Total,Total,56,868,174,289,174,289,0,0,121,176,102,200,302,25,14,104,87,122,469
7828,Randy Miller Jr.,2017,2019,Total,Total,46,1035,143,343,74,158,69,185,114,141,13,70,83,66,30,1,74,73,469
7829,Damari Milstead,2018,2019,Grand Canyon,WAC,60,1204,148,357,108,249,40,108,133,170,21,86,107,150,58,6,93,72,469
7830,Don MuepoKelly,2013,2017,Total,Total,74,1376,183,392,182,385,1,7,102,174,120,198,318,57,79,71,83,170,469
7831,Lonnie Robinson,2012,2013,Fairleigh Dickinson,NEC,60,1749,156,396,97,244,59,152,98,162,32,164,196,117,33,10,131,87,469
7832,Sam Singer,2014,2017,University of California,Pac-12,133,2451,184,439,146,301,38,138,63,124,46,252,298,292,75,10,147,240,469
7833,Tate Stensgaard,2014,2016,Western Illinois,Summit,72,1564,181,309,180,305,1,4,106,157,90,232,322,59,27,23,103,243,469
7834,Marcos Tamares,2009,2012,Total,Total,90,1617,172,462,132,325,40,137,85,131,68,156,224,42,57,18,102,156,469
7835,Joseph Uchebo,2014,2016,Total,Total,63,1075,197,351,197,351,0,0,75,134,143,284,427,34,36,24,51,81,469
7836,Wynton Witherspoon,2008,2009,George Washington,A-10,50,1376,175,419,131,274,44,145,75,113,67,125,192,106,44,22,77,108,469
7837,Eddie Ard,2008,2008,Lipscomb,A-Sun,31,966,157,391,101,230,56,161,98,133,25,117,142,64,39,20,73,69,468
7838,Evan Bailey,2015,2018,College of Charleston,CAA,121,1735,150,430,46,115,104,315,64,90,49,146,195,44,38,4,56,181,468
7839,John Baumann,2008,2008,Columbia,Ivy,29,911,160,311,135,228,25,83,123,164,65,129,194,31,18,9,58,75,468
7840,Lucian Brownlee,2016,2019,Coppin State,MEAC,114,1236,149,408,51,136,98,272,72,92,15,79,94,47,24,2,106,107,468
7841,Johnnie Bryant,2008,2008,Utah,MWC,33,891,160,325,71,124,89,201,59,64,8,65,73,39,26,0,40,63,468
7842,Braxton Dupree,2008,2011,Total,Total,81,1424,172,388,172,388,0,0,124,189,122,226,348,14,22,57,99,151,468
7843,Dominic Friend,2008,2010,Nicholls State,Southland,89,2278,160,435,108,238,52,197,96,137,65,214,279,158,61,21,167,247,468
7844,Nate Garth,2009,2013,Total,Total,120,2017,145,421,84,221,61,200,117,171,31,131,162,316,58,5,165,152,468
7845,Jacob Kessler,2015,2019,Army,Patriot,98,1964,180,398,119,202,61,196,47,73,100,222,322,142,65,19,98,172,468
7846,Tony Nixon,2010,2014,Total,Total,110,1597,162,452,79,192,83,260,61,101,63,135,198,52,32,12,71,137,468
7847,Mark Vital,2018,2019,Baylor,Big 12,67,1729,176,373,171,341,5,32,111,214,195,233,428,139,61,52,129,172,468
7848,Johnny Williams,2010,2014,George Mason,Total,113,1693,190,426,190,420,0,6,88,152,106,195,301,44,42,46,99,189,468
7849,Jamari Blackmon,2019,2019,North Alabama,A-Sun,32,1130,137,421,69,187,68,234,125,163,26,85,111,87,56,6,60,82,467
7850,Brad Brechting,2016,2019,Oakland,Horizon,98,1247,171,310,162,283,9,27,116,160,104,240,344,53,35,86,83,192,467
7851,Terrell Brown,2019,2019,Seattle,WAC,33,1102,181,397,166,352,15,45,90,132,47,179,226,150,33,12,78,89,467
7852,Marquese Chriss,2016,2016,Washington,Pac-12,34,848,179,338,158,278,21,60,88,129,85,98,183,26,32,55,69,138,467
7853,Elijah Cuffee,2018,2019,Liberty,Total,73,1852,163,382,73,151,90,231,51,60,16,139,155,137,59,29,100,168,467
7854,Devine Eke,2016,2019,Total,Total,91,1347,196,314,192,303,4,11,71,217,123,211,334,53,56,86,65,173,467
7855,Malcom Eleby,2008,2010,St. Bonaventure,A-10,90,1821,145,402,135,339,10,63,167,253,44,178,222,240,95,12,219,215,467
7856,Ryan Fazekas,2016,2019,Total,Total,78,1423,157,381,53,112,104,269,49,64,42,133,175,36,27,11,32,114,467
7857,Kyle Foreman,2016,2017,Boston University,Patriot,59,1631,156,392,113,249,43,143,112,146,21,129,150,248,90,6,157,119,467
7858,Brandone Francis,2016,2019,Total,Total,102,1730,171,488,88,222,83,266,42,74,36,147,183,92,53,9,69,157,467
7859,Rick Kreklow,2011,2015,Total,Total,97,1819,146,386,58,128,88,258,87,124,69,156,225,124,65,9,106,191,467
7860,Jacob Lampkin,2015,2017,Pacific,WCC,83,1590,195,378,195,375,0,3,77,138,122,265,387,74,18,24,99,182,467
7861,Tomas Murphy,2018,2019,Northeastern,CAA,64,1122,188,342,171,298,17,44,74,99,74,110,184,53,16,7,70,131,467
7862,Cameron Oluyitan,2017,2019,Total,Total,51,1227,161,371,106,213,55,158,90,123,27,147,174,81,38,13,93,95,467
7863,Perry Petty,2009,2011,Total,Total,49,1190,159,370,114,219,45,151,104,152,39,118,157,139,72,5,150,122,467
7864,James Whitaker,2015,2017,North Carolina A&T,MEAC,88,1290,151,414,108,246,43,168,122,155,56,124,180,29,39,16,91,147,467
7865,Jon Williams,2018,2019,Robert Morris,NEC,68,2093,145,384,35,116,110,268,67,83,18,126,144,256,60,6,166,181,467
7866,Brandon Armstrong,2017,2019,South Dakota,Summit,97,1466,153,405,70,169,83,236,77,104,20,140,160,52,23,1,33,89,466
7867,Kyle Benton,2014,2017,Total,Total,65,1474,180,302,180,300,0,2,106,189,185,220,405,22,39,51,55,129,466
7868,Kellan Carter,2008,2011,Nicholls State,Southland,117,2800,180,318,178,313,2,5,104,196,77,215,292,225,206,20,138,320,466
7869,Trevor Deloach,2010,2012,North Carolina-Wilmington,CAA,79,1304,170,424,125,300,45,124,81,123,98,169,267,58,51,7,87,73,466
7870,Archie Goodwin,2013,2013,Kentucky,SEC,33,1048,157,357,140,293,17,64,135,212,48,104,152,88,36,15,101,97,466
7871,Leonard Houston,2008,2008,Drake,MVC,33,1042,156,370,101,210,55,160,99,129,46,101,147,60,47,8,64,57,466
7872,JaVale McGee,2008,2008,Nevada,WAC,33,902,189,357,175,315,14,42,74,141,83,159,242,20,26,92,80,82,466
7873,Tyler Neal,2011,2014,Oklahoma,Big 12,116,1410,145,361,72,151,73,210,103,136,69,213,282,54,30,18,86,150,466
7874,Hayward Register,2014,2016,Louisiana,Sun Belt,92,1040,155,464,26,87,129,377,27,38,24,87,111,24,26,12,25,93,466
7875,Jamaal Robateau,2016,2018,Gardner-Webb,Big South,76,1443,161,421,78,165,83,256,61,82,28,181,209,79,62,16,73,86,466
7876,Elmo Stephen,2016,2017,Florida International,CUSA,52,1170,158,374,67,137,91,237,59,84,38,111,149,34,16,6,43,83,466
7877,Caleb Stewart,2018,2019,Binghamton,AEC,58,1276,162,392,82,169,80,223,62,88,30,237,267,35,31,70,61,80,466
7878,Rodell Wigginton,2015,2016,Buffalo,MAC,65,1303,175,396,158,326,17,70,99,159,108,203,311,54,44,35,91,131,466
7879,Duro Bjegovic,2010,2011,Sacramento State,Big Sky,56,1275,171,389,111,237,60,152,63,93,56,205,261,59,21,9,94,73,465
7880,Preston Bungei,2016,2018,Norfolk State,MEAC,67,1479,163,371,153,328,10,43,129,179,93,220,313,100,43,55,121,170,465
7881,Nahziah Carter,2018,2019,Washington,Pac-12,70,1224,170,358,130,243,40,115,85,135,50,95,145,49,42,19,70,121,465
7882,Mack Darrow,2010,2013,Princeton,Ivy,96,1703,150,361,77,157,73,204,92,123,72,176,248,152,31,22,61,138,465
7883,Byron Davis,2008,2008,Youngstown State,Horizon,30,1063,175,388,131,252,44,136,71,103,28,62,90,71,33,6,86,69,465
7884,Vance Johnson,2018,2019,Milwaukee,Horizon,64,1133,167,352,152,302,15,50,116,145,83,206,289,36,19,18,75,151,465
7885,Erin Straughn,2010,2012,East Carolina,CUSA,94,2076,163,405,84,172,79,233,60,95,105,286,391,103,68,29,118,155,465
7886,Rashaan Surles,2014,2017,Total,SWAC,84,1591,173,451,137,322,36,129,83,118,39,158,197,157,67,34,124,137,465
7887,Juan Anderson,2012,2015,Marquette,Big East,121,1864,171,406,138,292,33,114,89,150,138,261,399,120,92,31,131,207,464
7888,De'Von Cooper,2018,2019,Morehead State,OVC,62,1540,160,422,82,195,78,227,66,92,36,153,189,94,38,14,87,105,464
7889,Sebastian Douglas,2012,2014,Cleveland State,Horizon,72,1692,194,380,186,336,8,44,68,114,85,135,220,97,67,4,134,134,464
7890,Antonio Gillespie,2016,2019,Morgan State,MEAC,108,1626,157,480,50,152,107,328,43,66,35,69,104,63,41,2,47,169,464
7891,Roland Griffin,2016,2018,Total,Total,49,1139,181,350,168,313,13,37,89,139,49,165,214,63,23,28,70,120,464
7892,Devonnte Holland,2017,2019,Radford,Big South,95,1422,187,357,187,354,0,3,90,147,145,204,349,40,16,34,116,200,464
7893,Theo Johnson,2013,2015,Total,Total,95,1434,144,346,122,256,22,90,154,219,76,164,240,75,24,44,98,107,464
7894,Dominic Knight,2008,2011,Northwestern State,Southland,101,1643,154,358,126,278,28,80,128,209,64,174,238,156,55,21,152,268,464
7895,Nikola Koprivica,2008,2010,Washington State,Pac-10,98,1853,156,361,95,179,61,182,91,133,56,212,268,130,32,5,108,140,464
7896,Jordin Mayes,2011,2014,Arizona,Total,136,1664,161,421,83,199,78,222,64,96,24,101,125,129,64,3,97,145,464
7897,Amadi McKenzie,2008,2008,Tennessee Tech,OVC,32,963,178,301,170,276,8,25,100,173,103,165,268,55,30,9,79,89,464
7898,Ethan Niedermeyer,2008,2010,Portland,WCC,87,1765,162,400,69,153,93,247,47,65,79,139,218,80,53,11,119,223,464
7899,Marco Porcher Jimenez,2011,2015,Total,Total,104,1383,161,416,66,138,95,278,47,62,41,119,160,42,30,9,57,107,464
7900,Zach Rufer,2013,2016,Lafayette,Patriot,121,1974,152,406,52,133,100,273,60,96,54,232,286,141,103,11,86,204,464
7901,Steven Sexton,2008,2009,Coastal Carolina,Big South,59,1365,155,429,46,114,109,315,45,62,20,81,101,109,27,1,98,95,464
7902,Eugene Spates,2008,2009,Northeastern,CAA,63,1331,145,424,55,151,90,273,84,116,57,133,190,55,40,14,62,148,464
7903,Tre' Thomas,2017,2018,Coppin State,MEAC,60,1372,160,469,73,199,87,270,57,74,19,98,117,49,14,2,71,94,464
7904,Brian Zoubek,2008,2010,Duke,ACC,101,1435,192,316,192,316,0,0,80,136,245,283,528,67,51,77,93,252,464
7905,Jackson Carbajal,2011,2013,Sacramento State,Big Sky,70,1307,172,413,115,217,57,196,62,110,76,101,177,50,39,5,81,136,463
7906,Kerwin Dunham,2008,2011,Northern Iowa,MVC,126,2564,150,371,86,175,64,196,99,127,33,126,159,112,44,8,68,184,463
7907,Steven Enoch,2016,2019,Total,Total,90,1191,175,349,161,309,14,40,99,135,90,193,283,11,13,40,73,174,463
7908,A.J. Graves,2008,2008,Butler,Horizon,34,1196,148,395,53,114,95,281,72,81,10,89,99,74,54,3,55,42,463
7909,Jalen Harris,2017,2018,Louisiana Tech,CUSA,38,894,160,350,114,220,46,130,97,113,29,103,132,68,34,10,70,62,463
7910,Kain Harris,2016,2019,Total,Total,71,1149,152,435,82,209,70,226,89,111,26,84,110,28,15,10,65,114,463
7911,Carlos Hines,2018,2019,Northern Arizona,Big Sky,51,1068,152,419,90,212,62,207,97,134,18,81,99,131,46,8,112,93,463
7912,Desmond Jackson,2008,2011,Alabama A&M,SWAC,111,1991,161,555,67,204,94,351,47,91,64,140,204,115,98,11,131,189,463
7913,A.J. John,2015,2019,Total,Total,112,1828,170,419,102,207,68,212,55,87,98,249,347,42,33,51,85,250,463
7914,Jamal Jones,2012,2014,Total,SEC,39,970,151,416,68,187,83,229,78,104,36,108,144,45,28,12,55,62,463
7915,Mason Jones,2019,2019,Arkansas,SEC,34,996,136,337,60,129,76,208,115,143,18,114,132,93,31,6,61,77,463
7916,Tony Lee,2008,2008,Robert Morris,NEC,34,989,176,347,151,267,25,80,86,124,84,141,225,217,95,5,147,78,463
7917,Grant Parker,2008,2010,Air Force,MWC,57,1181,155,325,103,191,52,134,101,150,51,133,184,45,22,16,67,112,463
7918,PJ Pipes,2018,2019,Green Bay,Horizon,70,1513,146,386,78,190,68,196,103,122,24,134,158,110,48,8,84,157,463
7919,Naz Reid,2019,2019,Louisiana State,SEC,34,926,171,365,143,281,28,84,93,128,84,160,244,30,25,23,85,108,463
7920,Andre Wesson,2017,2019,Ohio State,Big Ten,98,2004,154,376,88,173,66,203,89,127,81,159,240,108,37,25,117,213,463
7921,BeeJay Anya,2014,2017,North Carolina State,ACC,129,2200,180,309,180,309,0,0,102,214,165,301,466,39,28,243,112,318,462
7922,Taylor Bessick,2013,2017,Total,Total,123,1858,193,398,193,398,0,0,76,125,165,283,448,32,44,99,99,314,462
7923,Avery Dingman,2012,2015,Creighton,Total,134,1800,152,378,64,134,88,244,70,102,53,214,267,84,30,16,75,178,462
7924,Kevin Douglas,2012,2015,St. Francis (NY),NEC,103,1488,169,404,116,231,53,173,71,109,81,205,286,41,44,29,97,231,462
7925,Darren Fells,2008,2008,UC-Irvine,Big West,32,1009,168,295,160,282,8,13,118,159,89,141,230,66,51,15,56,89,462
7926,Justin Glenn,2008,2012,Total,Total,114,1245,186,358,178,334,8,24,82,158,114,240,465,83,53,94,126,193,462
7927,David Gomez,2008,2008,Tulane,CUSA,32,911,162,301,153,279,9,22,129,179,55,142,197,29,27,51,65,88,462
7928,Brandon Harris,2013,2014,Western Kentucky,Sun Belt,65,1614,136,419,31,94,105,325,85,117,80,219,299,99,45,3,77,84,462
7929,Greg Hill,2010,2011,Texas Christian,MWC,59,1218,136,352,52,116,84,236,106,130,21,96,117,66,45,5,64,97,462
7930,Avery Johnson,2015,2019,Total,SEC,115,1531,164,493,106,287,58,206,76,97,27,97,124,98,49,2,66,144,462
7931,Jared Johnson,2015,2016,Stephen F. Austin,Southland,65,809,158,366,64,129,94,237,52,69,16,60,76,78,30,6,70,110,462
7932,Peter Jurkin,2013,2018,Total,Total,94,1112,170,312,163,292,7,20,115,145,85,206,291,7,30,77,81,137,462
7933,Thomas Neff,2016,2018,Denver,Summit,75,1831,150,351,58,135,92,216,70,93,45,144,189,105,44,16,79,149,462
7934,Scott Plaisance,2016,2019,Total,Total,84,1163,188,388,180,355,8,33,78,127,98,162,260,40,45,63,90,186,462
7935,Andrew Prestley,2008,2009,Grambling,SWAC,44,1233,183,412,170,362,13,50,83,118,74,128,202,70,34,14,92,86,462
7936,Jonathan Sanks,2016,2019,Total,Total,82,1334,153,388,61,130,92,258,64,98,21,113,134,72,22,6,54,159,462
7937,Carson Shanks,2015,2018,Total,Total,94,1281,171,350,169,334,2,16,118,197,64,180,244,48,7,77,124,259,462
7938,Dylan Sherwood,2012,2016,North Carolina-Wilmington,CAA,121,1325,170,402,90,164,80,238,42,60,89,155,244,26,35,20,49,150,462
7939,Antonio Williams,2011,2012,Coppin State,MEAC,60,1512,182,331,181,325,1,6,97,156,172,284,456,59,27,11,84,151,462
7940,Maurice Wiltz,2011,2015,Total,Total,76,1291,138,347,57,148,81,199,105,143,17,99,116,79,36,2,77,136,462
7941,Kevin Anderson,2018,2019,Delaware,CAA,40,1380,155,381,102,226,53,155,98,127,31,144,175,141,46,19,101,113,461
7942,Freddy Asprilla,2009,2013,Total,Total,68,1181,184,363,184,363,0,0,93,217,134,224,358,39,28,40,100,161,461
7943,T.J. Curry,2012,2015,Marist,MAAC,104,2001,142,385,54,143,88,242,89,123,60,176,236,162,61,2,109,162,461
7944,Kendall Griffin,2012,2015,Wright State,Horizon,92,2077,142,322,81,142,61,180,116,155,43,157,200,149,73,24,122,156,461
7945,Tyus Jones,2015,2015,Duke,ACC,39,1322,135,324,88,200,47,124,144,162,19,118,137,217,59,3,76,46,461
7946,Cory Kilby,2016,2019,Mercer,Southern,121,1754,160,383,104,197,56,186,85,116,79,210,289,74,27,24,84,168,461
7947,Desmond Ridenour,2014,2018,Total,Total,120,1759,178,457,141,302,37,155,68,121,55,157,212,152,96,15,109,169,461
7948,Mike Scott,2008,2008,Kent State,MAC,35,1153,148,305,108,204,40,101,125,147,64,158,222,39,39,27,51,66,461
7949,Ryan Dermody,2008,2010,Wyoming,MWC,68,1805,148,415,58,134,90,281,74,113,53,220,273,67,47,54,84,154,460
7950,Kiefer Douse,2016,2017,Canisius,MAAC,62,1298,170,361,130,243,40,118,80,115,57,144,201,120,42,4,85,136,460
7951,Aleksandar Dozic,2016,2019,Total,Total,83,1387,173,409,107,203,66,206,48,68,52,214,266,123,29,23,103,158,460
7952,Ryan Edwards,2014,2018,Total,Total,98,985,176,362,165,326,11,36,97,139,105,136,241,25,12,69,73,192,460
7953,Krys Faber,2009,2012,DePaul,Big East,119,1922,173,352,172,351,1,1,113,176,170,276,446,36,41,52,100,280,460
7954,Sam Finley,2014,2016,Total,Total,47,883,141,359,112,246,29,113,149,196,13,79,92,32,27,7,64,60,460
7955,Stephen Franklin,2011,2012,Texas-San Antonio,Southland,66,1613,142,315,89,186,53,129,123,164,87,202,289,123,74,28,108,208,460
7956,Terel Hall,2014,2015,Savannah State,MEAC,61,1531,159,352,152,318,7,34,135,217,36,105,141,176,91,12,134,124,460
7957,Brad Haugabrook,2010,2011,North Florida,A-Sun,65,1914,178,448,170,410,8,38,96,147,31,128,159,245,35,6,164,127,460
7958,Trenton Marshall,2010,2010,Jacksonville State,OVC,26,817,154,370,97,215,57,155,95,120,32,105,137,62,44,14,52,60,460
7959,Mack Mercer,2015,2018,Belmont,OVC,82,904,172,329,152,258,20,71,96,125,68,129,197,43,19,41,66,170,460
7960,Patrick Onwenu,2012,2016,Total,Total,91,1474,142,326,138,291,4,35,172,242,123,162,285,47,37,63,114,187,460
7961,Deion Taylor,2013,2016,Richmond,A-10,132,2696,164,388,108,190,56,198,76,160,101,293,394,135,84,68,99,314,460
7962,Adam Young,2010,2013,Total,Total,87,1689,162,448,111,276,51,172,85,125,117,203,320,80,50,47,83,206,460
7963,Alfred Aboya,2008,2009,UCLA,Pac-10,74,1556,175,329,174,326,1,3,108,164,130,174,304,34,55,12,63,168,459
7964,Ryan Allen,2011,2012,Milwaukee,Horizon,66,1514,157,299,148,267,9,32,136,223,93,163,256,63,71,56,105,165,459
7965,John Azzinaro,2014,2017,Bucknell,Patriot,122,1485,155,439,52,166,103,273,46,68,17,113,130,77,42,2,70,154,459
7966,Cavon Baker,2013,2017,Total,Total,81,1147,160,385,108,235,52,150,87,121,40,124,164,69,52,10,95,110,459
7967,Will Barnes,2008,2009,Tennessee Tech,OVC,62,1278,168,365,118,229,50,136,73,109,18,104,122,151,61,14,131,117,459
7968,Emmanuel Chibuogwu,2014,2017,Seattle,WAC,107,2125,162,396,112,232,50,164,85,142,76,235,311,127,49,21,112,213,459
7969,Brooks DeBisschop,2017,2019,Northern Arizona,Big Sky,87,1925,172,360,156,300,16,60,99,179,161,309,470,91,57,47,102,198,459
7970,Curtis Diamond,2014,2015,Georgia Southern,Total,65,1500,159,465,84,195,75,270,66,107,28,137,165,59,39,9,69,111,459
7971,Josh Duncan,2008,2008,Xavier,A-10,37,829,141,284,86,152,55,132,122,143,43,130,173,49,16,23,61,90,459
7972,Allante Holston,2016,2019,Total,Total,129,2454,165,378,154,342,11,36,118,173,81,269,350,120,67,23,127,199,459
7973,Frankie Johnson,2017,2018,Citadel,Southern,65,1673,145,384,95,214,50,170,119,163,73,121,194,259,106,6,135,167,459
7974,Nelson Kaputo,2016,2019,St. Bonaventure,A-10,115,1646,153,407,53,128,100,279,53,63,13,130,143,150,67,0,93,140,459
7975,Chris Knight,2008,2009,Bowling Green State,MAC,53,1241,183,405,169,353,14,52,79,122,108,210,318,54,34,36,99,136,459
7976,Ben Nakwaasah,2018,2019,Utah Valley,WAC,69,1459,150,391,72,182,78,209,81,110,13,156,169,181,46,4,113,117,459
7977,Benny Parker,2013,2016,Nebraska,Big Ten,130,2910,159,416,121,281,38,135,103,137,28,196,224,226,137,6,134,254,459
7978,Rob Shaw,2018,2019,Chicago State,WAC,62,1583,197,544,188,476,9,68,56,84,28,122,150,232,62,2,163,94,459
7979,Anthony Vanhook,2016,2017,Charlotte,CUSA,56,1360,179,374,177,368,2,6,99,140,94,192,286,155,55,24,82,164,459
7980,Deron Washington,2008,2008,Virginia Tech,ACC,35,1159,147,353,129,286,18,67,147,219,69,158,227,80,34,22,74,103,459
7981,DaShawn Wright,2008,2009,San Jose State,WAC,58,1347,187,390,180,363,7,27,78,113,86,132,218,65,68,5,95,115,459
7982,Mitch Brewe,2013,2016,UC-Santa Barbara,Big West,110,1684,170,353,149,295,21,58,97,136,135,185,320,52,43,29,61,195,458
7983,Darius Dawkins,2015,2017,Jacksonville,A-Sun,47,971,151,333,26,60,125,273,31,39,15,101,116,19,15,10,27,83,458
7984,Adris DeLeon,2008,2009,Eastern Washington,Big Sky,48,1085,152,438,93,228,59,210,95,128,23,93,116,111,43,3,91,87,458
7985,Matt Derenbecker,2011,2014,Total,Total,73,1429,159,399,71,156,88,243,52,78,18,143,161,67,30,6,65,105,458
7986,Tony Gaffney,2008,2009,Massachusetts,A-10,65,1719,177,340,164,293,13,47,91,149,150,326,476,73,100,174,80,144,458
7987,Greg Heckstall,2018,2019,Hampton,Total,52,1400,154,402,99,229,55,173,95,115,46,303,349,125,23,23,67,125,458
7988,J.J. Hickson,2008,2008,North Carolina State,ACC,31,890,163,276,163,275,0,1,132,195,80,182,262,31,22,47,83,60,458
7989,Devonte Klines,2017,2018,Montana State,Big Sky,64,1494,169,441,142,334,27,107,93,157,38,95,133,106,44,15,102,156,458
7990,Kira Lewis Jr.,2019,2019,Alabama,SEC,34,1075,157,364,103,213,54,151,90,115,13,74,87,98,28,10,74,61,458
7991,Tanner Riley,2011,2014,Portland,WCC,106,1300,166,455,78,182,88,273,38,44,23,77,100,64,24,8,76,126,458
7992,Michael Sands,2008,2010,Yale,Ivy,76,1264,150,314,149,306,1,8,157,217,94,198,292,48,15,5,90,119,458
7993,Edward Simpson,2015,2018,Middle Tennessee,CUSA,134,2635,156,419,50,127,106,292,40,82,26,225,251,204,64,8,86,191,458
7994,Ebuka Anyaorah,2010,2014,Total,Total,93,1327,147,356,92,196,55,160,108,152,47,124,171,50,31,25,100,97,457
7995,John Ashworth,2008,2011,IUPUI,Summit,129,3086,152,414,70,171,82,243,71,93,38,215,253,323,124,11,164,139,457
7996,Devocio Butler,2017,2019,Total,Total,56,1370,157,366,90,196,67,170,76,99,58,145,203,87,54,10,74,102,457
7997,Michael Byron,2011,2014,Gardner-Webb,Big South,124,1797,173,322,173,322,0,0,111,180,160,247,407,25,26,111,110,177,457
7998,Morgan Grim,2008,2012,Total,Total,111,1531,170,309,170,308,0,1,117,178,112,203,315,55,23,57,93,202,457
7999,Damon Huffman,2008,2008,Brown,Ivy,29,1002,154,319,72,137,82,182,67,84,13,77,90,48,35,2,45,50,457
8000,Josh Lomers,2008,2010,Baylor,Big 12,98,1360,176,261,176,261,0,0,105,156,120,142,262,20,35,71,105,246,457
8001,Kellen McCormick,2014,2017,Total,Total,119,1250,156,335,43,77,113,258,32,44,37,110,147,36,14,9,48,124,457
8002,Alex Nunner,2008,2009,Monmouth,NEC,62,1725,149,386,65,145,84,241,75,97,40,163,203,111,49,1,83,102,457
8003,Jason Richards,2008,2008,Davidson,Southern,36,1264,153,371,95,189,58,182,93,125,17,93,110,293,50,4,104,57,457
8004,C.J. Rivers,2015,2018,Drake,MVC,111,2357,180,374,157,291,23,83,74,108,63,370,433,237,86,6,128,122,457
8005,Vinnie Shahid,2019,2019,North Dakota State,Summit,35,1031,143,325,79,150,64,175,107,126,10,95,105,91,26,0,49,60,457
8006,DeAngelo Stewart,2014,2017,Total,Total,75,1314,155,378,54,116,101,262,46,65,37,162,199,56,35,18,43,98,457
8007,Aaron Tate,2014,2017,Robert Morris,NEC,105,2403,190,371,190,371,0,0,77,138,206,322,528,50,62,24,100,174,457
8008,London Warren,2008,2010,Dayton,A-10,106,2148,161,370,160,363,1,7,134,234,64,259,323,372,148,21,228,286,457
8009,Nick Banyard,2013,2017,Total,Total,123,2100,166,419,108,268,58,151,66,123,107,329,436,90,39,27,141,204,456
8010,Naz Bohannon,2018,2019,Youngstown State,Horizon,61,1778,188,430,177,382,11,48,69,116,208,294,502,130,45,10,115,158,456
8011,Etienne Brower,2008,2008,Massachusetts,A-10,36,1085,148,324,66,133,82,191,78,113,74,173,247,58,26,48,49,116,456
8012,Justin Burton,2008,2011,Winthrop,Big South,127,1855,152,475,107,330,45,145,107,146,19,111,130,191,68,8,127,102,456
8013,Tristian Curtis,2013,2016,Coastal Carolina,Big South,114,2069,181,312,179,306,2,6,92,185,220,351,571,35,28,55,87,196,456
8014,Greg Gainey,2013,2015,Texas-Arlington,Total,57,1025,177,366,148,282,29,84,73,101,72,144,216,21,29,17,59,138,456
8015,Javon Greene,2018,2019,George Mason,A-10,66,1514,150,366,95,168,55,198,101,123,29,223,252,70,67,16,79,149,456
8016,Walt Harris,2009,2010,Stephen F. Austin,Southland,60,1307,157,403,99,245,58,158,84,104,12,68,80,70,35,5,57,110,456
8017,Jaylen Johnson,2015,2017,Louisville,ACC,88,1343,189,358,182,340,7,18,71,119,154,180,334,34,30,30,67,163,456
8018,Nigel Johnson,2008,2009,Middle Tennessee,Sun Belt,62,1852,152,390,97,253,55,137,97,141,43,197,240,215,58,10,132,203,456
8019,Lamar Kearse,2011,2012,NJIT,GWC,58,1337,157,416,94,222,63,194,79,116,38,117,155,117,39,3,76,73,456
8020,Anthony Morrow,2008,2008,Georgia Tech,ACC,32,951,154,336,73,155,81,181,67,78,37,93,130,34,36,10,33,60,456
8021,Twann Oakley,2012,2014,Alcorn State,SWAC,56,1315,145,372,70,151,75,221,91,124,26,96,122,46,42,6,71,79,456
8022,Rod Singleton,2011,2012,Montana State,Big Sky,60,1709,146,347,105,235,41,112,123,179,32,126,158,215,54,4,140,116,456
8023,Royce White,2012,2012,Iowa State,Big 12,34,1072,175,328,171,316,4,12,102,205,85,231,316,170,40,32,130,89,456
8024,Alec Wnuk,2015,2018,North Carolina-Asheville,Big South,97,1466,179,341,171,308,8,33,90,152,83,172,255,87,30,13,118,189,456
8025,Jerime Andersen,2011,2012,UCLA,Total,66,1739,162,368,108,232,54,136,77,121,20,139,159,224,85,14,108,109,455
8026,Deverell Biggs,2014,2015,Total,Total,41,1061,162,357,128,268,34,89,97,134,26,110,136,73,58,12,103,106,455
8027,Angelo Chol,2012,2016,Total,Total,136,1649,184,355,184,355,0,0,87,142,152,212,364,27,40,77,113,250,455
8028,David Cubillan,2008,2010,Marquette,Big East,99,1959,156,392,58,123,98,269,45,60,31,94,125,170,59,5,71,112,455
8029,Erik Fromm,2011,2014,Butler,Total,128,1547,163,428,107,232,56,196,73,117,118,151,269,20,32,28,77,202,455
8030,Zach Hunsaker,2018,2019,Brown,Ivy,59,1643,147,385,66,151,81,234,80,91,16,137,153,90,61,5,91,153,455
8031,Justin Jackson,2017,2018,Maryland,Big Ten,44,1240,154,368,98,223,56,145,91,125,85,203,288,52,38,35,86,87,455
8032,Christian Kabongo,2011,2012,New Mexico State,WAC,44,1167,141,373,117,262,24,111,149,205,31,102,133,120,40,6,128,93,455
8033,Keion Mitchem,2008,2010,Texas Christian,MWC,92,1684,161,408,74,177,87,231,46,61,26,115,141,113,59,2,101,135,455
8034,Rasean Simpson,2013,2016,Morgan State,MEAC,89,1343,157,384,143,333,14,51,127,188,116,153,269,32,54,16,67,132,455
8035,Kurt Alexander,2011,2012,Drake,MVC,64,1240,153,379,130,318,23,61,125,163,11,104,115,105,39,4,111,137,454
8036,Sam Beeler,2013,2016,UC-Santa Barbara,Big West,127,1572,193,315,193,315,0,0,68,146,118,236,354,29,20,75,92,258,454
8037,Che Bob,2017,2018,Colorado State,MWC,48,1099,152,339,127,259,25,80,125,184,79,186,265,68,41,55,97,127,454
8038,Ke'Ron Brown,2013,2015,Hampton,MEAC,92,2155,151,448,130,320,21,128,131,234,117,251,368,128,151,24,156,268,454
8039,Michal Cekovsky,2015,2018,Maryland,Big Ten,104,1325,190,306,190,304,0,2,74,142,93,170,263,27,19,78,76,218,454
8040,Vance Cooksey,2008,2010,Youngstown State,Horizon,89,1721,133,355,84,207,49,148,139,185,37,131,168,198,87,3,147,155,454
8041,Josh Hearlihy,2014,2018,Total,Total,99,1453,141,346,91,213,50,133,122,162,45,169,214,123,31,8,122,119,454
8042,Roy Hibbert,2008,2008,Georgetown,Big East,34,894,179,294,176,291,3,3,93,144,75,141,216,63,18,75,57,92,454
8043,Shawn Huff,2008,2008,Valparaiso,Horizon,36,1130,153,314,62,124,91,190,57,68,42,119,161,56,10,18,77,75,454
8044,Dwayne Jackson,2008,2009,Binghamton,AEC,47,1123,143,342,80,164,63,178,105,133,58,99,157,43,32,12,54,108,454
8045,Ty Jones,2018,2019,Charleston Southern,Big South,64,1301,183,365,171,325,12,40,76,96,85,127,212,76,31,18,97,109,454
8046,Tyler Madison,2014,2017,Alabama-Birmingham,CUSA,117,1329,156,340,147,304,9,36,133,198,138,133,271,82,29,19,73,203,454
8047,Marquis Navarre,2009,2010,Montana State,Big Sky,57,1676,155,359,116,245,39,114,105,142,27,109,136,163,42,4,109,159,454
8048,Kevin Panzer,2011,2015,Total,Total,118,1979,162,433,108,255,54,178,76,120,97,252,349,88,21,49,118,178,454
8049,Mawdo Sallah,2015,2019,Total,Total,105,1612,200,378,200,378,0,0,54,102,130,253,383,27,20,92,77,240,454
8050,Andre Stephens,2008,2010,Southern Mississippi,CUSA,89,1672,171,355,171,355,0,0,112,187,140,213,353,24,28,44,80,215,454
8051,Jaroslav Tyrna,2008,2010,New Orleans,Sun Belt,92,1842,167,353,143,280,24,73,96,166,122,217,339,65,38,45,147,226,454
8052,Caleb Wood,2017,2018,Pennsylvania,Ivy,53,975,153,342,62,101,91,241,57,71,21,79,100,49,21,3,59,80,454
8053,Nysier Brooks,2017,2019,Cincinnati,AAC,103,1422,165,315,165,315,0,0,123,202,146,209,355,24,29,93,72,223,453
8054,Deonte Huff,2008,2008,Portland State,Big Sky,33,1012,155,307,131,229,24,78,119,159,71,128,199,85,42,6,81,69,453
8055,Justin Patton,2017,2017,Creighton,Big East,35,885,200,296,192,281,8,15,45,87,59,159,218,41,30,50,60,96,453
8056,Matt Roth,2009,2012,Indiana,Big Ten,95,1291,141,336,15,33,126,303,45,51,18,61,79,33,26,4,24,73,453
8057,Danny Thompson,2009,2012,Mount St. Mary's,NEC,95,1760,173,377,173,377,0,0,107,183,182,272,454,34,55,95,90,183,453
8058,Demetrius Young,2008,2009,Stony Brook,AEC,57,1389,190,296,178,276,12,20,61,82,139,183,322,26,44,20,48,98,453
8059,Pierre Bland,2013,2014,Purdue-Fort Wayne,Summit,69,1907,163,328,138,267,25,61,101,154,44,208,252,251,91,8,124,132,452
8060,Garrison Brooks,2018,2019,North Carolina,ACC,73,1368,181,325,181,325,0,0,90,146,143,188,331,64,31,29,63,172,452
8061,Bryce Fowler,2018,2019,Sacramento State,Big Sky,63,1766,183,395,143,286,40,109,46,75,54,194,248,152,55,21,109,119,452
8062,Coleman Johnson,2013,2016,Fairfield,MAAC,118,1972,183,440,183,438,0,2,86,131,156,254,410,72,52,128,101,339,452
8063,Jake Kitchell,2012,2015,Indiana State,MVC,124,1766,166,314,140,248,26,66,94,145,128,228,356,76,30,70,95,202,452
8064,JohnMark Ludwick,2008,2012,Total,Total,100,1416,147,347,28,47,119,300,39,51,37,130,167,67,26,17,79,154,452
8065,Jordan Nobles,2016,2019,Total,Total,109,2122,167,379,95,183,72,196,46,68,73,225,298,93,69,56,61,219,452
8066,Issa Thiam,2017,2019,Rutgers,Big Ten,90,1980,162,433,67,150,95,283,33,50,60,200,260,46,52,18,69,123,452
8067,Luis Valera,2009,2010,Texas-Rio Grande Valley,Total,60,1246,168,330,168,328,0,2,116,178,94,161,255,19,19,24,83,169,452
8068,Isaac Banks,2014,2017,East Tennessee State,Total,122,2048,190,324,189,321,1,3,70,147,178,328,506,57,36,75,93,244,451
8069,Justin Blake,2010,2012,Austin Peay,OVC,94,1353,144,388,38,75,106,313,57,88,17,81,98,83,27,5,59,102,451
8070,Aaron Bowen,2011,2015,Georgetown,Big East,111,1410,181,375,153,265,28,110,61,124,81,146,227,66,68,22,91,172,451
8071,Kyle Brucculeri,2008,2009,UC-Davis,Big West,63,1333,150,392,46,109,104,283,47,67,34,136,170,60,20,21,102,162,451
8072,Moustapha Diarra,2010,2011,San Francisco,WCC,64,1004,185,369,185,369,0,0,81,141,94,115,209,22,11,49,89,141,451
8073,Elliott Eliason,2012,2015,Minnesota,Big Ten,139,2179,184,351,184,349,0,2,83,162,205,396,601,116,49,151,106,295,451
8074,Pat Eveland,2010,2011,Pacific,Big West,65,1410,156,419,76,157,80,262,59,85,60,171,231,64,28,13,39,110,451
8075,Cameron Hunter,2018,2019,North Dakota State,Summit,55,1300,133,312,64,144,69,168,116,153,7,130,137,101,38,4,91,111,451
8076,Leroy Isler,2013,2014,Little Rock,Sun Belt,62,1644,143,363,114,270,29,93,136,188,74,131,205,72,57,8,109,159,451
8077,Jonathan Kale,2008,2009,Providence,Big East,57,1175,172,311,172,308,0,3,107,190,106,160,266,29,30,29,80,131,451
8078,Josh Micheaux,2011,2012,Georgia State,CAA,63,1569,155,350,146,317,9,33,132,207,94,218,312,192,83,20,152,143,451
8079,Michael Miller,2018,2019,North Texas,CUSA,63,1230,167,355,121,218,46,137,71,96,94,170,264,66,26,22,86,121,451
8080,Evan Nolte,2013,2016,Virginia,ACC,134,1880,149,382,57,108,92,274,61,85,43,145,188,79,61,30,56,177,451
8081,Sergio Olmos,2008,2009,Temple,A-10,64,1458,182,327,182,325,0,2,87,132,74,172,246,57,22,91,84,185,451
8082,D.J. Peterson,2012,2015,La Salle,A-10,129,2920,148,373,58,118,90,255,65,84,74,256,330,174,95,21,83,223,451
8083,Quantez Robertson,2008,2009,Auburn,SEC,66,2126,141,350,93,189,48,161,121,179,81,209,290,236,118,15,115,157,451
8084,Dru Smith,2017,2018,Evansville,MVC,50,1295,153,292,110,187,43,105,102,120,17,134,151,182,68,22,103,145,451
8085,Antwan Space,2012,2016,Total,Total,87,1619,170,425,144,314,26,111,85,158,96,247,343,72,35,45,104,187,451
8086,Kyle Stout,2017,2019,Lafayette,Patriot,88,1812,154,400,54,106,100,294,43,62,32,215,247,80,33,19,70,160,451
8087,Tim Toler,2011,2012,Northern Illinois,MAC,44,1140,177,404,121,257,56,147,41,56,52,183,235,45,14,17,84,90,451
8088,Anthony White,2013,2014,Mercer,A-Sun,71,1143,150,340,80,165,70,175,81,100,34,90,124,51,26,4,37,85,451
8089,James Beatty,2010,2011,Rutgers,Big East,64,1847,153,373,49,101,104,272,40,61,39,122,161,213,96,8,102,138,450
8090,Jimmy Boeheim,2018,2019,Cornell,Ivy,57,1075,171,398,124,241,47,157,61,96,37,126,163,43,17,19,51,80,450
8091,Bryant Dunston,2008,2008,Fordham,A-10,29,961,165,314,160,285,5,29,115,176,90,194,284,57,29,79,55,67,450
8092,Jordon Harris,2017,2018,Louisiana-Monroe,Sun Belt,55,1407,166,440,80,192,86,248,32,43,27,90,117,144,57,2,102,81,450
8093,Jeriah Horne,2017,2019,Total,Total,61,1047,162,378,91,181,71,197,55,70,41,172,213,42,30,18,66,90,450
8094,Dakari Johnson,2014,2015,Kentucky,SEC,78,1185,161,300,161,300,0,0,128,229,146,187,333,40,23,59,67,148,450
8095,Mitch Johnson,2008,2009,Stanford,Pac-10,68,2065,156,371,102,229,54,142,84,126,24,211,235,333,67,4,153,132,450
8096,Wendell Mitchell,2017,2019,Total,Total,54,1109,153,387,89,195,64,192,80,98,28,113,141,83,58,6,97,96,450
8097,Jordan Robertson,2015,2018,Colgate,Patriot,101,1345,160,398,108,242,52,156,78,124,59,89,148,40,22,22,78,138,450
8098,Matt Shaw,2008,2010,Nevada-Las Vegas,MWC,65,1102,155,348,104,215,51,133,89,118,70,156,226,35,25,36,41,147,450
8099,Bilal Abdullah,2008,2008,Lafayette,Patriot,30,937,137,288,76,152,61,136,114,153,49,108,157,74,25,16,90,80,449
8100,Jordan Boots,2011,2013,South Dakota,Total,91,1678,155,408,50,107,105,301,34,44,28,70,98,118,49,1,79,59,449
8101,Dimitrije Cabarkapa,2014,2017,James Madison,CAA,77,917,168,371,102,195,66,176,47,56,51,145,196,12,10,8,56,71,449
8102,Terrel de Rouen,2012,2015,Total,Total,67,1405,157,409,101,229,56,180,79,123,21,117,138,127,48,6,115,161,449
8103,Kevin Degnan,2015,2019,Total,MAAC,96,1598,166,392,81,166,85,226,32,56,58,244,302,46,45,29,49,119,449
8104,Del'Vin Dickerson,2015,2017,Total,Total,65,1156,170,367,135,244,35,123,74,125,66,166,232,27,32,22,54,173,449
8105,George Drake,2008,2010,Total,Total,97,1652,156,454,117,274,39,180,98,127,81,146,227,79,62,34,84,129,449
8106,Karl Gamble,2016,2019,Middle Tennessee,CUSA,127,1552,173,389,153,331,20,58,83,151,150,226,376,32,39,43,79,187,449
8107,Edon Maxhuni,2018,2019,Long Beach State,Big West,67,1148,150,389,67,181,83,208,66,73,15,71,86,70,20,0,91,92,449
8108,Eric Meister,2008,2010,Holy Cross,Patriot,78,1853,191,379,191,379,0,0,67,121,148,252,400,50,36,64,90,148,449
8109,Titus Rubles,2013,2014,Cincinnati,Total,68,1725,149,400,145,354,4,46,147,205,144,286,430,134,82,37,114,181,449
8110,Derrick Alston,2018,2019,Boise State,MWC,44,946,148,306,91,158,57,148,95,118,22,114,136,39,15,13,51,65,448
8111,Josh Brown,2010,2011,Towson,CAA,59,1380,161,371,106,228,55,143,71,92,19,84,103,86,54,4,72,92,448
8112,Torry Butler,2016,2017,Sam Houston State,Southland,68,1345,180,369,164,303,16,66,72,122,117,299,416,79,56,36,66,185,448
8113,Bruce Carter,2008,2008,Murray State,OVC,31,854,161,331,117,217,44,114,82,100,48,125,173,60,32,7,55,93,448
8114,DaJuan Coleman,2013,2017,Syracuse,Total,91,1388,169,327,169,326,0,1,110,198,167,234,401,25,51,58,98,192,448
8115,Derrick Favors,2010,2010,Georgia Tech,ACC,36,989,179,293,179,292,0,1,90,143,108,195,303,37,32,74,90,94,448
8116,Corey Gray,2010,2014,Total,Total,115,1881,151,422,74,183,77,239,69,109,37,90,127,137,50,2,119,174,448
8117,Justin Leon,2016,2017,Florida,SEC,70,1310,164,359,90,169,74,190,46,69,95,157,252,28,27,10,49,134,448
8118,Brandon Crawford,2009,2012,Total,Total,70,1412,154,325,126,257,28,68,111,167,89,157,246,86,45,20,80,140,447
8119,Jelani Currie,2013,2016,Texas A&M-Corpus Christi,Southland,110,1842,151,361,113,254,38,107,107,164,81,163,244,79,48,26,87,158,447
8120,Matthew Grant,2014,2017,Detroit Mercy,Horizon,95,1840,136,414,69,186,67,228,108,134,29,168,197,122,62,17,70,183,447
8121,Marcus Hall,2008,2008,Colorado,Big 12,32,1202,171,359,118,220,53,139,52,77,29,95,124,128,58,7,71,61,447
8122,Maceo Jack,2018,2019,George Washington,A-10,57,1134,153,376,78,163,75,213,66,77,31,117,148,37,19,14,55,69,447
8123,Darnell Jackson,2008,2008,Kansas,Big 12,40,971,171,273,169,267,2,6,103,149,81,186,267,43,31,19,51,90,447
8124,Isiah Martin,2008,2011,Indiana State,MVC,113,1555,178,326,178,325,0,1,91,159,127,179,306,26,28,136,71,210,447
8125,Dallas Polk-Hilliard,2018,2019,Total,Total,39,1100,164,353,103,216,61,137,58,94,41,149,190,31,23,25,57,84,447
8126,Collin Smith,2017,2019,Total,Total,68,1323,165,363,146,304,19,59,98,165,89,238,327,64,34,38,108,197,447
8127,Stanley Umude,2018,2019,South Dakota,Summit,44,844,160,332,134,255,26,77,101,144,32,140,172,43,23,39,57,92,447
8128,Hassan Whiteside,2010,2010,Marshall,CUSA,34,889,167,319,164,314,3,5,110,187,92,211,303,10,19,182,64,82,447
8129,Keith Williams,2018,2019,Cincinnati,AAC,68,1228,170,392,145,289,25,103,82,124,62,90,152,52,54,36,77,107,447
8130,Petras Balocka,2009,2010,Hawaii,WAC,54,1182,149,350,136,295,13,55,135,219,138,231,369,90,18,7,122,118,446
8131,Jomaru Brown,2019,2019,Eastern Kentucky,OVC,31,770,158,360,120,245,38,115,92,136,20,73,93,67,60,2,85,95,446
8132,Brian Butch,2008,2008,Wisconsin,Big Ten,36,885,162,355,137,274,25,81,97,150,77,160,237,29,20,29,51,69,446
8133,Ben Cherry,2010,2014,Total,Total,113,1629,141,340,33,95,108,245,56,70,15,76,91,59,29,1,60,140,446
8134,Justin Childs,2013,2014,Tennessee-Martin,OVC,60,1378,164,417,135,308,29,109,89,122,62,152,214,86,81,15,123,125,446
8135,Derek Drews,2008,2009,Western Michigan,MAC,63,1256,157,390,64,136,93,254,39,49,41,118,159,52,14,5,75,103,446
8136,Corvonn Gaines,2010,2013,East Carolina,CUSA,113,2478,154,373,110,223,44,150,94,184,67,210,277,243,117,20,136,190,446
8137,Blake Jolivette,2010,2013,American,Patriot,78,1678,168,442,135,364,33,78,77,108,25,136,161,128,31,0,133,95,446
8138,Shemiye McLendon,2011,2014,Total,Total,90,1803,156,461,104,275,52,186,82,113,44,127,171,129,53,7,132,138,446
8139,Karmari Newman,2017,2019,Total,Total,63,1199,143,382,58,129,85,253,75,97,25,92,117,51,30,4,59,86,446
8140,Brandon Pokley,2010,2013,Western Michigan,MAC,96,1545,133,342,38,94,95,248,85,97,40,121,161,46,28,9,79,118,446
8141,Eric Smith ,2011,2014,Total,Total,121,2037,151,440,94,244,57,196,87,133,24,108,132,195,51,2,150,121,446
8142,Matt Taylor,2015,2017,New Mexico State,WAC,94,1841,164,387,130,264,34,123,84,138,75,187,262,155,45,41,135,172,446
8143,Vinny Zollo,2012,2016,Total,Total,97,1605,158,435,97,228,61,207,69,98,123,231,354,74,27,38,105,182,446
8144,Paschal Chukwu,2015,2019,Total,Total,111,2114,160,237,160,237,0,0,125,208,228,313,541,30,62,185,100,293,445
8145,Jason Holmes,2010,2013,Total,Total,90,1497,178,362,165,325,13,37,76,140,88,224,312,28,41,78,104,199,445
8146,Kelvin McConnell,2010,2011,Kennesaw State,A-Sun,64,1681,139,365,44,111,95,254,72,90,15,58,73,111,39,2,93,107,445
8147,Joey Miller,2012,2014,Total,Total,69,1345,130,397,72,207,58,190,127,162,21,95,116,115,51,8,109,72,445
8148,Dwight O'Neil,2008,2009,Fresno State,WAC,39,1233,156,388,104,222,52,166,81,146,34,127,161,142,51,6,126,94,445
8149,Kingsley Okoroh,2015,2018,University of California,Pac-12,127,2255,176,380,176,380,0,0,93,162,182,304,486,71,32,201,122,303,445
8150,Dominique Reid,2015,2018,Total,Total,63,1022,161,363,158,354,3,9,120,175,95,189,284,38,16,21,101,146,445
8151,Aleksej Rostov,2013,2016,Western Kentucky,Total,117,1465,160,349,133,249,27,100,98,140,120,181,301,46,17,29,101,238,445
8152,Garrett Temple,2008,2009,Louisiana State,SEC,66,2126,137,365,86,198,51,167,120,151,74,216,290,245,101,48,140,189,445
8153,Tristin Walley,2018,2019,Arkansas State,Sun Belt,62,1450,140,366,90,210,50,156,115,163,112,197,309,59,43,39,76,139,445
8154,Kenny Wooten,2018,2019,Oregon,Pac-12,70,1528,182,286,182,284,0,2,81,128,95,231,326,33,35,165,80,185,445
8155,Edward Alade,2014,2017,Navy,Patriot,120,1678,199,341,199,340,0,1,46,99,155,187,342,63,32,49,97,209,444
8156,Marquiz Baker,2011,2011,Alcorn State,SWAC,28,793,128,382,71,219,57,163,131,168,29,65,94,31,45,0,65,56,444
8157,J.B. Conley,2010,2011,Texas State,Southland,62,1020,154,341,130,252,24,89,112,177,79,109,188,31,31,9,87,138,444
8158,Tim Diederichs,2008,2012,Loyola Marymount,WCC,105,1602,161,322,161,318,0,4,122,207,84,134,218,68,30,15,90,193,444
8159,Malik Dunbar,2018,2019,Auburn,SEC,72,1173,162,375,93,176,69,199,51,85,44,161,205,31,46,23,61,135,444
8160,Randy Hampton,2008,2009,Howard,MEAC,46,1227,156,318,133,242,23,76,109,186,67,128,195,61,30,21,122,133,444
8161,Josh Heath,2014,2017,Total,Total,115,2558,161,411,140,329,21,82,101,140,40,151,191,384,90,13,180,182,444
8162,Jamal Johnson,2011,2014,Cal Poly,Big West,128,2372,134,390,87,246,47,144,129,186,36,154,190,300,92,6,145,209,444
8163,Jeffery Ricard ,2013,2014,Southeastern Louisiana,Southland,57,1470,153,401,123,288,30,113,108,142,35,125,160,88,40,9,113,161,444
8164,Steven Shepp,2010,2012,Fresno State,WAC,87,2717,146,415,66,156,80,259,72,122,26,204,230,395,134,27,170,177,444
8165,Ian Sistare,2017,2019,Dartmouth,Ivy,78,1441,149,335,90,166,59,169,87,110,34,192,226,101,17,3,96,91,444
8166,Brian Starr,2017,2018,Towson,CAA,63,1725,149,363,97,207,52,156,94,125,19,130,149,138,63,8,100,110,444
8167,Trent Whiting,2013,2016,Arkansas-Pine Bluff,SWAC,124,1860,174,385,152,307,22,78,74,133,82,167,249,92,61,49,105,157,444
8168,Eric Adams,2014,2018,Samford,Southern,92,1211,167,267,167,266,0,1,109,157,130,213,343,33,58,84,79,186,443
8169,Devin Gage,2017,2019,DePaul,Big East,69,1489,171,414,154,341,17,73,84,115,25,112,137,178,74,12,122,126,443
8170,Malek Green,2018,2019,Morehead State,OVC,61,1360,179,351,166,307,13,44,72,112,92,226,318,20,26,35,52,126,443
8171,Brandon Nazione,2015,2016,Eastern Michigan,MAC,68,1429,154,314,141,277,13,37,122,169,101,235,336,52,56,25,82,158,443
8172,Deriece Parks,2016,2018,Western Carolina,Southern,50,1297,154,425,68,144,86,281,49,62,44,117,161,111,57,12,91,53,443
8173,Khion Sankey,2013,2014,Lipscomb,A-Sun,57,1553,155,342,111,216,44,126,89,165,123,235,358,140,70,23,107,183,443
8174,Kim Tillie,2008,2010,Utah,MWC,87,1451,159,329,153,304,6,25,119,147,140,272,412,56,42,33,95,233,443
8175,Patrick Wallace,2014,2017,Total,Total,72,1277,145,390,28,60,117,330,36,44,10,70,80,77,21,1,60,109,443
8176,Jack Whitman,2015,2017,William & Mary,CAA,81,1283,160,259,160,259,0,0,123,216,118,172,290,60,19,67,84,195,443
8177,Brooks Ybarra,2010,2012,Texas State,Southland,55,968,147,303,67,125,80,178,69,87,44,92,136,52,44,21,48,89,443
8178,James Akinjo,2019,2019,Georgetown,Big East,33,1043,128,351,76,218,52,133,134,165,7,89,96,173,37,1,100,81,442
8179,Jarrett Allen,2017,2017,Texas,Big 12,33,1061,179,316,179,309,0,7,84,149,100,178,278,27,19,51,84,68,442
8180,Zarko Comagic,2008,2009,Northern Arizona,Big Sky,57,1194,157,341,122,244,35,97,93,131,67,161,228,45,39,14,72,111,442
8181,Juan Davis Jr.,2017,2018,Troy,Sun Belt,68,1399,153,332,77,135,76,197,60,79,84,204,288,15,21,21,53,143,442
8182,Ayo Dosunmu,2019,2019,Illinois,Big Ten,32,1000,163,374,113,232,50,142,66,95,23,105,128,104,40,8,72,64,442
8183,Devon Dotson,2019,2019,Kansas,Big 12,36,1168,147,305,114,214,33,91,115,147,22,110,132,127,49,5,81,91,442
8184,Justin Graham,2014,2016,Hartford,AEC,91,1761,139,377,87,215,52,162,112,158,18,135,153,119,65,2,112,134,442
8185,Josh Hopkins,2018,2019,New Hampshire,AEC,54,1384,147,424,54,139,93,285,55,83,41,88,129,48,12,8,47,98,442
8186,Garrett Johnson,2010,2013,Fresno State,Total,105,1444,156,422,85,191,71,231,59,83,50,126,176,60,52,12,64,135,442
8187,Marcus Johnson,2015,2016,Samford,Southern,65,1397,152,373,85,163,67,210,71,104,33,106,139,121,57,3,82,90,442
8188,Michael Mayhew,2017,2019,Portland State,Big Sky,72,1126,142,379,37,89,105,290,53,68,59,78,137,72,55,1,67,120,442
8189,Hunter Mickelson,2012,2016,Total,Total,109,1397,192,414,190,402,2,12,56,82,113,204,317,45,58,150,77,201,442
8190,Vado Morse,2019,2019,Mount St. Mary's,NEC,30,923,141,338,83,175,58,163,102,131,13,64,77,87,32,1,72,68,442
8191,Johann Mpondo,2009,2012,Total,Total,117,2236,172,378,172,375,0,3,98,158,130,271,401,37,32,31,127,264,442
8192,Gavin Schilling,2014,2018,Michigan State,Big Ten,134,1527,172,296,172,296,0,0,98,181,159,241,400,51,23,53,96,259,442
8193,Akeem Williams,2014,2014,Massachusetts-Lowell,AEC,28,896,145,379,91,222,54,157,98,122,26,88,114,95,36,2,90,67,442
8194,Christian Carlyle,2017,2019,Florida Gulf Coast,A-Sun,79,1440,162,349,138,280,24,69,93,138,62,128,190,119,60,13,74,152,441
8195,Chris Colvin,2010,2013,Total,Total,88,1849,147,420,110,293,37,127,110,206,42,160,202,228,69,6,201,172,441
8196,Antonio Flaggs,2009,2010,Sacramento State,Big Sky,58,1392,133,357,54,152,79,205,96,121,18,112,130,76,44,10,67,116,441
8197,Gyorgy Goloman,2015,2018,UCLA,Pac-12,118,1764,169,323,142,250,27,73,76,133,105,214,319,86,60,87,85,280,441
8198,Jared Hamilton,2016,2019,Total,Total,58,1531,177,414,168,361,9,53,78,124,89,121,210,58,42,14,54,86,441
8199,Cameron Michael,2015,2016,Northern Colorado,Big Sky,33,958,151,350,78,160,73,190,66,84,12,95,107,45,22,2,46,78,441
8200,Robby Pride,2008,2010,Dartmouth,Ivy,82,1574,162,383,119,240,43,143,74,101,61,140,201,106,72,10,110,148,441
8201,Darius Quisenberry,2019,2019,Youngstown State,Horizon,32,870,142,346,91,186,51,160,106,133,12,82,94,120,43,1,65,72,441
8202,Kaiden Rice,2018,2019,Citadel,Southern,51,804,156,389,53,90,103,299,26,37,37,81,118,20,29,1,36,37,441
8203,Jonathon Simmons,2012,2012,Houston,CUSA,30,902,154,301,122,218,32,83,101,141,42,107,149,65,21,11,100,75,441
8204,Nick DelTufo,2008,2011,Monmouth,NEC,118,1823,155,361,137,285,18,76,112,168,83,139,222,59,36,26,130,234,440
8205,Tyler Ennis,2014,2014,Syracuse,ACC,34,1215,148,360,118,275,30,85,114,149,27,88,115,187,71,6,58,69,440
8206,Josh Harrellson,2009,2011,Kentucky,SEC,94,1486,185,337,176,308,9,29,61,94,181,260,441,39,46,84,60,136,440
8207,Devin Haygood,2016,2018,Youngstown State,Horizon,82,1301,187,337,187,336,0,1,66,144,124,162,286,45,30,80,100,245,440
8208,Delvon Johnson,2008,2011,Total,Total,86,1612,171,314,171,314,0,0,98,170,136,248,384,29,32,120,77,152,440
8209,Ronnel Jordan,2015,2016,New Hampshire,AEC,63,1294,170,409,115,241,55,168,45,79,37,153,190,56,18,8,62,88,440
8210,Ryan Manning,2015,2018,Air Force,MWC,92,1203,152,385,80,155,72,230,64,87,65,122,187,48,24,13,53,91,440
8211,Kleon Penn,2008,2009,McNeese State,Southland,58,1443,180,286,180,284,0,2,80,133,119,228,347,29,12,219,84,139,440
8212,Xavian Rimmer,2014,2015,Louisiana,Sun Belt,70,1439,128,322,52,120,76,202,108,135,24,103,127,84,36,1,74,120,440
8213,Josh Tarver,2008,2010,Oregon State,Pac-10,98,2045,165,418,144,315,21,103,89,137,50,135,185,181,89,18,136,172,440
8214,CJ Walker,2017,2018,Florida State,ACC,68,1227,148,364,92,198,56,166,88,126,21,114,135,129,55,7,86,139,440
8215,Jasper Williams,2009,2013,Total,Total,118,1783,130,460,32,124,98,336,82,123,37,141,178,158,71,2,155,184,440
8216,Chad Andrews-Fulton,2018,2019,Coppin State,MEAC,62,1459,153,337,139,296,14,41,119,190,141,218,359,79,39,27,128,193,439
8217,Jerrald Bonham,2008,2010,Centenary (LA),Summit,90,767,161,331,156,313,5,18,112,163,58,82,309,61,60,51,108,106,439
8218,T.J. Dunans,2016,2017,Auburn,SEC,47,1224,170,412,141,298,29,114,70,112,25,123,148,130,56,39,121,118,439
8219,Ken'Darrius Hamilton,2017,2018,Tennessee State,OVC,56,1201,165,366,113,203,52,163,57,72,67,161,228,35,31,35,104,180,439
8220,Alfonzo Hubbard,2012,2013,Utah Valley,GWC,50,1124,171,358,152,296,19,62,78,114,69,151,220,73,41,19,72,67,439
8221,Austin Montgomery,2008,2008,IUPUI,Summit,32,967,150,316,78,146,72,170,67,76,22,76,98,51,33,11,56,69,439
8222,Nathan Sobey,2013,2014,Wyoming,MWC,66,1434,145,340,105,212,40,128,109,161,25,119,144,88,28,12,64,109,439
8223,Paul Stoll,2008,2008,Texas-Rio Grande Valley,Ind,31,1026,108,222,22,41,86,181,137,161,6,75,81,224,79,4,109,82,439
8224,Hooper Vint,2012,2016,Texas-El Paso,CUSA,101,1376,181,341,168,286,13,55,64,104,86,194,280,43,8,61,83,192,439
8225,Josh Wallace,2010,2013,Auburn,SEC,118,2429,148,395,137,352,11,43,132,203,34,158,192,302,119,6,155,198,439
8226,Austin White,2015,2018,High Point,Big South,120,1901,153,379,134,308,19,71,114,160,20,126,146,90,65,3,67,164,439
8227,Jawaan Alston,2008,2011,Buffalo,MAC,117,1833,183,331,183,330,0,1,72,156,167,182,349,83,40,33,131,291,438
8228,Anthony Banks,2011,2011,Florida Gulf Coast,A-Sun,30,926,164,335,164,333,0,2,110,155,106,85,191,26,23,13,73,78,438
8229,Calvin Brock,2008,2009,Illinois,Big Ten,69,1368,173,384,149,315,24,69,68,105,97,143,240,77,55,14,87,145,438
8230,Josh Carlton,2018,2019,Connecticut,AAC,65,1218,168,294,168,294,0,0,102,160,144,178,322,24,24,83,85,180,438
8231,Scott Cutley,2008,2008,Cal State Fullerton,Big West,30,987,175,339,164,304,11,35,77,127,65,158,223,85,37,6,77,61,438
8232,Cartier Diarra,2018,2019,Kansas State,Big 12,63,1541,145,328,84,170,61,158,87,122,40,138,178,117,52,11,113,142,438
8233,Shaquille Duncan,2012,2014,Morgan State,MEAC,87,1505,186,338,186,336,0,2,66,143,101,167,268,44,26,108,93,171,438
8234,Brendon Lavender,2009,2012,Arizona,Total,130,1568,142,348,34,85,108,263,46,65,14,93,107,94,33,9,63,118,438
8235,Tommy Mason-Griffin,2010,2010,Oklahoma,Big 12,31,1107,147,369,77,204,70,165,74,91,15,74,89,154,28,0,87,41,438
8236,Nick Petkovich,2009,2012,Lafayette,Patriot,104,1218,151,384,36,83,115,301,21,34,59,161,220,37,37,26,56,156,438
8237,Troy Reid-Knight,2014,2016,Maine,AEC,82,1517,141,368,72,170,69,198,87,125,49,119,168,132,58,3,134,173,438
8238,Baylee Steele,2017,2019,Total,Total,68,1346,162,295,160,284,2,11,112,146,118,264,382,32,39,42,70,178,438
8239,Marcus Stout,2008,2008,Fordham,A-10,29,975,152,379,79,169,73,210,61,84,19,52,71,85,29,0,69,76,438
8240,Junior Treasure,2010,2010,Texas Southern,SWAC,30,834,136,341,83,165,53,176,113,146,12,63,75,87,55,3,101,93,438
8241,Dominique Williams,2014,2018,Total,Total,84,1605,171,399,148,314,23,85,73,106,91,209,300,46,40,16,72,128,438
8242,R.J. Williams,2012,2014,Loyola (MD),Total,77,2183,133,367,101,263,32,104,140,191,35,124,159,261,124,7,154,172,438
8243,Derrick Bails,2008,2011,Little Rock,Sun Belt,110,1206,173,399,173,396,0,3,91,164,95,239,334,20,23,49,107,162,437
8244,Tony Boyle,2008,2009,Southern Illinois,MVC,63,1274,148,306,148,305,0,1,141,200,97,158,255,25,29,12,75,170,437
8245,Herb Courtney,2008,2008,Delaware,CAA,31,1035,153,345,123,247,30,98,101,166,51,141,192,34,39,43,78,107,437
8246,Zack Gibson,2008,2010,Michigan,Big Ten,99,1188,171,339,147,246,24,93,71,102,103,129,232,35,42,65,65,165,437
8247,Collin Hartman,2014,2018,Indiana,Big Ten,106,1822,156,352,82,141,74,211,51,72,107,177,284,110,58,34,70,219,437
8248,R.J. McCray,2011,2014,Louisiana-Monroe,Sun Belt,100,1951,157,372,116,256,41,116,82,127,25,129,154,133,63,16,133,106,437
8249,Michael Orock,2008,2010,Wagner,NEC,87,1408,178,323,178,323,0,0,81,174,133,185,318,34,31,53,104,192,437
8250,Cletrell Pope,2019,2019,Bethune-Cookman,MEAC,31,927,172,283,169,272,3,11,90,178,134,243,377,21,25,38,61,110,437
8251,Kevin Scott,2017,2018,Texas Southern,SWAC,42,1205,161,378,118,251,43,127,72,101,67,131,198,81,55,10,79,102,437
8252,Tahj Shamsid-Deen,2014,2016,Auburn,SEC,58,1472,150,389,87,188,63,201,74,101,13,63,76,129,44,2,58,123,437
8253,Dwight Tarwater,2011,2015,Total,Total,112,1870,159,419,88,188,71,231,48,71,104,229,333,59,23,21,60,173,437
8254,Jamal Wright,2017,2019,High Point,Big South,83,1687,143,374,87,193,56,181,95,140,14,134,148,178,79,6,121,147,437
8255,Tajuan Agee,2019,2019,Iona,MAAC,33,908,151,330,116,232,35,98,99,136,60,205,265,37,33,23,79,119,436
8256,Mike Anderson,2014,2015,Washington,Pac-12,63,1808,134,305,85,176,49,129,119,166,105,263,368,134,43,24,101,165,436
8257,Jamal Branch,2012,2015,Total,Total,89,1722,170,392,148,317,22,75,74,107,36,143,179,198,63,9,119,138,436
8258,Ja'Michael Brown,2016,2017,North Texas,CUSA,62,1604,157,418,76,175,81,243,41,77,21,118,139,124,74,5,100,121,436
8259,Umoja Gibson,2018,2019,North Texas,CUSA,35,997,138,346,35,84,103,262,57,72,13,83,96,67,49,3,71,89,436
8260,Ithiel Horton,2019,2019,Delaware,CAA,33,1075,151,349,72,156,79,193,55,70,14,89,103,52,33,4,47,71,436
8261,KJ Jackson,2019,2019,Maryland-Baltimore County,AEC,34,1098,156,384,111,233,45,151,79,114,24,104,128,106,77,14,114,87,436
8262,Kosta Jankovic,2016,2019,Kennesaw State,A-Sun,77,1390,167,414,132,314,35,100,67,94,54,175,229,93,16,8,102,103,436
8263,Trent Meyer,2011,2013,North Carolina-Asheville,Big South,92,1681,147,408,62,145,85,263,57,76,32,115,147,181,93,17,107,119,436
8264,Brian Morris,2009,2011,Towson,CAA,91,2284,134,387,72,192,62,195,106,161,30,215,245,315,60,12,154,150,436
8265,Calvin O'Neil,2008,2010,Middle Tennessee,Sun Belt,66,1723,144,308,136,287,8,21,140,196,119,133,252,95,52,9,68,126,436
8266,John Peterson,2009,2013,Total,Total,107,1545,139,323,64,116,75,207,83,114,50,132,182,57,30,9,65,150,436
8267,Jovante' Spivey,2016,2017,Sam Houston State,Southland,67,1331,113,328,74,189,39,139,171,232,31,100,131,136,39,6,81,121,436
8268,Diamond Stone,2016,2016,Maryland,Big Ten,35,807,167,294,167,294,0,0,102,134,77,111,188,15,18,55,53,80,436
8269,Nathan Taphorn,2014,2017,Northwestern,Big Ten,109,1241,149,334,48,90,101,244,37,55,37,120,157,60,20,17,66,126,436
8270,Shane Temara,2017,2018,North Texas,CUSA,59,1193,170,380,116,208,54,172,42,77,92,185,277,21,11,47,46,87,436
8271,Taurean Thompson,2017,2019,Total,Total,61,885,180,362,170,317,10,45,66,99,72,116,188,23,30,45,65,122,436
8272,Raynere Thornton,2018,2019,Memphis,AAC,70,1640,153,319,116,216,37,103,93,154,115,237,352,77,58,25,91,135,436
8273,Austin Vereen,2016,2018,Virginia Military Institute,Southern,85,1477,134,391,53,138,81,253,87,113,52,165,217,56,48,22,73,140,436
8274,Jeremiah Wood,2008,2008,Akron,MAC,31,890,168,330,162,321,6,9,94,165,97,143,240,77,36,14,89,85,436
8275,Kyle Zunic,2018,2019,Winthrop,Big South,56,1142,149,360,73,138,76,222,62,89,34,130,164,90,35,10,96,71,436
8276,Terrell Allen,2011,2014,Central Connecticut State,NEC,116,1699,156,371,130,282,26,89,97,146,136,201,337,48,27,60,75,174,435
8277,R.J. Buck,2010,2013,North Carolina A&T,MEAC,107,1725,143,306,135,267,8,39,141,224,98,154,252,81,45,11,89,168,435
8278,Taran Buie,2011,2013,Total,Total,41,1131,144,456,84,245,60,211,87,131,33,96,129,57,30,5,100,64,435
8279,Myles Carter,2016,2019,Total,Total,47,1040,167,351,161,336,6,15,95,156,82,191,273,17,10,57,80,131,435
8280,James Douglas,2012,2013,Total,Total,60,1271,155,383,95,215,60,168,65,88,26,101,127,98,50,2,96,67,435
8281,Kameron Gibson,2019,2019,Western Carolina,Southern,32,985,159,347,81,154,78,193,39,57,13,54,67,62,17,6,71,99,435
8282,Brandon Lampley,2008,2009,Ball State,MAC,61,1685,139,356,89,208,50,148,107,144,17,123,140,132,49,1,92,105,435
8283,Ryan Martin,2016,2016,Tennessee Tech,OVC,31,895,132,254,115,197,17,57,154,197,74,179,253,36,18,21,61,108,435
8284,Olivier Mbaigoto,2012,2013,Central Michigan,MAC,62,1228,159,390,123,265,36,125,81,116,104,163,267,27,27,34,66,155,435
8285,Nuni Omot,2017,2018,Baylor,Big 12,59,1086,142,306,77,144,65,162,86,102,52,120,172,67,22,17,69,89,435
8286,Brandon Perry,2013,2016,Total,Total,71,982,153,306,153,306,0,0,129,243,120,127,247,26,21,32,83,189,435
8287,Daryus Quarles,2011,2014,Saint Joseph's,A-10,117,1849,164,475,110,282,54,193,53,87,50,169,219,75,28,19,67,136,435
8288,T.J. Taylor,2014,2015,North Texas,CUSA,57,1350,154,353,108,211,46,142,81,121,46,129,175,100,46,12,105,80,435
8289,B.J. West,2010,2014,Total,Total,75,1074,169,327,168,319,1,8,96,135,139,239,378,30,26,79,81,117,435
8290,Steffon Wiley,2008,2009,Southern,SWAC,50,1238,135,313,88,176,47,137,118,171,27,106,133,132,81,4,137,120,435
8291,Alexis Yetna,2019,2019,South Florida,AAC,35,1061,163,303,137,229,26,74,83,134,116,224,340,34,29,20,57,87,435
8292,Sam Bittner,2016,2019,Fresno State,MWC,107,2340,147,336,53,111,94,225,46,66,92,215,307,150,88,22,83,244,434
8293,Drew Crowell,2008,2012,Wofford,Southern,117,1675,189,319,185,306,4,13,52,93,100,183,283,61,17,31,47,117,434
8294,Alvin Ellis,2014,2017,Michigan State,Big Ten,136,1486,141,349,74,163,67,186,85,136,45,156,201,110,60,25,103,168,434
8295,John Hart,2010,2013,Total,Total,82,1172,158,394,83,188,75,206,43,58,35,75,110,70,44,12,87,105,434
8296,Marcus James,2011,2012,Sam Houston State,Southland,60,1372,166,356,160,329,6,27,96,166,115,228,343,39,47,40,116,163,434
8297,David Jeune,2010,2013,North Florida,A-Sun,129,2518,151,369,134,284,17,85,115,174,218,314,532,81,59,41,170,322,434
8298,Antywan Jones,2009,2010,Troy,Sun Belt,64,1418,177,375,141,272,36,103,44,78,83,177,260,86,46,43,99,130,434
8299,Darius Lewis,2014,2017,Duquesne,A-10,105,1613,167,302,167,302,0,0,100,183,120,325,445,49,19,105,126,288,434
8300,Nick Madray,2014,2018,Total,Total,76,1429,151,367,101,217,50,150,82,111,71,157,228,20,28,41,77,193,434
8301,Chris O'Brien,2009,2013,Total,Total,87,1993,141,373,89,221,52,152,100,138,98,153,251,135,51,28,102,218,434
8302,Omari Spellman,2018,2018,Villanova,Big East,40,1125,160,336,95,186,65,150,49,70,90,231,321,30,26,59,40,92,434
8303,Hyjii Thomas,2013,2014,Texas-San Antonio,Total,62,1444,133,342,98,231,35,111,133,196,43,111,154,77,39,8,124,97,434
8304,Braxton Tucker,2015,2018,Portland State,Big Sky,46,974,177,358,173,340,4,18,76,104,85,95,180,28,21,12,46,101,434
8305,DeVon Walker,2013,2017,Total,Total,122,1797,144,374,116,264,28,110,118,179,116,221,337,89,51,46,83,147,434
8306,Brett Wishon,2015,2017,Lipscomb,A-Sun,67,1288,142,382,43,93,99,289,51,65,43,163,206,109,18,20,88,103,434
8307,Teeng Akol,2009,2013,Total,Total,83,1139,167,363,150,303,17,60,82,119,97,152,249,31,9,96,81,143,433
8308,C.J. Barksdale,2012,2014,Virginia Tech,ACC,84,1464,164,331,153,300,11,31,94,121,116,205,321,40,27,38,60,135,433
8309,Kevin Booze,2015,2016,Lamar,Southland,56,1140,138,353,83,196,55,157,102,135,20,87,107,199,61,1,122,141,433
8310,Shamarr Bowden,2010,2013,Total,Total,68,1137,144,382,32,75,112,307,33,48,11,51,62,59,29,2,56,86,433
8311,Nemanja Calasan,2008,2009,Purdue,Big Ten,68,1133,162,385,123,261,39,124,70,125,83,129,212,34,13,21,84,126,433
8312,Frank Elegar,2008,2008,Drexel,CAA,31,930,146,261,146,261,0,0,141,214,62,187,249,32,31,59,68,96,433
8313,Gary Johnson,2013,2014,Albany (NY),AEC,56,1309,151,315,149,305,2,10,129,178,62,151,213,58,32,17,82,90,433
8314,Bruce Massey,2012,2013,Middle Tennessee,Sun Belt,68,1721,149,339,137,285,12,54,123,191,69,170,239,245,105,21,125,147,433
8315,Joe Richard,2009,2012,Tulsa,CUSA,131,2461,161,304,161,304,0,0,111,208,198,365,563,69,40,61,146,319,433
8316,Jerren Shipp,2008,2010,Arizona State,Pac-10,99,1816,141,338,83,160,58,178,93,122,73,162,235,78,48,8,61,128,433
8317,Brandon Thompson,2010,2013,Total,Total,77,1525,142,365,53,97,89,268,60,78,60,131,191,66,65,11,57,99,433
8318,Tyler Thornton,2011,2014,Duke,ACC,139,2590,125,308,36,77,89,231,94,121,51,180,231,264,139,6,118,349,433
8319,Ryan Watts,2010,2013,Alabama State,SWAC,96,1408,148,442,97,262,51,180,86,126,44,101,145,78,58,15,136,198,433
8320,Richie Williams,2008,2009,San Diego State,MWC,61,1721,151,386,96,225,55,161,76,111,55,170,225,201,119,3,146,158,433
8321,D'Andre Bell,2008,2010,Georgia Tech,ACC,68,1584,159,355,135,288,24,67,90,117,50,107,157,117,76,19,117,175,432
8322,Derek Brooks,2008,2011,Air Force,MWC,71,1023,148,302,95,173,53,129,83,110,30,131,161,56,29,18,61,130,432
8323,Jaraun Burrows,2008,2008,Purdue-Fort Wayne,Summit,31,920,155,257,152,250,3,7,119,176,38,161,199,58,24,47,68,102,432
8324,Jalen Canty,2017,2018,UC-Santa Barbara,Big West,36,978,172,298,172,298,0,0,88,145,120,150,270,40,18,54,47,93,432
8325,Harrison DuPont,2010,2012,Total,Total,55,1237,156,372,136,311,20,61,100,168,70,155,225,55,23,19,105,110,432
8326,Kennedy Eubanks,2014,2016,Total,Total,63,1331,159,379,115,219,44,160,70,127,62,199,261,44,28,34,71,151,432
8327,Justin Foreman,2014,2016,Total,Total,51,1292,136,326,87,191,49,135,111,190,46,151,197,61,35,5,76,140,432
8328,Brandon Graham,2014,2015,Alabama State,SWAC,61,1359,151,338,114,202,37,136,93,137,76,174,250,45,37,49,73,163,432
8329,Jordan Hunter,2016,2019,Saint Mary's (CA),WCC,120,1221,176,304,175,303,1,1,79,138,132,237,369,50,34,74,69,200,432
8330,Justin Jonas,2008,2008,Troy,Sun Belt,31,914,137,335,55,98,82,237,76,91,34,75,109,46,28,3,54,45,432
8331,Jarryd Loyd,2008,2008,Valparaiso,Horizon,36,931,152,366,101,218,51,148,77,119,20,78,98,143,35,3,96,89,432
8332,Christian Mackey,2015,2018,Denver,Summit,115,1233,167,298,160,271,7,27,91,134,121,176,297,87,16,33,104,223,432
8333,Roberto Mafra,2009,2010,San Diego,WCC,64,1063,172,346,172,346,0,0,88,118,87,137,224,21,16,70,69,138,432
8334,Andre McGee,2008,2009,Louisville,Big East,73,1457,138,365,36,99,102,266,54,75,23,97,120,135,90,1,73,128,432
8335,Devonte Patterson,2019,2019,Prairie View,SWAC,33,898,147,298,134,233,13,65,125,173,66,93,159,38,44,6,75,102,432
8336,Ismael Sanogo,2015,2018,Seton Hall,Big East,111,2381,163,332,151,302,12,30,94,173,198,383,581,96,109,91,104,282,432
8337,Terrance Shannon,2010,2014,Total,Total,92,1193,160,357,160,355,0,2,112,201,112,170,282,38,58,43,109,176,432
8338,Zach Trader,2008,2008,Texas-Rio Grande Valley,Ind,31,1045,170,333,170,327,0,6,92,122,54,128,182,75,15,1,70,80,432
8339,Cameron Tyson,2019,2019,Idaho,Big Sky,32,813,142,339,36,92,106,247,42,48,12,50,62,24,15,3,47,56,432
8340,Eric Wallace,2008,2012,Total,Total,66,1247,186,416,179,394,7,22,53,140,113,238,351,28,47,65,81,138,432
8341,Ivory Young,2016,2017,Utah Valley,WAC,58,1247,141,391,57,159,84,232,66,87,12,108,120,111,40,0,94,81,432
8342,Richmond Aririguzoh,2017,2019,Princeton,Ivy,68,1038,160,245,160,244,0,1,111,162,101,135,236,57,21,38,83,125,431
8343,Reggie Baker,2017,2017,Bethune-Cookman,MEAC,32,994,157,413,113,265,44,148,73,93,35,113,148,54,27,2,50,67,431
8344,Dorian Chatman,2016,2017,Lamar,Southland,61,1035,161,341,158,328,3,13,106,165,92,117,209,51,33,54,108,179,431
8345,Derick Flowers,2010,2013,UC-Irvine,Big West,122,1635,135,400,88,231,47,169,114,152,23,133,156,201,43,3,156,199,431
8346,Ricardo Johnson,2011,2014,Ohio,MAC,118,1609,139,347,119,266,20,81,133,206,111,178,289,92,71,25,106,224,431
8347,Matt Kamieniecki,2011,2015,Ball State,MAC,98,1649,156,300,155,297,1,3,118,228,179,271,450,71,63,37,96,248,431
8348,Justin McBride,2014,2016,Central Florida,AAC,72,882,170,301,170,301,0,0,91,149,92,183,275,10,17,51,95,153,431
8349,Nate Rogers,2010,2013,Total,Total,80,1328,149,380,86,197,63,183,70,109,26,97,123,119,53,8,124,136,431
8350,Marcus Santos-Silva,2018,2019,Virginia Commonwealth,A-10,66,1056,175,303,175,303,0,0,81,144,135,208,343,33,31,53,62,146,431
8351,D'Shawn Schwartz,2018,2019,Colorado,Pac-12,67,1421,151,349,92,171,59,178,70,91,39,151,190,55,16,6,52,108,431
8352,Kenneth van Kempen,2008,2010,Ohio,MAC,102,1902,186,428,185,420,1,8,58,85,107,279,386,55,35,37,117,279,431
8353,Curtis Washington,2011,2015,Total,Total,71,1360,175,285,175,285,0,0,81,116,121,222,343,12,20,122,49,155,431
8354,Carlos Dotson,2019,2019,Western Carolina,Southern,31,860,170,285,170,284,0,1,90,171,97,196,293,46,23,14,104,99,430
8355,Denzel Dulin,2015,2017,Total,Total,56,1487,145,359,122,267,23,92,117,185,50,126,176,56,43,20,97,136,430
8356,Aljami Durham,2018,2019,Indiana,Big Ten,65,1557,141,348,87,184,54,164,94,129,11,113,124,93,27,13,67,129,430
8357,Jordan Harris,2017,2019,Georgia,SEC,77,1356,142,312,92,188,50,124,96,124,40,144,184,103,57,23,123,132,430
8358,Demetrius Henry,2014,2017,Total,Total,84,1573,176,354,175,350,1,4,77,141,126,178,304,39,32,56,105,270,430
8359,Alfonzo Houston,2013,2014,North Carolina Central,MEAC,65,1263,143,326,134,285,9,41,135,182,27,112,139,62,35,5,57,70,430
8360,Chase Jeter,2016,2019,Total,Total,78,1235,162,287,162,287,0,0,106,178,109,192,301,28,25,43,77,179,430
8361,John Kopriva,2012,2015,George Washington,A-10,128,1909,163,351,144,308,19,43,85,149,100,217,317,45,39,54,79,205,430
8362,Carlos Lopez-Sosa,2011,2014,Nevada-Las Vegas,MWC,121,1202,159,298,157,289,2,9,110,192,99,162,261,48,57,70,85,194,430
8363,Jabari McGhee,2015,2019,Total,Total,65,1067,162,317,162,317,0,0,106,173,149,192,341,32,50,30,57,162,430
8364,Jaylon Moore,2012,2015,Evansville,MVC,124,1349,177,287,177,287,0,0,76,141,75,132,207,17,29,36,53,162,430
8365,Steven Rush,2008,2008,North Carolina A&T,MEAC,30,884,136,366,58,127,78,239,80,94,15,60,75,55,33,1,77,46,430
8366,Shayok M. Shayok,2012,2016,Total,Total,101,1684,175,371,163,333,12,38,68,143,126,215,341,38,46,39,109,218,430
8367,Marshawn Wilson,2016,2017,Northern Illinois,MAC,49,847,137,328,70,156,67,172,89,123,32,90,122,53,28,5,48,73,430
8368,Jacob Arnett,2010,2012,Lipscomb,A-Sun,90,1936,148,393,94,237,54,156,79,102,61,174,235,205,62,5,133,169,429
8369,Shane Clark,2008,2009,Villanova,Big East,68,1418,153,332,122,236,31,96,92,124,119,159,278,68,39,25,64,164,429
8370,Tristan Clark,2018,2019,Baylor,Big 12,47,1074,177,267,174,256,3,11,72,109,78,158,236,48,33,63,61,121,429
8371,Randal Falker,2008,2008,Southern Illinois,MVC,33,963,144,264,144,264,0,0,141,204,117,118,235,45,23,43,82,115,429
8372,Donald Lawson,2008,2010,Western Michigan,MAC,86,1736,162,325,162,325,0,0,105,177,172,243,415,39,44,92,117,238,429
8373,Justin Leathers,2013,2014,Texas-Rio Grande Valley,Total,64,1499,152,384,115,275,37,109,88,121,102,171,273,66,56,20,98,158,429
8374,Jagan Mosely,2017,2019,Georgetown,Big East,93,1899,137,308,104,207,33,101,122,168,31,181,212,234,61,13,129,171,429
8375,David Pekarek,2016,2019,Fordham,A-10,95,1577,150,432,72,149,78,283,51,73,41,196,237,68,36,32,98,140,429
8376,Danjel Purifoy,2017,2019,Auburn,SEC,56,1146,132,328,53,116,79,212,86,100,43,147,190,68,57,6,54,96,429
8377,Markhuri Sanders-Frison,2010,2011,University of California,Pac-10,61,1250,175,306,173,303,2,3,77,129,92,225,317,52,25,27,66,210,429
8378,Darrin Williams,2011,2012,Illinois-Chicago,Horizon,58,1147,172,327,172,327,0,0,85,148,107,177,284,37,16,52,97,162,429
8379,Jonathan Andre,2019,2019,Northern Arizona,Big Sky,31,928,158,352,129,264,29,88,83,112,75,188,263,38,23,10,59,73,428
8380,Steve Baker,2011,2012,Green Bay,Horizon,62,1544,162,380,102,238,60,142,44,66,80,140,220,99,43,5,93,119,428
8381,Tyrell Biggs,2008,2009,Pittsburgh,Big East,73,1594,171,353,150,294,21,59,65,106,147,160,307,43,24,33,69,163,428
8382,Corvon Butler,2013,2017,Total,Total,59,1063,178,341,177,316,1,25,71,97,106,148,254,37,35,23,52,132,428
8383,Joshua Clyburn,2011,2013,Presbyterian,Big South,83,1399,170,331,169,328,1,3,87,152,100,198,298,27,18,31,115,137,428
8384,Leland Green,2017,2019,Hawaii,Big West,84,1577,158,449,88,229,70,220,42,83,39,140,179,63,43,6,89,158,428
8385,Patrick Hardy,2008,2010,Savannah State,Ind,84,1846,149,379,90,216,59,163,71,103,57,151,208,126,109,20,128,142,428
8386,Ken Holdman,2009,2011,Oral Roberts,Summit,92,2104,158,323,130,245,28,78,84,129,75,174,249,124,98,32,113,213,428
8387,Julius Johnson,2016,2019,Richmond,A-10,124,2017,146,381,64,122,82,259,54,67,44,168,212,94,52,15,60,226,428
8388,Ricky Lucas,2008,2008,Stony Brook,AEC,30,983,141,360,83,225,58,135,88,110,55,88,143,39,39,2,76,74,428
8389,Juwan Major,2014,2016,Southern Utah,Big Sky,88,1831,162,370,156,342,6,28,98,154,44,123,167,111,44,25,165,217,428
8390,Danny Morrissey,2008,2009,Penn State,Big Ten,67,1388,142,363,38,77,104,286,40,55,18,102,120,103,26,5,67,106,428
8391,Marcus Nelson,2008,2010,Army,Patriot,87,2196,167,349,157,305,10,44,84,168,74,209,283,202,107,62,162,228,428
8392,Drake U'u,2009,2013,Total,Total,94,1701,143,400,110,249,33,151,109,181,72,197,269,132,61,12,105,167,428
8393,Nick Victor,2013,2016,Yale,Ivy,91,2047,161,358,114,232,47,126,59,132,89,322,411,167,69,74,144,224,428
8394,Tawrence Walton,2008,2009,Chicago State,Ind,60,1528,140,321,121,270,19,51,129,186,126,214,340,61,46,22,97,132,428
8395,Isaac White,2016,2017,Massachusetts-Lowell,AEC,39,1187,129,293,41,78,88,215,82,100,8,91,99,91,28,3,82,80,428
8396,JD Williams,2019,2019,Louisiana-Monroe,Sun Belt,35,1157,140,322,98,206,42,116,106,133,27,112,139,58,36,22,73,62,428
8397,Abdul Ado,2018,2019,Mississippi State,SEC,67,1698,163,265,163,265,0,0,101,182,157,214,371,26,48,124,106,180,427
8398,Armani Branch,2015,2019,Total,Total,92,1150,166,397,124,245,42,152,53,83,61,153,214,44,31,40,77,109,427
8399,David Campbell,2008,2011,High Point,Big South,119,2025,152,388,94,197,58,191,65,89,94,247,341,119,47,3,109,157,427
8400,Michael Clark,2008,2009,Mississippi Valley State,SWAC,62,1614,155,377,71,156,84,221,33,44,30,87,117,76,41,8,76,111,427
8401,Antwon Clayton,2015,2018,Jacksonville,A-Sun,100,2111,161,352,157,331,4,21,101,192,186,277,463,101,90,93,118,289,427
8402,Zalmico Harmon,2014,2015,UC-Santa Barbara,Big West,61,1906,124,341,76,206,48,135,131,168,27,86,113,261,37,5,82,134,427
8403,Phil Hawkins,2013,2014,Texas State,Total,65,1793,137,379,88,228,49,151,104,135,15,139,154,145,45,2,96,74,427
8404,Avery Johnson,2011,2015,Total,Total,126,2297,142,356,79,174,63,182,80,107,46,200,246,127,107,20,105,198,427
8405,Falando Jones,2011,2012,Mississippi Valley State,SWAC,51,1159,147,338,106,227,41,111,92,144,58,143,201,77,50,10,98,140,427
8406,Myles Lewis,2018,2019,Virginia Military Institute,Southern,57,1048,172,375,167,345,5,30,78,116,70,136,206,39,41,18,88,105,427
8407,Garland Owens,2014,2017,Boston College,ACC,122,1984,168,355,140,263,28,92,63,104,102,184,286,94,31,24,93,241,427
8408,Marshall Plumlee,2013,2016,Duke,ACC,124,1777,155,233,154,232,1,1,116,209,199,277,476,59,44,100,68,192,427
8409,Shaun Pruitt,2008,2008,Illinois,Big Ten,34,919,163,285,163,285,0,0,101,179,107,141,248,27,16,20,73,86,427
8410,Isaiah Tate,2008,2011,George Mason,CAA,114,1626,151,384,87,194,64,190,61,97,75,138,213,66,52,12,62,98,427
8411,Buay Tuach,2016,2017,Loyola Marymount,WCC,55,1138,153,330,93,171,60,159,61,102,46,108,154,89,53,12,73,104,427
8412,Kienan Walter,2017,2019,North Dakota,Total,79,1274,144,312,99,183,45,129,94,142,53,189,242,66,36,20,85,187,427
8413,Lawrence White,2016,2017,UC-Davis,Big West,64,1618,156,356,121,239,35,117,80,147,39,176,215,88,74,32,88,164,427
8414,Ben Allen,2009,2010,Saint Mary's (CA),WCC,62,1192,159,346,106,199,53,147,55,69,72,237,309,93,22,32,72,131,426
8415,Roydell Brown,2017,2019,Total,Total,55,1022,165,309,157,274,8,35,88,147,86,181,267,45,30,15,83,78,426
8416,Yima Chia-Kur,2008,2009,Arkansas State,Sun Belt,44,1063,155,376,130,308,25,68,91,120,57,94,151,28,19,4,72,95,426
8417,Steven Coleman,2009,2010,Ohio,MAC,42,1106,143,315,94,178,49,137,91,125,36,109,145,105,68,9,99,114,426
8418,Jaheam Cornwall,2018,2019,Gardner-Webb,Big South,62,1425,144,324,65,134,79,190,59,81,11,140,151,164,55,1,87,99,426
8419,Daniel Fountain,2008,2008,North Carolina-Wilmington,CAA,33,1065,132,324,40,107,92,217,70,90,14,108,122,68,47,12,46,64,426
8420,Sam Goodman,2010,2011,Morehead State,OVC,70,1476,161,335,141,273,20,62,84,133,92,111,203,105,63,12,79,174,426
8421,Juwan Gray,2017,2018,San Diego,WCC,65,1536,151,331,108,213,43,118,81,126,59,225,284,51,41,43,55,145,426
8422,Patrick Hazel,2008,2012,Total,Total,102,1880,163,297,163,297,0,0,100,195,168,263,431,43,34,130,101,199,426
8423,Henrik Jadersten,2016,2019,Santa Clara,WCC,114,1417,159,383,89,174,70,209,38,50,61,188,249,36,20,46,63,243,426
8424,Mickey Perry,2008,2010,Dayton,A-10,95,1341,152,390,80,167,72,223,50,86,27,97,124,101,38,9,82,142,426
8425,Evan Ravenel,2009,2013,Total,Total,115,1426,159,317,159,316,0,1,108,161,110,208,318,37,27,53,86,242,426
8426,Landon Tatum,2011,2012,Idaho,WAC,65,1729,137,318,119,275,18,43,134,199,29,113,142,252,58,3,123,113,426
8427,Kyle Weaver,2008,2008,Washington State,Pac-10,35,1159,138,298,114,232,24,66,126,172,37,147,184,151,60,25,97,66,426
8428,Dwain Williams,2008,2010,Total,Total,35,1053,119,338,40,130,79,208,109,122,16,35,51,65,19,0,49,54,426
8429,Hassan Attia,2017,2018,Hartford,AEC,59,1247,180,282,180,282,0,0,65,152,126,210,336,33,39,118,107,236,425
8430,Chinemelu Elonu,2008,2009,Texas A&M,Big 12,68,1127,164,260,164,260,0,0,97,162,131,221,352,16,13,69,91,137,425
8431,Wenyen Gabriel,2017,2018,Kentucky,SEC,75,1526,147,345,85,176,62,169,69,111,126,256,382,47,41,74,70,204,425
8432,K.J. Garland,2008,2008,North Carolina-Asheville,Big South,32,1217,154,358,103,206,51,152,66,96,20,118,138,191,43,0,87,44,425
8433,Josh Gentry,2014,2015,Cal State Fullerton,Big West,62,1442,140,318,108,211,32,107,113,142,42,102,144,73,27,15,81,102,425
8434,London Giles,2009,2013,Total,Total,103,1534,136,357,69,161,67,196,86,108,10,124,134,79,66,1,105,109,425
8435,Garrison Goode,2016,2019,UC-Davis,Big West,117,2690,158,326,158,325,0,1,109,197,165,214,379,84,79,43,122,271,425
8436,Brannen Greene,2014,2016,Kansas,Big 12,93,1079,121,271,40,79,81,192,102,117,19,146,165,62,25,5,73,103,425
8437,Robert Hines,2008,2008,St. Francis (NY),NEC,28,937,155,386,129,285,26,101,89,127,57,115,172,62,28,10,110,74,425
8438,Nick Hopkins,2018,2019,Belmont,OVC,61,1016,140,340,29,57,111,283,34,39,15,97,112,72,35,2,40,74,425
8439,Jacob Lawson,2012,2016,Total,Total,116,1475,167,323,167,321,0,2,91,139,114,187,301,41,51,118,87,262,425
8440,Tony Lewis,2010,2011,Illinois State,MVC,64,1177,157,288,157,286,0,2,111,156,127,255,382,40,25,9,102,100,425
8441,Kandi Mukole,2008,2010,Howard,MEAC,95,1644,145,368,104,225,41,143,94,185,96,243,339,42,27,53,133,230,425
8442,Rauno Nurger,2015,2018,Wichita State,Total,121,1377,155,309,128,224,27,85,88,126,72,180,252,44,13,44,60,184,425
8443,Chris Obekpa,2013,2015,St. John's (NY),Big East,95,2318,175,361,175,360,0,1,75,164,206,361,567,78,75,321,112,259,425
8444,Jordan Payne,2008,2008,Louisiana-Monroe,Sun Belt,31,850,126,318,60,138,66,180,107,126,16,65,81,48,26,2,73,46,425
8445,Greg Somogyi,2009,2012,UC-Santa Barbara,Big West,122,1494,177,359,177,355,0,4,71,129,89,259,348,52,20,187,107,205,425
8446,Lucas Steijn,2008,2009,Idaho State,Big Sky,63,1386,163,305,163,305,0,0,99,136,86,129,215,41,23,26,82,155,425
8447,Casey Teson,2016,2017,Eastern Illinois,OVC,59,1451,138,351,33,81,105,270,44,49,6,111,117,48,32,3,37,81,425
8448,Terrence Thompson,2016,2018,Total,Total,86,1379,145,319,128,272,17,47,118,201,141,243,384,32,52,15,67,154,425
8449,Darian Townes,2008,2008,Arkansas,SEC,35,805,168,279,168,279,0,0,89,142,77,116,193,31,21,38,46,68,425
8450,Brandon Cyrus,2017,2018,DePaul,Big East,63,1688,152,385,124,294,28,91,92,132,106,134,240,79,44,18,85,136,424
8451,Matt Gibson,2008,2008,Hawaii,WAC,25,858,137,294,99,171,38,123,112,140,17,65,82,121,47,4,101,84,424
8452,Winston Grays,2015,2016,James Madison,CAA,64,1410,141,340,75,156,66,184,76,105,49,138,187,91,47,12,66,83,424
8453,UC Iroegbu,2017,2018,Stony Brook,AEC,64,1370,136,387,48,125,88,262,64,88,36,105,141,76,49,15,51,117,424
8454,Zach Lamb,2012,2014,Cal State Bakersfield,Total,60,1021,156,344,114,233,42,111,70,94,23,65,88,70,36,10,81,103,424
8455,Corey Littlejohn,2012,2015,North Carolina-Asheville,Big South,94,1674,140,353,101,231,39,122,105,139,95,167,262,135,86,16,133,170,424
8456,Jaume Sorolla,2017,2019,Valparaiso,Total,89,1571,167,328,165,325,2,3,88,124,121,207,328,42,26,96,79,202,424
8457,Darian Thibodeaux,2011,2012,Houston,CUSA,60,1905,147,360,53,120,94,240,36,45,47,127,174,137,41,13,78,126,424
8458,Emmanuel Toney,2014,2019,Texas A&M-Corpus Christi,Southland,101,2006,144,351,95,211,49,140,87,126,57,163,220,172,89,8,117,163,424
8459,Jaylen Babb-Harrison,2013,2017,Eastern Kentucky,OVC,69,943,142,353,58,127,84,226,55,62,26,121,147,67,45,3,51,72,423
8460,Brian Burrell,2008,2008,Texas-Rio Grande Valley,Ind,31,1031,156,400,81,181,75,219,36,46,39,127,166,47,39,2,71,79,423
8461,Deandre Davis,2016,2017,Alcorn State,SWAC,53,1118,167,297,157,273,10,24,79,131,122,133,255,31,31,42,64,155,423
8462,Makale Foreman,2017,2018,Chattanooga,Southern,61,1480,140,364,38,85,102,279,41,50,16,63,79,67,31,0,59,77,423
8463,Eric Gilchrese,2008,2009,New Hampshire,AEC,45,1060,115,315,61,176,54,139,139,180,31,69,100,121,49,3,79,108,423
8464,ShanQuan Hemphill,2019,2019,Green Bay,Horizon,37,1030,178,335,178,333,0,2,67,143,59,140,199,57,39,20,70,71,423
8465,Taylor King,2008,2010,Total,Total,66,939,146,349,63,125,83,224,48,71,75,162,237,32,34,29,50,118,423
8466,Rocky Kreuser,2018,2019,North Dakota State,Summit,67,1165,143,327,83,154,60,173,77,96,59,139,198,39,17,46,61,130,423
8467,Alani Moore,2017,2019,Temple,AAC,91,1661,135,362,49,119,86,243,67,89,47,93,140,121,72,3,70,105,423
8468,Shaun Noriega,2010,2015,Total,Total,92,1175,125,344,24,70,101,274,72,90,12,45,57,34,17,9,49,84,423
8469,Blake Sanford,2010,2011,Southern,SWAC,53,1079,138,387,57,152,81,235,66,93,41,69,110,42,22,7,64,55,423
8470,C.J. Siples,2015,2018,Air Force,MWC,110,1696,148,345,106,213,42,132,85,146,26,177,203,165,84,22,104,174,423
8471,Ryan Williams,2011,2014,Central Arkansas,Southland,92,1536,145,466,92,284,53,182,80,115,55,125,180,142,72,5,138,164,423
8472,Tyvon Williams,2010,2011,South Carolina State,MEAC,64,1312,147,355,97,189,50,166,79,120,37,118,155,193,72,6,147,82,423
8473,Patrick Beverley,2008,2008,Arkansas,SEC,35,1183,136,330,71,158,65,172,85,132,42,189,231,84,44,16,69,85,422
8474,Antone Christian,2011,2014,Northern Illinois,MAC,89,1323,143,440,73,198,70,242,66,85,90,123,213,62,42,12,82,116,422
8475,Marcus Davis,2012,2013,Houston Baptist,GWC,37,957,141,340,99,225,42,115,98,117,53,153,206,52,55,11,97,127,422
8476,Damonte Dodd,2014,2017,Maryland,Total,119,1797,160,273,160,273,0,0,102,185,172,206,378,46,18,141,112,297,422
8477,Evan Harris,2008,2009,Harvard,Ivy,50,1202,130,246,129,244,1,2,161,223,82,176,258,54,57,56,74,150,422
8478,D.J. Harvey,2018,2019,Notre Dame,ACC,48,1095,143,367,93,205,50,162,86,120,38,141,179,30,29,18,54,77,422
8479,JaMarkus Holt,2009,2010,Alcorn State,SWAC,51,1126,162,409,162,394,0,15,98,189,122,188,310,21,23,34,110,113,422
8480,John Johnson,2012,2015,Total,Total,76,1309,137,344,70,157,67,187,81,107,14,73,87,81,29,1,78,116,422
8481,Aaron Korn,2015,2018,Lipscomb,A-Sun,117,1679,145,355,77,153,68,202,64,98,68,263,331,88,39,8,79,157,422
8482,Duwan Kornegay,2010,2011,Prairie View,SWAC,61,1177,152,400,94,196,58,204,60,101,93,152,245,32,39,15,63,71,422
8483,Mitch Peterson,2017,2019,Kent State,MAC,101,1894,153,421,84,199,69,222,47,73,91,215,306,84,64,19,78,132,422
8484,D'Vonne Pickett,2013,2014,Seattle,WAC,59,1371,166,371,158,329,8,42,82,145,50,127,177,198,65,8,133,140,422
8485,Ja'Mill Powell,2015,2016,Eastern Kentucky,OVC,60,1157,133,338,69,153,64,185,92,124,42,79,121,54,37,15,70,134,422
8486,Elijah Pughsley,2016,2017,Western Carolina,Southern,54,1085,126,421,35,133,91,288,79,113,16,84,100,83,34,2,119,98,422
8487,Jeff Stubbs,2013,2014,Jackson State,SWAC,55,1174,132,335,110,253,22,82,136,163,12,102,114,76,56,9,127,146,422
8488,Miles Taylor,2009,2010,Campbell,A-Sun,58,1099,158,283,153,264,5,19,101,156,72,96,168,43,35,2,63,99,422
8489,Alex Tiffin,2011,2015,Total,Total,122,1834,168,360,166,345,2,15,84,149,108,201,309,51,21,24,138,313,422
8490,Raheem Watts,2016,2017,Southern Mississippi,CUSA,59,1291,148,334,121,238,27,96,99,133,46,161,207,31,26,9,105,179,422
8491,Maliek White,2017,2019,Providence,Big East,91,1448,151,381,90,201,61,180,59,90,18,104,122,139,72,14,97,109,422
8492,Tim Anderson,2008,2008,Air Force,MWC,30,1090,128,299,78,158,50,141,115,142,21,62,83,82,67,10,57,58,421
8493,Jvonte Brooks,2012,2013,Dartmouth,Ivy,50,1318,122,271,118,259,4,12,173,231,113,196,309,58,26,9,102,157,421
8494,Blake Cushingberry,2009,2012,Oakland,Summit,81,1590,141,354,68,113,73,241,66,104,56,144,200,74,56,2,79,140,421
8495,Khary Doby,2014,2016,North Carolina A&T,MEAC,91,1485,153,408,106,250,47,158,68,121,60,174,234,28,18,29,77,168,421
8496,Joseph Dorsett-Jeffreys,2008,2010,Norfolk State,MEAC,91,1140,167,332,167,332,0,0,87,143,83,169,252,12,16,38,103,216,421
8497,Jonathan Fairell,2014,2015,Murray State,OVC,69,1493,170,285,170,285,0,0,81,184,199,276,475,52,50,62,104,227,421
8498,Mason Faulkner,2017,2018,Northern Kentucky,Horizon,65,1151,137,337,81,150,56,187,91,114,20,119,139,141,51,2,88,122,421
8499,Johnny Hamilton,2016,2018,Total,Total,54,939,163,261,163,260,0,1,95,150,121,194,315,23,19,94,70,117,421
8500,Antoine Johnson,2008,2010,Georgia Southern,Southern,77,1238,164,358,144,299,20,59,73,144,45,92,137,141,83,14,116,108,421
8501,Vladimir Kuljanin,2008,2008,North Carolina-Wilmington,CAA,33,1050,188,282,188,282,0,0,45,86,104,224,328,80,14,30,106,61,421
8502,Nikita Mescheriakov,2009,2012,Total,Total,84,1478,145,373,108,228,37,145,94,132,50,148,198,84,37,9,115,227,421
8503,Jimmy Oden,2008,2012,Total,Total,121,1837,103,293,77,205,26,88,189,262,62,162,224,269,137,5,191,237,421
8504,Kyle Richardson,2010,2014,Total,Total,105,1439,174,333,174,331,0,2,73,123,119,171,290,39,36,41,113,180,421
8505,Jourdan Stickler,2013,2016,Total,Total,67,1179,144,362,68,176,76,186,57,77,46,85,131,55,27,1,65,86,421
8506,Chase Stigall,2010,2013,Butler,Total,125,1858,139,454,29,85,110,369,33,51,49,146,195,94,45,4,86,157,421
8507,Justin Swidowski,2012,2013,Sacred Heart,NEC,43,965,168,325,150,276,18,49,67,84,60,142,202,17,24,44,52,131,421
8508,Joe'Randle Toliver,2017,2018,Arkansas-Pine Bluff,SWAC,67,1520,139,379,20,44,119,335,24,35,25,140,165,119,60,6,90,82,421
8509,Bernard Toombs,2008,2011,Troy,Sun Belt,76,1411,174,330,174,330,0,0,73,131,146,290,436,38,32,81,71,165,421
8510,Durell Vinson,2008,2008,Wagner,NEC,31,967,191,342,191,342,0,0,39,120,141,217,358,37,34,36,103,98,421
8511,Joe Ballard,2008,2009,Florida A&M,MEAC,63,,152,391,123,286,29,105,87,155,77,165,242,230,116,13,167,121,420
8512,Worrel Clahar,2012,2013,DePaul,Big East,63,1313,144,325,108,216,36,109,96,127,30,129,159,167,83,5,132,156,420
8513,Erik Copes,2012,2015,George Mason,Total,90,1836,175,353,175,353,0,0,70,138,168,291,459,29,31,122,101,259,420
8514,Jonathan Dalton,2017,2019,Southeast Missouri State,OVC,93,2250,132,312,86,190,46,122,110,154,33,135,168,315,75,1,156,150,420
8515,Damon Forest,2008,2010,Total,Total,42,808,142,337,88,169,54,168,82,116,32,62,94,22,24,12,54,77,420
8516,Marvin Kilgore,2008,2008,Texas-El Paso,CUSA,33,1044,141,304,117,232,24,72,114,177,26,125,151,166,35,11,79,100,420
8517,Shawn O'Connell,2016,2019,Total,Total,124,1738,164,272,161,260,3,12,89,148,163,243,406,22,42,50,68,283,420
8518,Tyler Singleton,2016,2019,Total,Total,77,1348,147,336,132,295,15,41,111,175,31,112,143,110,37,2,95,91,420
8519,Lucca Staiger,2009,2010,Iowa State,Big 12,49,1219,140,350,18,45,122,305,18,23,12,90,102,73,17,2,77,77,420
8520,Malcolm Thomas,2009,2010,Louisiana-Monroe,Sun Belt,39,1033,150,388,101,259,49,129,71,92,55,104,159,29,42,10,68,91,420
8521,Chris Adams,2012,2015,San Francisco,WCC,107,1853,143,391,21,66,122,325,11,16,7,131,138,89,34,3,54,152,419
8522,Eric Bledsoe,2010,2010,Kentucky,SEC,37,1122,144,312,95,184,49,128,82,123,19,95,114,107,52,12,112,82,419
8523,Tori Boyd,2008,2009,Illinois-Chicago,Horizon,61,1253,131,323,90,200,41,123,116,148,64,124,188,60,39,12,101,127,419
8524,Corey Counts,2008,2009,Loyola Marymount,WCC,62,1699,132,349,43,103,89,246,66,85,10,103,113,145,39,3,108,92,419
8525,Ozante Fields,2017,2019,South Carolina State,MEAC,81,1206,169,303,169,302,0,1,81,117,113,189,302,29,15,25,76,215,419
8526,Kaleb Korver,2008,2011,Creighton,MVC,135,2277,138,356,22,59,116,297,27,43,49,230,279,165,53,6,105,145,419
8527,LaMarcus Lowe,2009,2012,Total,Total,96,1686,148,306,148,306,0,0,123,188,134,250,384,21,32,205,110,255,419
8528,Goanar Mar,2018,2019,George Mason,A-10,52,1463,130,327,79,169,51,158,108,138,80,113,193,41,30,9,74,134,419
8529,Curry McKinney,2010,2011,Eastern Illinois,OVC,60,1463,155,421,105,265,50,156,59,89,37,175,212,127,68,10,101,110,419
8530,Alex Owumi,2008,2008,Alcorn State,SWAC,29,944,147,345,115,245,32,100,93,128,60,130,190,55,25,5,83,87,419
8531,Brett Roseboro,2010,2014,Total,Total,92,1320,171,376,167,361,4,15,73,122,99,214,313,24,41,58,109,197,419
8532,Lance Stephenson,2010,2010,Cincinnati,Big East,34,960,162,368,146,295,16,73,79,119,63,119,182,84,31,6,81,66,419
8533,Cyrus Tate,2008,2009,Iowa,Big Ten,54,1211,144,216,144,216,0,0,131,211,105,192,297,12,36,25,85,143,419
8534,Darryl Ashford,2010,2011,Creighton,MVC,72,1432,145,341,93,186,52,155,76,113,58,167,225,96,37,44,66,134,418
8535,Lyndon Jordan,2008,2011,Fairfield,MAAC,116,1684,147,361,76,160,71,201,53,82,59,142,201,96,66,6,79,139,418
8536,Ceslovas Kucinskas,2008,2011,Coppin State,MEAC,118,1685,165,348,154,313,11,35,77,117,126,172,298,22,45,18,78,256,418
8537,Donte Minter,2008,2008,Appalachian State,Southern,30,754,164,276,164,276,0,0,90,123,45,134,179,54,27,46,55,79,418
8538,Anthony Morse,2013,2016,Tennessee Tech,OVC,110,1479,157,299,157,297,0,2,104,182,140,203,343,27,39,110,78,218,418
8539,Shaun Pratl,2010,2011,Eastern Illinois,OVC,57,995,161,316,156,300,5,16,91,143,88,125,213,71,32,23,71,157,418
8540,Jimario Rivers,2017,2018,Memphis,AAC,63,1447,162,309,157,290,5,19,89,137,90,132,222,90,41,44,82,173,418
8541,Gentrey Thomas,2016,2017,UC-Riverside,Big West,55,1304,168,389,127,239,41,150,41,62,45,153,198,83,40,11,99,92,418
8542,Kelvin Amayo,2013,2017,Total,Total,70,1431,159,338,146,291,13,47,86,187,82,210,292,156,71,23,116,149,417
8543,Jeremy Anderson,2008,2011,Liberty,Big South,80,1393,133,357,12,21,121,336,30,37,7,76,83,37,18,3,47,104,417
8544,Evaldas Baniulis,2008,2010,South Carolina,SEC,87,1419,141,347,32,82,109,265,26,41,42,146,188,61,39,6,70,113,417
8545,Jr. Clay,2019,2019,Tennessee Tech,OVC,29,916,139,338,100,239,39,99,100,139,24,86,110,124,51,4,116,52,417
8546,Jaquan Dotson,2019,2019,Savannah State,MEAC,31,973,144,323,82,126,62,197,67,94,75,137,212,61,40,17,62,70,417
8547,Jase Febres,2018,2019,Texas,Big 12,67,1462,144,395,31,74,113,321,16,25,40,119,159,33,25,16,35,101,417
8548,Bradley Gay,2011,2012,Texas-Arlington,Southland,62,1100,145,334,93,187,52,147,75,109,47,132,179,56,47,4,80,94,417
8549,Tobias Howard,2017,2019,Total,Total,62,1317,147,401,75,176,72,225,51,68,21,82,103,118,32,4,108,74,417
8550,Louis King,2019,2019,Oregon,Pac-12,31,943,148,340,89,187,59,153,62,79,41,130,171,40,27,7,64,77,417
8551,Phillip Lawrence-Ricks,2013,2016,Marist,MAAC,100,1533,150,345,107,208,43,137,74,115,61,154,215,51,29,33,60,147,417
8552,Karam Mashour,2011,2015,Total,Total,61,883,156,316,133,239,23,77,82,126,59,165,224,41,40,17,60,94,417
8553,Neal Monson,2015,2016,UC-Davis,Big West,61,1301,163,306,163,303,0,3,91,128,90,264,354,39,24,19,71,113,417
8554,Tyler Roche,2008,2010,Boston College,ACC,86,1440,151,345,70,127,81,218,34,53,48,119,167,77,22,30,56,89,417
8555,Nate Rucker,2011,2015,Total,Total,56,1126,150,293,150,291,0,2,117,205,64,145,209,21,36,17,82,166,417
8556,Zhaire Smith,2018,2018,Texas Tech,Big 12,37,1051,154,277,136,237,18,40,91,127,83,102,185,66,42,42,41,67,417
8557,Jimmy Sotos,2018,2019,Bucknell,Patriot,66,1728,129,325,75,165,54,160,105,135,21,200,221,259,61,13,139,137,417
8558,Jaleel Wheeler,2017,2018,Tulsa,AAC,61,1444,140,320,120,244,20,76,117,170,44,196,240,83,29,15,103,108,417
8559,P.J. Couisnard,2008,2008,Wichita State,MVC,31,1000,140,334,94,197,46,137,90,144,56,116,172,67,48,24,64,106,416
8560,Nick Dials,2008,2008,Akron,MAC,35,1121,108,280,31,75,77,205,123,141,19,64,83,148,36,2,78,74,416
8561,Josh Henderson,2012,2016,Vanderbilt,SEC,105,1400,164,341,162,335,2,6,86,148,107,161,268,56,32,46,90,170,416
8562,Kaleb Joseph,2015,2019,Total,Total,99,1634,149,372,112,259,37,113,81,109,34,121,155,194,53,9,116,124,416
8563,Kevon Looney,2015,2015,UCLA,Pac-12,36,1113,151,321,129,268,22,53,92,147,122,209,331,51,46,32,45,104,416
8564,Oliver Lynch-Daniels,2018,2019,Houston Baptist,Southland,60,1196,147,383,86,199,61,184,61,92,42,106,148,113,33,8,91,126,416
8565,Jack McVeigh,2016,2018,Nebraska,Big Ten,78,1370,138,382,51,125,87,257,53,71,42,139,181,56,35,15,53,83,416
8566,Nate Reuvers,2018,2019,Wisconsin,Big Ten,62,1245,163,386,119,255,44,131,46,65,61,127,188,56,17,86,61,148,416
8567,Bobby Sharp,2014,2015,Portland,WCC,62,1128,135,387,27,88,108,299,38,51,6,68,74,58,26,2,29,95,416
8568,Chris Skrelja,2008,2009,Brown,Ivy,57,1966,136,304,122,253,14,51,130,214,80,307,387,225,57,8,157,144,416
8569,Troy Smith,2009,2010,Morgan State,MEAC,66,1302,145,361,116,252,29,109,97,138,68,108,176,71,50,8,66,107,416
8570,Marquis Baker,2012,2013,Alcorn State,SWAC,27,891,127,378,65,158,62,220,99,138,19,72,91,45,36,5,64,40,415
8571,Dreon Barlett,2013,2016,Sacramento State,Big Sky,106,1484,135,330,41,98,94,232,51,62,24,156,180,45,23,12,48,144,415
8572,Anthony Bonner,2017,2018,Colorado State,MWC,68,1394,141,327,82,177,59,150,74,86,11,120,131,59,30,2,58,112,415
8573,Junior Fortunat,2012,2015,Rider,MAAC,112,1429,164,315,164,315,0,0,87,213,119,165,284,18,24,62,102,245,415
8574,Ethan Lee,2014,2018,Central Arkansas,Southland,115,1602,154,325,154,318,0,7,107,190,124,183,307,57,43,30,93,236,415
8575,Isaiah Livers,2018,2019,Michigan,Big Ten,75,1396,151,313,78,133,73,180,40,53,62,168,230,41,36,30,46,105,415
8576,Adrick McKinney,2012,2013,Texas Christian,Total,64,1346,153,352,153,351,0,1,109,222,123,205,328,51,40,23,103,142,415
8577,Craig Randall,2016,2019,Total,Total,68,1166,149,401,73,140,76,261,41,63,27,92,119,74,39,10,80,72,415
8578,Chris Robinson,2015,2018,Sacred Heart,NEC,97,1630,149,418,85,202,64,216,53,86,84,190,274,71,46,5,71,174,415
8579,Jack Salt,2016,2019,Virginia,ACC,125,2041,177,299,177,299,0,0,61,132,172,264,436,38,35,60,75,252,415
8580,Ryan Smith,2014,2017,Tulane,Total,121,1617,169,343,169,342,0,1,77,132,145,164,309,32,26,81,93,271,415
8581,Spencer Stewart,2008,2010,Illinois-Chicago,Horizon,77,2205,128,389,62,187,66,202,93,125,31,212,243,355,76,12,226,187,415
8582,Giorgi Bezhanishvili,2019,2019,Illinois,Big Ten,33,862,169,312,164,282,5,30,71,108,76,97,173,26,22,26,78,126,414
8583,Tray Boyd III,2019,2019,East Tennessee State,Southern,34,770,157,366,75,143,82,223,18,27,9,55,64,65,27,13,61,54,414
8584,Jay Estime',2018,2019,North Carolina-Wilmington,CAA,65,1412,147,381,65,134,82,247,38,53,48,117,165,81,25,4,69,117,414
8585,Marquis Ford,2008,2009,Saint Francis (PA),NEC,57,1430,136,366,80,192,56,174,86,119,42,132,174,132,46,3,117,89,414
8586,Marcus Heemstra,2011,2014,South Dakota State,Summit,118,1377,162,309,159,301,3,8,87,123,123,169,292,83,37,44,85,190,414
8587,Talen Horton-Tucker,2019,2019,Iowa State,Big 12,35,952,155,382,106,223,49,159,55,88,23,147,170,82,45,23,60,79,414
8588,Adom Jacko,2016,2016,Loyola Marymount,WCC,25,683,170,305,169,303,1,2,73,100,59,100,159,16,18,22,45,95,414
8589,Jordan Latham,2011,2014,Total,Total,104,1604,159,386,157,379,2,7,94,148,85,163,248,55,31,97,103,253,414
8590,Darin Mahoney,2009,2012,Weber State,Big Sky,123,2507,158,325,153,308,5,17,93,137,211,358,569,85,86,100,92,310,414
8591,Cole Martinez,2013,2017,Texas A&M-Corpus Christi,Southland,113,1225,126,304,39,71,87,233,75,83,22,74,96,55,34,5,36,112,414
8592,Jeffery Middlebrooks,2009,2012,Alabama State,SWAC,108,2326,104,350,43,130,61,220,145,207,39,136,175,311,84,5,201,279,414
8593,Neemias Queta,2019,2019,Utah State,MWC,35,947,167,272,165,267,2,5,78,138,86,224,310,57,23,84,81,108,414
8594,Matt Shaw,2008,2008,Southern Illinois,MVC,33,1038,135,326,83,164,52,162,92,121,43,185,228,38,31,16,75,82,414
8595,Courtney Stanley,2009,2011,Loyola (IL),Horizon,90,2040,142,350,121,264,21,86,109,189,69,154,223,266,76,11,210,193,414
8596,Peter Stein,2008,2009,William & Mary,CAA,63,1491,165,336,148,284,17,52,67,108,102,182,284,104,39,24,131,190,414
8597,Jeremy Baker,2009,2010,Quinnipiac,NEC,45,1252,131,285,114,227,17,58,134,179,75,137,212,55,32,7,71,114,413
8598,Vincent Eze,2016,2019,Maine,AEC,65,1294,156,353,155,351,1,2,100,176,117,183,300,49,46,29,102,180,413
8599,Zarryon Fereti,2008,2008,St. Bonaventure,A-10,30,1084,126,358,59,170,67,188,94,110,19,103,122,70,20,3,65,57,413
8600,Tyrell Gumbs-Frater,2018,2019,Coastal Carolina,Sun Belt,48,836,134,304,40,93,94,211,51,70,25,61,86,24,27,6,43,78,413
8601,Trey Hampton,2009,2010,Georgia State,CAA,64,1579,154,315,151,303,3,12,102,146,127,151,278,43,35,66,102,147,413
8602,Todd Hendley,2008,2008,North Carolina-Wilmington,CAA,33,1004,164,300,153,264,11,36,74,94,72,96,168,48,18,11,78,99,413
8603,David Jesperson,2014,2018,Total,Total,112,1576,150,337,82,149,68,188,45,59,66,199,265,56,29,34,68,155,413
8604,Rob Lowery,2009,2010,Dayton,A-10,56,1063,132,364,57,156,75,208,74,109,31,104,135,192,45,2,119,100,413
8605,Kai Mitchell,2019,2019,Sam Houston State,Southland,33,789,177,323,176,319,1,4,58,85,82,167,249,37,34,24,54,104,413
8606,Fard Muhammad,2017,2018,Binghamton,AEC,58,1013,141,345,40,94,101,251,30,40,21,91,112,41,30,4,40,64,413
8607,Jon Pack,2009,2012,Coastal Carolina,Big South,114,1585,160,294,160,293,0,1,93,180,163,224,387,48,32,67,98,189,413
8608,Jarvis Ray,2011,2014,Texas Christian,Total,80,1428,162,397,153,333,9,64,80,135,59,137,196,69,59,18,103,163,413
8609,Ajay Sanders,2018,2019,Coastal Carolina,Sun Belt,66,1682,139,382,51,131,88,251,47,69,72,196,268,76,36,10,84,140,413
8610,Craig Stanley,2009,2010,Drake,MVC,56,1425,135,283,120,236,15,47,128,169,13,84,97,187,36,3,132,66,413
8611,Demarco Stepter,2009,2010,Texas-San Antonio,Southland,57,1000,165,338,155,286,10,52,73,103,128,166,294,12,25,22,63,152,413
8612,Kurtis Woods,2010,2010,Kennesaw State,A-Sun,33,1035,142,387,67,180,75,207,54,87,47,60,107,47,38,4,65,47,413
8613,Darion Benbow,2008,2011,Lafayette,Patriot,94,1627,161,364,158,352,3,12,87,134,90,222,312,58,53,37,119,205,412
8614,C.J. Blackwell,2012,2014,Loyola Marymount,WCC,68,1188,158,409,96,221,62,188,34,51,63,115,178,43,31,14,57,91,412
8615,Kevin Crescenzi,2013,2016,Dartmouth,Ivy,107,1736,144,417,80,220,64,197,60,87,73,173,246,97,71,15,84,198,412
8616,Kevin Easley,2019,2019,Chattanooga,Southern,29,814,154,347,104,221,50,126,54,83,50,143,193,35,20,9,58,56,412
8617,Arthur Edwards,2014,2016,Total,Total,70,1328,138,359,58,125,80,234,56,84,34,142,176,67,41,23,98,141,412
8618,Michael Grace,2010,2013,Yale,Ivy,106,1649,142,383,104,256,38,127,90,118,15,102,117,197,55,3,144,141,412
8619,David Howard,2014,2017,Evansville,MVC,112,1206,151,285,151,283,0,2,110,202,97,184,281,21,19,38,56,199,412
8620,Kourtlin Jackson,2015,2016,Total,Total,36,806,126,278,70,147,56,131,104,136,23,111,134,36,33,8,49,67,412
8621,Derrien King,2016,2019,Total,Total,65,1444,133,402,67,203,66,199,80,100,27,172,199,58,32,17,86,100,412
8622,Cosmo Morabbi,2009,2012,Citadel,Southern,108,1884,143,418,75,185,68,233,58,87,34,131,165,115,52,1,94,140,412
8623,Dave Noel,2008,2008,Central Florida,CUSA,31,1028,132,255,92,167,40,88,108,137,32,97,129,95,39,2,68,82,412
8624,Duby Okeke,2015,2018,Total,Total,122,1593,168,265,168,265,0,0,76,176,170,235,405,16,23,192,121,272,412
8625,Kristinn Palsson,2016,2018,Marist,MAAC,70,1826,135,371,29,57,106,314,36,54,21,213,234,88,36,16,76,150,412
8626,Jarmal Reid,2013,2016,Oregon State,Pac-12,109,1634,144,358,143,351,1,7,123,187,56,143,199,84,62,34,99,253,412
8627,Jordan Robinson,2015,2018,Duquesne,A-10,95,1165,156,284,156,283,0,1,100,165,108,174,282,33,10,36,59,167,412
8628,Dontavious Sears,2015,2016,Lamar,Southland,58,827,154,343,99,162,55,181,49,75,68,156,224,28,37,19,40,72,412
8629,Jade' Smith,2018,2019,Pepperdine,WCC,57,1327,158,349,131,256,27,93,69,105,79,177,256,86,73,12,88,165,412
8630,Chandler Thomas,2012,2015,Total,Total,62,1190,155,343,142,309,13,34,89,145,94,180,274,20,39,21,73,139,412
8631,George Willborn III,2017,2019,Total,Total,67,986,142,323,123,265,19,58,109,204,80,125,205,56,38,12,76,119,412
8632,Miles Wilson,2017,2017,Mount St. Mary's,NEC,35,1009,144,317,106,212,38,105,86,115,24,113,137,25,29,18,71,86,412
8633,Ken Cerroni,2011,2013,Green Bay,Horizon,73,1380,120,308,23,55,97,253,74,83,13,63,76,68,32,2,60,112,411
8634,Keandre Cook,2019,2019,Missouri State,MVC,32,931,135,309,87,180,48,129,93,126,32,104,136,23,30,12,79,68,411
8635,Romeo Crouch,2018,2019,Presbyterian,Big South,68,1622,144,309,78,140,66,169,57,91,101,140,241,75,68,18,69,118,411
8636,Quintin Dove,2019,2019,Tennessee-Martin,OVC,31,739,160,268,150,240,10,28,81,100,81,80,161,13,27,16,32,101,411
8637,Xavier Harris,2013,2015,Fairleigh Dickinson,NEC,84,1382,171,337,171,337,0,0,69,128,124,200,324,37,22,54,100,230,411
8638,Josh Johnson,2011,2012,Presbyterian,Big South,53,1588,136,337,44,90,92,247,47,59,22,138,160,87,36,19,63,91,411
8639,Rob Kurz,2008,2008,Notre Dame,Big East,33,944,125,278,86,179,39,99,122,143,63,171,234,64,20,48,68,100,411
8640,Marcus Merriweather,2015,2018,Alabama A&M,SWAC,82,1193,130,384,70,191,60,193,91,113,21,76,97,67,15,1,89,103,411
8641,Bobby Nash,2008,2008,Hawaii,WAC,30,1065,136,359,77,188,59,171,80,91,34,103,137,80,17,7,35,64,411
8642,Chinanu Onuaku,2015,2016,Louisville,ACC,66,1385,182,294,182,293,0,1,47,86,160,263,423,70,50,104,109,175,411
8643,Alex Phillips,2013,2014,Omaha,Summit,62,1161,146,326,94,191,52,135,67,90,45,96,141,86,29,3,100,134,411
8644,David Rivers,2012,2015,Nebraska,Big Ten,107,2195,160,377,150,331,10,46,81,138,128,199,327,59,57,36,56,203,411
8645,Damion Rosser,2018,2019,New Orleans,Southland,66,1426,161,329,156,307,5,22,84,146,87,125,212,121,55,27,116,139,411
8646,Trey Touchet,2016,2019,Total,Total,118,1946,139,365,79,162,60,203,73,90,22,163,185,167,50,4,90,115,411
8647,Joel Angus III,2016,2018,Total,Total,51,1185,154,311,154,309,0,2,102,138,96,155,251,40,28,19,71,96,410
8648,Josimar Ayarza,2010,2011,Southern Mississippi,CUSA,61,1026,143,299,140,282,3,17,121,168,98,121,219,27,14,34,73,136,410
8649,Drew Barham,2010,2014,Total,Total,113,1161,136,328,30,71,106,257,32,52,69,132,201,38,44,22,39,158,410
8650,Brice Brooks,2008,2008,Sacred Heart,NEC,32,989,158,313,155,306,3,7,91,120,65,111,176,50,32,22,79,90,410
8651,David Carter,2008,2009,UC-Davis,Big West,62,1324,130,281,90,196,40,85,110,129,14,103,117,72,47,7,101,114,410
8652,Dorvell Carter,2010,2013,Marist,MAAC,76,1268,152,354,105,210,47,144,59,96,57,140,197,49,34,11,58,80,410
8653,Tyler Creammer,2017,2019,Virginia Military Institute,Southern,86,1314,155,352,149,327,6,25,94,137,112,247,359,41,21,32,89,162,410
8654,Brian Grandieri,2008,2008,Pennsylvania,Ivy,31,965,164,339,143,279,21,60,61,97,56,127,183,68,25,4,56,61,410
8655,Cameron Jones,2016,2019,Saint Peter's,MAAC,70,1492,137,384,44,112,93,272,43,57,35,138,173,70,55,9,76,151,410
8656,Durrell McDonald,2013,2015,DePaul,Big East,97,1766,155,382,97,223,58,159,42,64,34,145,179,133,101,12,112,203,410
8657,Kelvin Parker,2012,2013,Mount St. Mary's,NEC,57,1306,148,363,77,151,71,212,43,64,50,151,201,63,63,14,64,79,410
8658,Shembari Phillips,2016,2019,Total,Total,84,1401,133,344,90,217,43,127,101,131,35,142,177,99,33,12,105,171,410
8659,Prentice Small,2008,2011,Lehigh,Patriot,118,1757,118,362,102,289,16,73,158,234,28,122,150,270,74,1,148,143,410
8660,Kevin Thomas,2008,2009,Murray State,OVC,61,1626,125,299,89,185,36,114,124,170,28,126,154,255,69,0,140,149,410
8661,Rashad Vaughn,2015,2015,Nevada-Las Vegas,MWC,23,742,144,328,90,187,54,141,68,98,14,97,111,36,18,8,50,54,410
8662,Mohamed Bendary,2016,2019,NJIT,A-Sun,128,1479,181,278,181,277,0,1,47,77,133,207,340,84,26,55,92,247,409
8663,Traci Carter,2016,2019,Total,Total,72,1678,140,384,90,224,50,160,79,104,30,152,182,283,108,8,146,197,409
8664,Nate Darling,2017,2018,Alabama-Birmingham,CUSA,63,1205,142,296,63,108,79,188,46,57,15,100,115,107,16,11,82,64,409
8665,Nick Greenbacker,2010,2013,Sacred Heart,NEC,117,1862,171,405,139,302,32,103,35,65,91,179,270,79,58,65,108,263,409
8666,Drew Maynard,2009,2011,Oakland,Summit,73,1202,156,337,100,167,56,170,41,81,60,131,191,55,34,24,91,117,409
8667,Westly Perryman,2010,2012,Boise State,Total,72,1633,145,343,109,234,36,109,83,143,49,142,191,133,99,11,84,89,409
8668,Tywhon Pickford,2018,2019,Northern Iowa,MVC,61,1532,145,374,112,239,33,135,86,117,92,262,354,65,28,15,58,54,409
8669,Stevie Repichowski,2014,2018,Total,Total,103,1270,132,349,26,52,106,297,39,50,13,95,108,24,29,2,34,114,409
8670,Aamir Simms,2018,2019,Clemson,ACC,68,1430,158,350,104,186,54,164,39,58,76,189,265,55,29,54,64,127,409
8671,Brian Wright,2009,2011,Lipscomb,A-Sun,81,1422,145,384,69,148,76,236,43,67,54,136,190,75,43,32,75,151,409
8672,Earnest Bridges,2008,2011,High Point,Big South,108,1476,152,298,151,293,1,5,103,177,104,191,295,28,20,39,102,214,408
8673,Andre Coimbra,2011,2012,Central Michigan,MAC,63,1496,158,341,134,268,24,73,68,113,121,193,314,32,44,65,112,238,408
8674,Brendan Connolly,2010,2013,Princeton,Ivy,106,1542,165,313,165,312,0,1,78,127,112,171,283,96,31,51,82,202,408
8675,Mark Dorris,2008,2008,Marshall,CUSA,30,944,136,348,88,208,48,140,88,116,37,83,120,72,55,4,76,72,408
8676,Bassey Inameti,2009,2012,Tennessee Tech,OVC,112,1486,161,296,161,294,0,2,86,146,94,139,233,45,20,97,111,289,408
8677,Derek Reese,2013,2016,Tennessee,SEC,104,1915,143,352,96,210,47,142,75,113,142,313,455,71,47,42,71,184,408
8678,Daniel Ruffin,2008,2008,Bradley,MVC,29,972,122,310,59,139,63,171,101,121,29,74,103,169,53,3,96,49,408
8679,Adam Walker,2008,2010,Howard,MEAC,76,1850,158,406,153,384,5,22,87,165,116,288,404,100,30,85,139,169,408
8680,John Barber,2008,2008,Youngstown State,Horizon,30,971,158,357,130,272,28,85,63,92,55,155,210,35,19,17,69,52,407
8681,George Davis,2008,2010,Arkansas-Pine Bluff,SWAC,94,1458,164,355,157,337,7,18,72,128,137,194,331,25,47,42,88,250,407
8682,Jake Diebler,2008,2009,Valparaiso,Horizon,67,2159,125,342,33,82,92,260,65,82,51,125,176,148,81,8,63,177,407
8683,Shaun Doss,2019,2019,Arkansas-Pine Bluff,SWAC,32,973,130,281,110,213,20,68,127,188,44,89,133,55,34,13,73,76,407
8684,Anthony Elechi,2015,2016,Morehead State,OVC,66,1057,163,307,162,303,1,4,80,104,141,152,293,20,25,21,58,204,407
8685,Tyler Gaskins,2014,2015,Saint Peter's,MAAC,62,1324,153,388,95,217,58,171,43,76,32,93,125,77,43,7,88,102,407
8686,Jarhon Giddings,2008,2009,Richmond,A-10,67,1186,151,325,118,207,33,118,72,102,55,140,195,49,32,42,70,137,407
8687,Abdoulaye Gueye,2015,2019,Georgia Tech,ACC,89,1440,168,347,164,323,4,24,67,118,110,193,303,67,44,75,113,190,407
8688,Jaylen Hoard,2019,2019,Wake Forest,ACC,31,936,152,332,140,279,12,53,91,127,80,156,236,47,19,20,78,68,407
8689,Matt Johnson,2008,2009,Northern Arizona,Big Sky,51,1283,142,319,87,178,55,141,68,99,33,134,167,127,34,8,117,87,407
8690,Matt Mierzycki,2010,2011,Texas-Rio Grande Valley,GWC,56,1309,132,339,130,321,2,18,141,223,116,209,325,74,34,5,127,183,407
8691,Malik Petteway,2018,2019,Robert Morris,NEC,48,907,149,315,148,313,1,2,108,170,96,164,260,17,50,50,57,137,407
8692,Michael Steadman,2019,2019,San Jose State,MWC,31,945,169,350,164,328,5,22,64,105,72,192,264,27,4,14,75,76,407
8693,Marcus Thomas,2018,2019,Western Carolina,Southern,55,913,140,322,103,215,37,107,90,123,41,103,144,56,34,12,87,95,407
8694,Xeyrius Williams,2016,2018,Dayton,A-10,77,1307,147,334,87,166,60,168,53,67,77,177,254,62,39,56,63,134,407
8695,Ben Wilson,2015,2016,Idaho State,Big Sky,59,1961,152,335,151,332,1,3,102,158,54,222,276,171,53,9,103,129,407
8696,Mike Amius,2018,2018,Western Carolina,Southern,32,738,152,277,152,277,0,0,102,161,62,117,179,35,38,27,90,97,406
8697,Mason Archie,2012,2016,Total,Total,88,1595,137,385,82,203,55,182,77,103,50,111,161,69,35,2,92,143,406
8698,Ty Armstrong,2010,2013,Total,Total,77,996,169,309,169,306,0,3,68,117,89,132,221,27,20,29,64,160,406
8699,Elgin Bailey,2008,2012,Total,Total,94,1182,146,350,146,349,0,1,114,213,116,170,286,15,34,57,117,188,406
8700,Ray Chambers,2012,2013,Troy,Sun Belt,61,1227,168,332,168,330,0,2,70,92,146,174,320,15,17,22,49,130,406
8701,Dylan Chatman,2014,2015,Eastern Illinois,OVC,63,1650,131,339,38,90,93,249,51,76,16,154,170,114,66,5,77,120,406
8702,Ferron Flavors Jr.,2018,2018,Fairfield,MAAC,33,1033,134,378,39,95,95,283,43,58,18,102,120,36,20,0,27,64,406
8703,Gavin Grant,2008,2008,North Carolina State,ACC,31,956,125,271,93,189,32,82,124,163,44,94,138,91,25,18,75,57,406
8704,John Griffin,2008,2008,Bucknell,Patriot,31,997,115,303,36,86,79,217,97,125,22,72,94,84,47,5,83,77,406
8705,James Harrison,2014,2018,Total,Total,68,935,144,346,56,111,88,235,30,42,25,76,101,36,28,5,46,95,406
8706,Shawn Henderson,2010,2011,Idaho,WAC,62,1375,157,398,128,308,29,90,63,94,58,165,223,114,52,2,81,112,406
8707,Vonn Jones,2012,2013,Texas State,Total,64,1367,130,342,76,174,54,168,92,135,31,79,110,207,104,3,107,106,406
8708,Austin Lewis,2013,2016,McNeese State,Southland,115,1609,175,319,175,318,0,1,56,107,174,219,393,16,23,163,63,233,406
8709,Jeff Lowery,2014,2017,Total,Total,63,1465,141,342,120,288,21,54,103,145,15,85,100,181,62,4,121,140,406
8710,Michel Nzege,2015,2017,East Carolina,AAC,88,1505,167,306,165,298,2,8,70,105,141,198,339,48,29,26,83,155,406
8711,Matt Pressey,2011,2012,Missouri,Big 12,68,1452,143,352,106,234,37,118,83,121,46,119,165,107,53,10,76,97,406
8712,Isaiah Roberts,2011,2013,Navy,Patriot,67,1472,142,336,115,242,27,94,95,149,29,96,125,108,72,12,123,178,406
8713,Jacquez Rozier,2012,2015,Middle Tennessee,Total,99,1572,142,307,140,296,2,11,120,203,147,175,322,47,47,48,96,190,406
8714,Anton Silver,2009,2010,Gardner-Webb,Big South,53,829,145,356,84,176,61,180,55,91,38,110,148,54,27,4,87,88,406
8715,Elyjah Williams,2018,2019,Fairleigh Dickinson,NEC,65,1362,158,256,146,232,12,24,78,137,114,192,306,96,58,54,100,143,406
8716,Kellen Williams,2008,2008,Eastern Washington,Big Sky,30,1064,154,304,124,213,30,91,68,94,89,159,248,49,34,6,45,70,406
8717,Jonas Brown,2008,2008,Louisiana-Monroe,Sun Belt,31,1041,132,305,76,157,56,148,85,121,40,71,111,81,42,11,77,61,405
8718,Sam Coleman,2009,2010,Coppin State,MEAC,52,1234,151,353,150,347,1,6,102,142,111,164,275,17,23,39,64,130,405
8719,Alioune Diouf,2010,2013,James Madison,CAA,110,1778,156,395,138,324,18,71,75,128,103,213,316,87,63,34,119,143,405
8720,Ty Egbert,2014,2017,Idaho,Total,111,1423,150,282,150,282,0,0,105,167,90,197,287,32,15,52,72,192,405
8721,Augustine Ene,2018,2019,Incarnate Word,Southland,56,1179,142,312,102,204,40,108,81,96,47,108,155,60,48,22,90,97,405
8722,Tobi Ewuosho,2018,2019,Alabama State,SWAC,59,1321,137,332,121,274,16,58,115,182,85,176,261,63,63,16,102,148,405
8723,Rob Ferguson,2008,2008,Saint Joseph's,A-10,34,1111,155,300,96,167,59,133,36,43,56,107,163,39,26,39,45,92,405
8724,Blaise Ffrench,2009,2013,Total,Total,105,2013,155,419,146,377,9,42,86,161,37,181,218,257,90,13,190,169,405
8725,Dallas Gary,2014,2015,Coppin State,MEAC,59,1033,124,311,102,222,22,89,135,192,32,135,167,41,18,10,85,76,405
8726,Anton Gill,2014,2018,Total,Total,97,1397,138,381,59,141,79,240,50,80,18,105,123,62,37,6,57,109,405
8727,Jashire Hardnett,2018,2019,Brigham Young,WCC,55,1420,142,321,117,230,25,91,96,118,18,118,136,105,44,3,83,125,405
8728,Adam McCoy,2008,2009,North Texas,Sun Belt,57,695,136,326,57,124,79,202,54,65,30,69,99,31,22,4,50,36,405
8729,Carter Skaggs,2018,2019,Washington State,Pac-12,56,1051,132,322,24,42,108,280,33,37,21,103,124,35,12,2,49,62,405
8730,Jeremy Watson,2015,2016,Jacksonville State,OVC,60,1376,118,301,103,252,15,49,154,209,116,211,327,22,21,15,70,103,405
8731,Jordan Weiner,2008,2011,UC-Santa Barbara,Big West,109,1465,129,330,26,56,103,274,44,59,18,87,105,101,92,6,67,146,405
8732,Bishop Wheatley,2008,2010,Tulsa,CUSA,91,2229,145,338,143,321,2,17,113,161,103,218,321,92,40,26,108,228,405
8733,Todd Babington,2008,2008,Austin Peay,OVC,35,1046,126,304,24,37,102,267,50,74,17,65,82,50,41,1,40,71,404
8734,Nick Fuller,2015,2018,Total,Total,90,978,145,263,131,213,14,50,100,135,73,143,216,29,26,17,47,131,404
8735,Kevin Galloway,2009,2011,Total,Total,62,1494,136,341,108,240,28,101,104,184,52,224,276,251,72,38,200,88,404
8736,Myron Gordon,2019,2019,Samford,Southern,33,972,129,291,94,187,35,104,111,130,13,65,78,58,25,8,49,54,404
8737,Keith Matthews,2011,2013,Fairfield,MAAC,102,1387,161,348,159,338,2,10,80,136,106,141,247,37,41,50,73,180,404
8738,Mark Smith,2018,2019,Total,Total,51,1157,134,347,67,166,67,181,69,87,34,111,145,76,31,3,66,124,404
8739,Peyton Stovall,2008,2008,Ball State,MAC,30,1072,139,299,98,194,41,105,85,118,61,119,180,67,39,5,66,70,404
8740,Dwight Wilson,2018,2019,James Madison,CAA,58,1063,174,311,174,311,0,0,56,82,128,208,336,20,15,18,62,111,404
8741,Donte Wright,2018,2018,South Carolina State,MEAC,32,836,129,349,36,91,93,258,53,65,19,54,73,29,22,2,47,61,404
8742,Jahvon Blair,2018,2019,Georgetown,Big East,61,1044,123,362,41,114,82,248,75,94,31,75,106,91,18,0,60,52,403
8743,John Brandenburg,2009,2013,Total,Total,98,1393,154,337,154,336,0,1,95,139,102,155,257,46,23,70,93,148,403
8744,Zach Coleman,2015,2018,Total,Total,104,1633,141,376,95,197,46,179,75,126,133,273,406,76,46,53,95,201,403
8745,Patrick Foley,2008,2010,Columbia,Ivy,44,1048,134,333,111,257,23,76,112,139,10,60,70,115,34,5,84,79,403
8746,Jordan Hamilton,2009,2012,Lehigh,Patriot,93,1375,139,327,81,148,58,179,67,89,46,86,132,45,28,31,63,162,403
8747,Jay Higgins,2010,2011,Eastern Michigan,MAC,63,1848,130,397,43,114,87,283,56,122,61,153,214,133,64,12,102,127,403
8748,Mike Jefferson,2008,2008,High Point,Big South,31,1086,129,335,64,141,65,194,80,107,20,94,114,216,41,1,112,69,403
8749,Shamarkus Kennedy,2019,2019,McNeese State,Southland,31,807,157,244,157,242,0,2,89,132,81,136,217,31,16,59,72,94,403
8750,Abe Lodwick,2009,2012,Washington State,Total,111,1897,138,362,45,100,93,262,34,46,85,266,351,89,41,25,81,249,403
8751,Martavious Newby,2013,2016,Mississippi,SEC,114,2062,122,317,93,201,29,116,130,182,155,302,457,158,123,20,120,209,403
8752,Sheldon Oliver,2008,2010,Stetson,A-Sun,67,1517,144,337,144,335,0,2,115,204,170,135,305,29,59,16,84,119,403
8753,Andrew Pusar,2008,2009,Harvard,Ivy,55,1319,163,312,124,208,39,104,38,64,79,68,147,68,30,9,91,68,403
8754,Jalen Reeder,2018,2019,Alabama A&M,SWAC,55,1174,150,386,99,210,51,176,52,83,44,112,156,53,26,6,88,63,403
8755,Jarred Reuter,2016,2019,Total,Total,91,1074,158,318,158,317,0,1,87,125,79,154,233,76,17,8,79,119,403
8756,Raymond Sykes,2008,2009,Clemson,ACC,66,1188,174,302,174,302,0,0,55,102,124,121,245,37,36,58,99,116,403
8757,Vacha Vaughn,2014,2017,Mississippi Valley State,SWAC,122,1899,154,351,146,321,8,30,87,136,134,278,412,99,62,9,102,264,403
8758,Teondre Williams,2009,2011,Oregon,Pac-10,83,1220,151,358,106,241,45,117,56,92,62,89,151,48,39,32,75,95,403
8759,Kellen Allen,2008,2008,Long Island University,NEC,30,670,158,300,158,300,0,0,86,163,58,80,138,14,8,13,66,62,402
8760,Chris Barnes,2008,2011,Georgia,SEC,116,1712,150,302,150,302,0,0,102,206,167,222,389,44,43,85,109,184,402
8761,Thik Bol,2017,2019,Southern Illinois,MVC,62,1339,174,349,173,348,1,1,53,92,103,209,312,15,13,107,60,116,402
8762,Kevin Bradshaw,2011,2012,UC-Riverside,Big West,59,1391,156,329,156,328,0,1,90,156,112,187,299,30,37,40,100,195,402
8763,Paris Burns,2015,2016,Illinois-Chicago,Horizon,44,1016,142,351,111,248,31,103,87,114,17,82,99,108,35,4,85,111,402
8764,Nikola Cerina,2010,2014,Total,Total,108,1623,156,323,148,291,8,32,82,154,92,224,316,43,51,33,101,258,402
8765,Rodney Clinkscales,2010,2012,Southern Methodist,CUSA,88,1460,131,317,44,95,87,222,53,62,12,85,97,75,35,3,60,80,402
8766,Tyran de Lattibeaudiere,2015,2015,Lamar,Southland,30,893,167,290,167,290,0,0,68,128,86,146,232,47,40,63,94,99,402
8767,Fredrick Edmond,2016,2016,Western Kentucky,CUSA,33,954,163,285,155,264,8,21,68,125,38,158,196,90,33,15,72,53,402
8768,Stefan Gonzalez,2016,2019,Total,Total,90,1130,137,308,37,71,100,237,28,39,13,158,171,49,19,0,49,63,402
8769,Justin Gorham,2017,2018,Towson,CAA,64,1066,156,292,153,278,3,14,87,134,115,191,306,34,17,7,67,138,402
8770,Alex Hunter,2018,2019,Furman,Southern,66,1556,144,332,66,122,78,210,36,47,19,143,162,145,40,2,53,88,402
8771,Terry Martin,2008,2009,Louisiana State,SEC,62,1244,149,406,82,197,67,209,37,53,33,115,148,82,17,19,75,82,402
8772,Lawrence McKenzie,2008,2008,Minnesota,Big Ten,34,916,124,296,45,112,79,184,75,97,16,63,79,89,31,2,75,72,402
8773,Ramon Mercado,2013,2014,Hampton,MEAC,61,1161,131,378,54,120,77,258,63,82,30,131,161,49,40,17,69,91,402
8774,Myron Strong,2008,2010,Total,Total,63,1420,157,374,125,256,32,118,56,91,30,95,125,159,80,4,108,146,402
8775,Frank Tolbert,2008,2008,Auburn,SEC,30,909,134,312,102,210,32,102,102,134,66,89,155,67,46,14,76,109,402
8776,Isaiah Tripp,2015,2018,Abilene Christian,Southland,114,1507,131,307,76,158,55,149,85,115,34,95,129,97,45,2,70,162,402
8777,Jordan Aaberg,2010,2014,North Dakota State,Summit,115,1287,167,270,167,270,0,0,67,85,85,180,265,24,26,90,68,186,401
8778,Tyrone Caldwell,2009,2011,Austin Peay,OVC,99,1488,129,276,92,181,37,95,106,147,28,106,134,216,59,3,133,103,401
8779,Tony Davis,2008,2009,Central Florida,CUSA,51,1174,141,313,124,247,17,66,102,145,114,207,321,45,53,58,84,142,401
8780,Duke Ethridge,2015,2016,Chattanooga,Southern,62,892,139,281,115,202,24,79,99,137,73,145,218,19,25,36,59,98,401
8781,Alterique Gilbert,2017,2019,Connecticut,AAC,34,989,136,360,87,204,49,156,80,110,12,95,107,114,47,5,71,65,401
8782,Nate Lozeau,2008,2012,Total,Total,90,1282,167,307,167,307,0,0,67,101,78,176,254,8,19,30,70,172,401
8783,Carl Lucas,2008,2008,Mississippi Valley State,SWAC,32,916,134,306,107,239,27,67,106,146,75,101,176,29,22,11,71,88,401
8784,Erik Marschall,2009,2010,Bowling Green State,MAC,63,1332,159,314,156,300,3,14,80,127,99,175,274,54,39,35,81,170,401
8785,Haiishen McIntyre,2013,2016,High Point,Big South,105,1735,130,324,117,271,13,53,128,176,32,149,181,226,99,12,100,136,401
8786,Rodrigue Mels,2008,2009,Cal State Northridge,Big West,54,898,144,342,98,193,46,149,67,84,34,91,125,56,74,11,82,107,401
8787,Cookie Miller,2008,2009,Nebraska,Big 12,60,1654,132,326,93,202,39,124,98,130,15,111,126,218,103,1,123,89,401
8788,Ryan Pierson,2011,2015,Total,Total,97,1370,154,362,152,348,2,14,91,117,84,123,207,38,22,23,71,170,401
8789,Daniel Puckett,2008,2009,Tulane,CUSA,62,1409,143,364,114,275,29,89,86,131,71,172,243,84,46,32,102,163,401
8790,Austin Reaves,2017,2018,Wichita State,Total,66,1098,124,276,42,94,82,182,71,89,23,139,162,104,28,18,56,79,401
8791,Jamal Reynolds,2015,2016,Canisius,MAAC,65,1429,130,266,128,261,2,5,139,204,147,228,375,85,49,24,64,121,401
8792,Marquis Teague,2012,2012,Kentucky,SEC,40,1303,145,352,119,272,26,80,85,119,17,84,101,191,37,11,109,91,401
8793,Karl-Anthony Towns,2015,2015,Kentucky,SEC,39,822,145,256,143,248,2,8,109,134,92,169,261,44,18,88,53,115,401
8794,Nicholas Wilson,2008,2009,North Carolina A&T,MEAC,55,1065,143,357,73,169,70,188,45,68,68,112,180,38,54,25,86,110,401
8795,Oliver Black,2015,2018,Total,Total,95,1963,158,307,158,306,0,1,84,159,144,254,398,68,27,46,116,248,400
8796,Sasa Borovnjak,2010,2013,Penn State,Big Ten,81,1411,162,299,162,297,0,2,76,120,92,139,231,23,26,18,64,165,400
8797,Rakeem Dickerson,2012,2014,Arkansas State,Sun Belt,95,1708,110,298,83,210,27,88,153,210,38,124,162,179,86,3,116,145,400
8798,Michael Dunn,2010,2013,Northern Arizona,Big Sky,85,1518,129,332,89,192,40,140,102,133,41,157,198,109,70,16,102,176,400
8799,Drake Green,2015,2018,Abilene Christian,Southland,116,1708,142,399,57,152,85,247,31,42,23,133,156,80,54,15,75,194,400
8800,Marty Hill,2018,2019,Evansville,MVC,40,1015,151,342,87,192,64,150,34,47,31,117,148,60,40,6,47,88,400
8801,Prince Ibeh,2013,2016,Texas,Big 12,135,1769,157,282,157,281,0,1,86,199,185,270,455,14,37,212,105,342,400
8802,Cavell Johnson,2008,2008,Maryland-Baltimore County,AEC,31,838,166,318,161,303,5,15,63,111,73,136,209,31,15,70,34,77,400
8803,Durrell Norman,2011,2012,Northern Arizona,Big Sky,61,1333,141,279,134,256,7,23,111,166,119,170,289,55,38,16,84,146,400
8804,Kevin Obanor,2019,2019,Oral Roberts,Summit,27,627,132,227,106,164,26,63,110,133,71,130,201,13,4,8,44,69,400
8805,Blake Paul,2016,2019,Tulane,AAC,122,1653,160,317,160,316,0,1,80,125,121,246,367,65,30,104,109,247,400
8806,Cory Remekun,2010,2013,Saint Louis,A-10,133,1847,158,312,158,312,0,0,84,158,111,179,290,55,41,113,121,260,400
8807,Jack Trotter,2009,2012,Stanford,Total,108,1545,161,336,153,308,8,28,70,103,118,181,299,43,16,24,52,188,400
8808,Venjie Wallis,2016,2019,Total,Total,37,983,132,310,112,241,20,69,116,179,50,85,135,68,47,14,76,94,400
8809,Austin Wiley,2017,2019,Auburn,SEC,51,781,148,257,148,254,0,3,104,198,97,127,224,7,11,65,70,118,400
8810,Derrick Wilson,2012,2015,Marquette,Big East,132,2789,150,387,139,324,11,63,89,195,91,227,318,366,123,14,127,237,400
8811,Derek Wright,2008,2008,Austin Peay,OVC,35,1133,128,297,75,165,53,132,91,115,7,79,86,165,89,4,74,69,400
8812,Andre Adams,2014,2019,Total,Total,79,1217,162,297,158,270,4,27,71,113,60,194,254,73,44,28,117,179,399
8813,Brandon Averette,2017,2018,Oklahoma State,Big 12,69,1203,148,349,128,290,20,59,83,111,9,104,113,164,49,1,100,106,399
8814,Raye Bailey,2008,2009,Savannah State,Ind,59,1393,112,277,66,168,46,109,129,163,25,115,140,161,67,2,156,145,399
8815,Glen Burns,2017,2018,Chicago State,WAC,44,1266,120,267,104,220,16,47,143,193,36,123,159,148,54,4,119,112,399
8816,K.J. Byers,2018,2019,Long Beach State,Big West,63,1334,145,315,123,219,22,96,87,146,85,237,322,57,62,66,115,130,399
8817,Justin Drummond,2008,2009,Wagner,NEC,61,1522,141,347,110,260,31,87,86,130,44,163,207,165,64,34,116,98,399
8818,Mark Flagg,2018,2019,Saint Francis (PA),NEC,64,1086,148,292,145,279,3,13,100,163,130,151,281,34,34,57,66,157,399
8819,Donovan Gilmore,2015,2019,Total,Total,116,1389,155,301,153,293,2,8,87,126,104,253,357,22,34,31,87,191,399
8820,Jalen Harris,2017,2019,Total,Total,65,1685,132,356,117,260,15,96,120,170,20,135,155,256,63,9,105,139,399
8821,Terry Harris,2015,2019,Total,Total,76,1094,133,333,57,129,76,204,57,79,40,112,152,25,20,7,49,86,399
8822,Jonathan Huffman,2009,2010,Iona,MAAC,61,1119,139,343,64,141,75,202,46,71,33,167,200,22,11,20,62,93,399
8823,Phillip Jones,2014,2017,Total,Total,81,1198,136,319,132,301,4,18,123,227,141,196,337,40,57,41,111,164,399
8824,Bryan Petersen,2008,2009,Iowa State,Big 12,64,1861,123,312,26,57,97,255,56,67,21,164,185,178,48,5,104,140,399
8825,Nick Robinson,2017,2018,Saint Joseph's,A-10,62,1528,133,321,107,231,26,90,107,157,61,213,274,137,44,27,95,166,399
8826,Andrew Steele,2009,2013,Alabama,SEC,94,1775,124,301,99,211,25,90,126,176,59,182,241,128,66,7,101,151,399
8827,Cameron Tyler,2009,2009,Fairleigh Dickinson,NEC,30,1062,126,328,104,243,22,85,125,188,26,76,102,160,31,3,129,62,399
8828,Jy'lan Washington,2016,2018,Louisiana Tech,CUSA,97,1427,134,300,89,161,45,139,86,137,81,157,238,43,40,50,60,129,399
8829,Christian Bradford,2017,2018,Radford,Big South,68,1738,142,398,88,216,54,182,60,79,18,139,157,180,36,3,100,94,398
8830,Jiri Hubalek,2008,2008,Iowa State,Big 12,32,820,140,304,125,261,15,43,103,142,73,161,234,31,20,15,57,97,398
8831,David Jackson,2008,2008,Western Illinois,Summit,29,880,139,333,119,279,20,54,100,124,34,96,130,62,30,16,68,80,398
8832,Michael Kirby,2008,2009,Pacific,Big West,57,1286,119,273,41,105,78,168,82,100,10,79,89,118,32,8,106,79,398
8833,Latrell Love,2015,2016,Mississippi Valley State,SWAC,65,1052,132,328,132,324,0,4,134,201,45,90,135,26,17,14,59,84,398
8834,Charles McKinney,2012,2014,DePaul,Big East,89,1608,155,311,143,259,12,52,76,133,79,116,195,116,90,20,117,185,398
8835,Gio McLean,2016,2017,Total,Total,38,1001,129,365,70,184,59,181,81,103,30,114,144,101,23,1,89,83,398
8836,Brandon Morris,2013,2014,Georgia,SEC,63,1309,124,270,114,237,10,33,140,220,59,120,179,67,32,17,89,118,398
8837,Ian O'Leary,2008,2009,Saint Mary's (CA),WCC,67,1306,144,333,98,205,46,128,64,97,130,170,300,52,39,23,71,111,398
8838,Paige Paulsen,2008,2008,Milwaukee,Horizon,30,1032,125,320,52,134,73,186,75,95,53,138,191,42,28,8,44,67,398
8839,Jordan Perkins,2018,2019,North Carolina Central,MEAC,64,1562,140,351,112,268,28,83,90,127,45,128,173,315,46,16,159,158,398
8840,Ivan Raut,2018,2019,Fordham,A-10,61,1494,135,357,45,84,90,273,38,51,16,171,187,62,45,2,69,87,398
8841,Patrick Robinson,2011,2014,Northwestern State,Southland,125,2084,138,326,119,233,19,93,103,172,157,189,346,116,97,45,136,305,398
8842,Jake Silpe,2016,2019,Pennsylvania,Ivy,95,1673,133,324,78,158,55,166,77,121,46,163,209,164,80,4,101,171,398
8843,Rodney Stokes,2008,2011,Morgan State,MEAC,113,1415,165,319,165,319,0,0,68,104,128,181,309,35,32,96,72,213,398
8844,Andrew Strait,2008,2008,Montana,Big Sky,30,897,166,260,164,257,2,3,64,100,58,141,199,27,24,20,50,73,398
8845,Dazzmond Thornton,2008,2010,James Madison,CAA,76,1061,166,298,166,298,0,0,66,102,63,133,196,16,21,15,107,130,398
8846,Stephen Tyree,2008,2011,Bucknell,Patriot,73,1736,133,250,119,211,14,39,118,182,104,220,324,142,58,11,116,200,398
8847,Caleb Walker,2011,2012,Nebraska,Total,62,1418,140,306,101,180,39,126,79,118,66,198,264,61,34,11,87,88,398
8848,Varez Ward,2009,2012,Total,Total,62,1292,118,326,95,221,23,105,139,213,42,122,164,160,42,14,122,118,398
8849,Isaiah Washington,2018,2019,Minnesota,Big Ten,60,1092,148,427,117,293,31,134,71,95,27,101,128,153,33,6,83,72,398
8850,Clay Wilson,2012,2015,Princeton,Ivy,87,1189,132,321,40,72,92,249,42,58,9,71,80,42,24,0,40,92,398
8851,Kassoum Yakwe,2016,2019,Total,Total,96,1710,144,322,144,322,0,0,110,197,122,205,327,42,32,157,102,249,398
8852,Georgios Angelou,2014,2017,Saint Francis (PA),NEC,82,1271,124,302,23,51,101,251,48,55,8,75,83,91,25,3,79,77,397
8853,Michael Gilmore,2015,2019,Total,Total,113,1188,157,322,116,202,41,120,42,79,74,264,338,48,35,39,99,219,397
8854,Jermaine Griffin,2008,2008,Texas-Arlington,Southland,33,805,164,259,164,258,0,1,69,138,78,157,235,27,8,34,64,80,397
8855,R.J. Kelly,2017,2019,Total,Total,59,1494,140,273,112,183,28,90,89,140,113,178,291,64,40,52,78,170,397
8856,Tommie McCune,2012,2015,Total,Total,77,1126,140,323,119,234,21,89,96,132,67,161,228,59,26,13,104,158,397
8857,Connor Nolte,2008,2012,Total,Total,106,1584,134,342,54,115,80,227,49,75,88,185,273,64,55,21,85,152,397
8858,Michael Orris,2013,2017,Total,Total,102,2275,146,394,125,290,21,104,84,132,30,111,141,262,68,3,162,205,397
8859,Nick Shaw,2008,2009,Stephen F. Austin,Southland,64,1745,149,322,114,212,35,110,64,106,84,266,350,85,29,11,89,184,397
8860,Sean Smith,2008,2009,Northern Illinois,MAC,54,1201,156,362,123,273,33,89,52,69,52,113,165,69,40,16,83,100,397
8861,Ricmonds Vilde,2012,2015,Total,Total,74,1090,159,295,148,265,11,30,68,105,94,226,320,41,18,35,114,167,397
8862,Matt Weir,2018,2019,Purdue-Fort Wayne,Summit,66,1245,118,266,41,90,77,176,84,95,12,79,91,151,21,0,81,72,397
8863,Marcus Wright,2009,2011,Appalachian State,Southern,87,1291,143,345,101,211,42,134,69,98,25,125,150,120,44,6,146,130,397
8864,Chad Adams,2010,2013,New Mexico,MWC,128,1447,138,295,101,208,37,87,83,113,64,178,242,62,45,8,64,171,396
8865,Avery Bradley,2010,2010,Texas,Big 12,34,1003,159,368,117,256,42,112,36,66,33,65,98,71,44,18,52,80,396
8866,Donavan Bragg,2011,2011,Cal State Bakersfield,Ind,28,882,119,323,75,196,44,127,114,136,20,54,74,66,22,1,59,36,396
8867,Troy Brown,2018,2018,Oregon,Pac-12,35,1093,143,322,111,212,32,110,78,105,53,164,217,111,55,7,86,78,396
8868,Billy Giles,2016,2017,Robert Morris,NEC,59,1173,171,286,171,282,0,4,54,110,101,144,245,17,28,34,52,133,396
8869,Cornelius Hudson,2015,2016,Wake Forest,ACC,52,1165,121,345,53,118,68,227,86,122,32,134,166,62,44,11,80,99,396
8870,Kimani Jackson,2016,2018,Total,Total,72,1085,152,272,150,260,2,12,90,141,127,154,281,27,25,45,93,188,396
8871,Donald Johnson,2011,2012,Cal State Bakersfield,Ind,56,1122,148,305,111,211,37,94,63,76,81,171,252,35,24,47,67,136,396
8872,David Kadiri,2014,2017,Total,Total,88,1240,164,284,164,283,0,1,68,124,114,142,256,14,19,55,49,223,396
8873,Greg Kelley,2012,2015,Yale,Ivy,108,1149,138,347,71,151,67,196,53,69,71,145,216,41,16,21,45,162,396
8874,Jake Lindsey,2016,2018,Baylor,Big 12,103,2015,148,335,108,222,40,113,60,88,39,176,215,293,70,31,104,216,396
8875,Kevin McAdoo,2018,2019,Eastern Michigan,MAC,59,1037,139,328,77,148,62,180,56,77,17,36,53,60,34,3,68,63,396
8876,Jeffery McClendon,2016,2019,Loyola Marymount,WCC,115,2026,140,380,103,251,37,129,79,121,94,149,243,134,144,15,109,253,396
8877,Jack McGillis,2009,2010,Montana,Big Sky,59,1337,141,350,108,240,33,110,81,126,56,136,192,78,41,20,80,169,396
8878,Shawntez Patterson,2009,2013,Total,Total,58,1221,144,405,67,191,77,214,31,67,62,153,215,39,25,31,85,120,396
8879,Karim Rowson,2013,2014,South Dakota,Summit,60,1163,126,287,117,251,9,36,135,189,53,156,209,39,42,18,80,84,396
8880,E.J. Stephens,2018,2019,Lafayette,Patriot,57,1311,152,333,105,196,47,137,45,65,25,119,144,71,23,18,49,73,396
8881,Mustapha Traore,2017,2019,Monmouth,MAAC,93,1447,163,323,163,322,0,1,70,123,120,234,354,55,38,28,96,150,396
8882,Craig Victor,2015,2017,Total,Total,41,932,148,330,147,322,1,8,99,161,83,126,209,28,38,23,43,123,396
8883,Travon Bell,2018,2019,Chicago State,WAC,54,1148,141,377,50,104,91,273,22,32,24,124,148,56,48,8,58,95,395
8884,Kyle Coston,2008,2009,Portland State,Big Sky,65,1380,129,356,60,152,69,204,68,105,53,154,207,87,22,27,94,159,395
8885,Barry Eberhardt,2008,2009,Saint Louis,A-10,62,1217,161,304,149,264,12,40,61,97,82,177,259,43,21,13,72,166,395
8886,Travis Elliott,2011,2015,Total,Total,120,2198,150,354,150,354,0,0,95,183,197,291,488,39,49,41,115,327,395
8887,Tevin Foster,2018,2018,Abilene Christian,Southland,32,1037,122,291,76,146,46,145,105,131,20,79,99,112,47,4,84,74,395
8888,Felipe Haase,2018,2019,South Carolina,SEC,65,1399,133,339,75,165,58,174,71,90,79,170,249,67,31,14,81,142,395
8889,Matt Hubbard,2015,2017,Santa Clara,WCC,69,1368,145,379,94,196,51,183,54,71,64,147,211,44,16,21,79,136,395
8890,Deon Lyle,2018,2018,Texas-San Antonio,CUSA,35,687,136,327,40,89,96,238,27,43,29,100,129,12,9,4,35,72,395
8891,Taj McCullough,2008,2008,Winthrop,Big South,34,961,149,319,125,231,24,88,73,121,57,139,196,46,49,16,62,84,395
8892,Darris Nichols,2008,2008,West Virginia,Big East,37,1282,134,304,72,143,62,161,65,90,24,99,123,119,43,17,42,77,395
8893,Pauly Paulicap,2018,2019,Manhattan,MAAC,41,901,141,265,141,265,0,0,113,179,110,143,253,9,14,86,61,139,395
8894,Travis Peterson,2008,2008,Samford,OVC,30,940,145,291,104,159,41,132,64,90,29,113,142,107,25,41,63,63,395
8895,Ahsante Shivers,2017,2018,Siena,MAAC,65,1395,130,325,99,226,31,99,104,150,56,151,207,75,33,10,92,126,395
8896,Alan-Michael Thompson,2012,2013,Louisiana,Sun Belt,62,1083,133,334,56,103,77,231,52,71,17,53,70,26,26,4,39,93,395
8897,Souley Boum,2018,2018,San Francisco,WCC,36,732,113,311,66,181,47,130,121,146,21,74,95,37,19,5,62,60,394
8898,Marcus Britt,2008,2011,Arkansas,SEC,113,1841,140,328,83,173,57,155,57,65,54,141,195,126,90,15,81,138,394
8899,Dan Coleman,2008,2008,Minnesota,Big Ten,34,917,157,335,153,311,4,24,76,97,72,126,198,26,29,41,57,95,394
8900,Eric Coleman,2008,2008,Northern Iowa,MVC,32,763,135,245,135,244,0,1,124,191,56,225,281,63,20,43,70,96,394
8901,Bobby Conley,2016,2017,Texas State,Sun Belt,67,1519,135,348,79,177,56,171,68,109,24,165,189,109,45,15,55,95,394
8902,Justin Coughlin,2009,2012,Denver,Sun Belt,118,1475,138,298,91,153,47,145,71,111,31,111,142,92,36,74,86,208,394
8903,Anthony Cousin,2011,2013,Illinois State,MVC,92,1835,124,348,75,188,49,160,97,131,21,100,121,168,46,0,114,98,394
8904,Dominique Ferguson,2011,2012,Florida International,Sun Belt,49,1379,142,345,129,281,13,64,97,183,93,182,275,31,32,59,89,149,394
8905,Daniel Grieves,2014,2016,Total,Total,68,1267,136,330,73,137,63,193,59,92,62,134,196,51,40,16,74,167,394
8906,Justin Haynes,2009,2011,Southern Methodist,CUSA,94,1691,146,257,123,192,23,65,79,166,54,131,185,86,65,8,93,170,394
8907,Frank Jackson,2017,2017,Duke,ACC,36,895,133,281,82,152,51,129,77,102,23,67,90,61,20,2,49,85,394
8908,Kelvin Jones,2017,2019,Total,Total,61,986,165,304,165,304,0,0,64,111,108,171,279,31,17,71,81,197,394
8909,K.J. Matsui,2008,2009,Columbia,Ivy,53,1033,134,308,33,67,101,241,25,31,13,60,73,33,24,1,51,59,394
8910,Adhar Mayen,2008,2010,Hawaii,WAC,85,1526,152,369,108,223,44,146,46,64,63,117,180,80,31,14,100,177,394
8911,Brandon Miller,2016,2019,Gardner-Webb,Big South,103,1384,149,273,147,270,2,3,94,180,123,179,302,20,38,39,74,256,394
8912,Rinardo Perry,2017,2018,Massachusetts-Lowell,AEC,59,1219,150,364,110,220,40,144,54,98,39,90,129,77,48,16,66,100,394
8913,Gligorije Rakocevic,2016,2019,Oregon State,Pac-12,112,1470,152,299,143,274,9,25,81,135,118,171,289,19,21,21,84,216,394
8914,Ron Trapps,2014,2017,Total,Total,83,1028,136,372,57,122,79,250,43,59,38,106,144,51,33,3,58,71,394
8915,Tyler Troupe,2009,2010,Georgia Southern,Southern,62,1204,154,383,123,279,31,104,55,84,104,199,303,46,35,27,97,117,394
8916,Terrell Barnes,2010,2013,Tennessee Tech,OVC,119,2496,153,370,153,369,0,1,87,239,204,306,510,117,61,28,129,309,393
8917,Kenny Buckner,2012,2013,Boise State,MWC,58,1133,169,275,169,274,0,1,55,97,127,158,285,29,23,16,57,134,393
8918,Terrance Carter,2008,2008,James Madison,CAA,30,945,135,290,129,263,6,27,117,146,77,123,200,53,41,4,69,102,393
8919,Clint Chapman,2008,2012,Texas,Big 12,117,1313,152,333,152,324,0,9,89,139,117,202,319,20,25,76,61,197,393
8920,Zach Charles,2017,2018,Eastern Kentucky,OVC,61,1367,131,251,122,225,9,26,122,175,116,227,343,37,33,70,50,156,393
8921,Dante Curry,2008,2011,Total,Total,80,1072,126,366,32,92,94,274,47,73,20,68,88,50,40,3,57,94,393
8922,Michael Douglas,2016,2019,Florida International,CUSA,121,1645,135,387,69,164,66,223,57,99,64,164,228,34,45,15,46,165,393
8923,Brian Ezeh,2008,2008,Prairie View,SWAC,30,929,149,304,141,246,8,58,87,151,59,136,195,75,46,11,112,99,393
8924,Eric Jamison,2017,2019,Gardner-Webb,Big South,81,1250,160,295,146,248,14,47,59,83,58,211,269,40,32,11,74,114,393
8925,Matt Lopez,2012,2015,Total,Total,59,950,159,284,159,284,0,0,75,137,80,184,264,18,7,18,86,117,393
8926,Quincy Miller,2012,2012,Baylor,Big 12,37,903,138,309,114,240,24,69,93,114,54,128,182,53,25,24,66,69,393
8927,Ralph Mims,2008,2008,Florida State,ACC,34,1046,119,293,67,148,52,145,103,128,29,118,147,59,57,12,60,49,393
8928,Emmanuel Ndumanya,2015,2018,Santa Clara,WCC,111,2028,143,283,142,282,1,1,106,198,183,327,510,35,68,46,128,320,393
8929,Randy Phillips,2017,2018,Radford,Big South,68,1403,154,300,154,300,0,0,85,159,189,169,358,37,30,51,127,180,393
8930,Gary Roberson,2012,2013,Northwestern State,Southland,63,1143,151,332,117,232,34,100,57,94,79,122,201,44,35,11,76,135,393
8931,Donovan Sims,2018,2019,Middle Tennessee,CUSA,57,1208,141,323,78,153,63,170,48,63,14,139,153,127,57,5,85,70,393
8932,Dakota Slaughter,2013,2016,Total,Total,67,1099,139,308,73,129,66,179,49,65,36,115,151,70,20,18,53,103,393
8933,Fabian White Jr.,2018,2019,Houston,AAC,67,1165,154,307,154,306,0,1,85,123,116,147,263,48,29,51,73,185,393
8934,Madut Bol,2010,2013,Southern,SWAC,117,1453,135,316,108,242,27,74,95,137,74,147,221,16,27,50,65,154,392
8935,Kendrix Brown,2009,2012,William & Mary,CAA,116,2448,134,361,89,220,45,141,79,119,75,302,377,215,107,30,179,193,392
8936,Calen Coleman,2013,2014,Montana State,Big Sky,54,1126,135,328,59,123,76,205,46,65,39,100,139,45,39,6,55,85,392
8937,Volodymyr Gerun,2013,2015,Total,Total,71,1181,149,318,143,289,6,29,88,132,113,152,265,35,33,51,82,134,392
8938,J.R. Harris,2016,2017,Texas-San Antonio,CUSA,38,930,126,368,57,153,69,215,71,87,16,70,86,51,29,4,63,82,392
8939,Brian Hodges,2008,2008,Maryland-Baltimore County,AEC,28,813,125,317,62,149,63,168,79,101,34,58,92,45,21,4,37,55,392
8940,Quenton Kirby,2009,2010,Western Illinois,Summit,58,1352,144,369,135,332,9,37,95,145,46,168,214,91,27,5,130,103,392
8941,Ryan Majerle,2015,2016,Grand Canyon,WAC,66,1294,128,301,40,75,88,226,48,59,47,93,140,38,15,11,29,83,392
8942,John McArthur,2011,2014,Santa Clara,WCC,128,2059,157,400,151,371,6,29,72,96,126,231,357,49,38,36,75,270,392
8943,Chris Moore,2008,2008,Charleston Southern,Big South,29,880,134,291,53,101,81,190,43,55,10,82,92,85,30,6,38,53,392
8944,Jarvis Pugh,2015,2018,Santa Clara,WCC,91,1715,151,332,119,233,32,99,58,104,92,221,313,88,59,22,75,226,392
8945,DaShonte Riley,2010,2014,Total,Total,107,2336,154,331,154,327,0,4,84,148,178,360,538,76,81,207,172,285,392
8946,Jeremiah Rivers,2008,2011,Total,Total,97,2230,138,347,123,287,15,60,101,165,66,245,311,195,96,30,169,234,392
8947,Gerald Robinson,2008,2008,Tennessee-Martin,OVC,28,793,131,322,88,180,43,142,87,136,67,155,222,14,31,14,56,68,392
8948,Aakim Saintil,2016,2016,Long Island University,NEC,31,906,112,304,78,174,34,130,134,166,12,57,69,146,46,1,90,104,392
8949,Dane Smith,2011,2012,Tennessee-Martin,OVC,64,1456,150,319,148,308,2,11,90,139,125,163,288,73,61,16,98,128,392
8950,Kendarius Smith,2019,2019,North Alabama,A-Sun,32,1069,132,351,64,144,68,207,60,89,22,114,136,87,46,0,70,74,392
8951,Kerwin Smith,2015,2019,Total,Total,111,1630,164,287,164,287,0,0,64,159,127,225,352,25,20,45,110,224,392
8952,Vytas Sulskis,2011,2011,Youngstown State,Horizon,30,819,122,253,79,138,43,115,105,149,41,116,157,61,29,13,59,100,392
8953,Tyrese Williford,2019,2019,Southern Illinois-Edwardsville,OVC,30,867,114,310,85,200,29,110,135,175,20,86,106,110,23,4,104,63,392
8954,Talbott Denny,2013,2018,Total,Total,93,1736,119,287,103,241,16,46,137,243,121,205,326,66,55,9,91,265,391
8955,Tavian Dunn-Martin,2017,2019,Total,Total,68,1048,119,320,40,96,79,224,74,86,10,63,73,120,42,1,78,85,391
8956,Keawe Enos,2012,2014,Utah Valley,Total,85,1582,123,304,41,88,82,216,63,73,12,112,124,101,29,1,69,117,391
8957,Akeem Gooding,2008,2009,Saint Peter's,MAAC,58,1439,140,342,139,327,1,15,110,191,87,184,271,71,62,15,104,131,391
8958,Dontay Hampton,2010,2013,Chattanooga,Southern,94,1046,107,286,59,140,48,146,129,162,34,103,137,96,61,1,74,111,391
8959,Ta'Jay Henry,2016,2017,Mississippi Valley State,SWAC,55,1300,153,296,153,294,0,2,85,143,130,171,301,38,39,13,75,160,391
8960,Dale Jones,2016,2018,Total,Total,41,876,133,314,55,106,78,208,47,57,22,195,217,35,19,13,55,114,391
8961,Scott Morris,2011,2014,New Hampshire,AEC,109,1403,135,386,24,73,111,313,10,14,5,67,72,43,35,6,53,126,391
8962,Iggy Nujic,2011,2014,Total,Total,72,1222,133,331,96,215,37,116,88,120,50,140,190,50,29,14,84,142,391
8963,Amadou Sow,2019,2019,UC-Santa Barbara,Big West,32,759,150,266,149,261,1,5,90,127,77,133,210,13,17,24,62,100,391
8964,Nick Thompson,2011,2013,Total,Total,49,1317,154,329,132,269,22,60,61,91,63,245,308,156,40,4,131,80,391
8965,Michael Tuck,2008,2008,Loyola (MD),MAAC,33,957,154,303,126,218,28,85,55,77,74,163,237,38,20,13,64,114,391
8966,Troy Whiteside,2016,2019,Cornell,Ivy,83,1512,158,362,120,242,38,120,37,63,47,129,176,78,50,8,82,166,391
8967,Aaron Anderson,2013,2017,Total,Total,83,1847,124,274,91,184,33,90,109,145,73,203,276,198,54,5,136,183,390
8968,Parfait Bitee,2008,2008,Rhode Island,A-10,33,979,128,258,63,131,65,127,69,87,13,68,81,156,26,6,81,67,390
8969,Zach Collins,2017,2017,Gonzaga,WCC,39,673,135,207,125,186,10,21,110,148,66,164,230,16,18,69,60,105,390
8970,Milik Gantz,2018,2019,North Carolina A&T,MEAC,62,1059,156,305,139,243,17,62,61,93,31,128,159,71,52,13,80,99,390
8971,Marcelis Hansberry,2011,2013,Louisiana-Monroe,Sun Belt,71,1387,142,353,116,246,26,107,80,124,24,113,137,110,46,2,94,91,390
8972,Hayden Howell,2016,2018,Abilene Christian,Southland,92,1131,150,315,145,299,5,16,85,140,95,124,219,33,17,29,106,193,390
8973,Charles Jackson,2015,2015,Tennessee Tech,OVC,30,816,157,275,157,275,0,0,76,133,111,175,286,14,33,40,47,100,390
8974,Ridley Johnson,2008,2009,Toledo,MAC,55,1367,138,378,78,172,60,206,54,75,52,111,163,48,41,5,80,73,390
8975,Zane Knowles,2011,2014,Total,Total,73,1307,168,302,168,301,0,1,54,115,125,257,382,21,16,56,80,190,390
8976,Jaizec Lottie,2018,2019,Little Rock,Sun Belt,55,1509,142,358,107,234,35,124,71,138,21,142,163,182,61,3,127,123,390
8977,Jamie Orme,2018,2019,Portland State,Big Sky,63,1034,142,329,106,217,36,112,70,115,95,138,233,39,60,34,52,176,390
8978,Derrick Rodgers,2011,2013,Portland,WCC,94,1732,139,331,133,309,6,22,106,153,39,130,169,192,46,8,161,128,390
8979,Aaron Rountree,2013,2016,Total,Total,120,1885,151,322,143,291,8,31,80,139,97,238,335,150,95,120,99,211,390
8980,Drew Shiller,2008,2010,Stanford,Pac-10,84,1445,119,304,27,72,92,232,60,67,20,112,132,130,32,4,71,117,390
8981,Mario Sisinni,2008,2009,Coastal Carolina,Big South,50,1490,125,338,56,142,69,196,71,89,11,109,120,156,34,0,95,105,390
8982,Jonathan Sloan,2008,2011,Texas State,Southland,94,924,138,309,138,307,0,2,114,180,84,136,220,26,26,25,72,147,390
8983,Kadeem Smithen,2015,2019,Total,Total,118,1740,114,274,75,164,39,110,123,154,62,170,232,108,70,25,71,181,390
8984,Milos Supica,2018,2019,Charlotte,CUSA,57,1219,155,303,155,302,0,1,80,134,94,178,272,38,26,26,98,129,390
8985,Phillip Williams,2009,2013,Jackson State,SWAC,123,1904,145,405,120,291,25,114,75,119,62,140,202,95,72,1,130,186,390
8986,Lincoln Davis,2014,2017,Total,Total,76,1187,120,312,78,186,42,126,107,164,24,112,136,84,40,14,76,109,389
8987,Ronald Douglas,2008,2009,South Alabama,Sun Belt,63,1385,148,278,148,278,0,0,93,202,138,137,275,50,21,97,76,156,389
8988,Kelton Ford,2014,2016,Troy,Sun Belt,82,1365,116,334,80,182,36,152,121,203,15,109,124,119,83,6,103,138,389
8989,Tyler Harris,2019,2019,Memphis,AAC,36,919,129,350,50,99,79,251,52,62,13,52,65,68,23,0,62,72,389
8990,Chris Johnson,2010,2012,Saint Francis (PA),NEC,68,1762,130,304,99,229,31,75,98,144,22,122,144,265,92,4,162,170,389
8991,Sandro Mamukelashvili,2018,2019,Seton Hall,Big East,68,1319,139,313,103,193,36,120,75,123,103,225,328,70,27,58,64,139,389
8992,Dewayne Pettus,2008,2008,Bethune-Cookman,MEAC,31,1053,137,308,126,266,11,42,104,140,37,90,127,54,44,13,72,69,389
8993,Devin Searcy,2008,2011,Dayton,A-10,130,1604,155,304,155,304,0,0,79,122,156,197,353,39,34,32,87,176,389
8994,Marko Spica,2008,2010,Central Michigan,MAC,56,850,131,269,131,268,0,1,127,182,75,97,172,21,21,17,120,154,389
8995,Ben Allison,2009,2011,Davidson,Southern,94,1285,126,299,120,266,6,33,130,224,94,177,271,46,28,23,117,219,388
8996,Jaylen Benton,2017,2018,Total,Total,62,1082,140,348,82,177,58,171,50,70,32,84,116,141,64,7,85,139,388
8997,Tevin Brown,2019,2019,Murray State,OVC,33,1081,130,314,40,72,90,242,38,47,19,135,154,75,36,19,37,71,388
8998,Tyler Davis,2013,2016,Alabama A&M,SWAC,108,1861,128,358,54,121,74,237,58,89,41,79,120,86,63,1,97,135,388
8999,Johnathan Edwards,2011,2012,Radford,Big South,51,1176,147,323,147,319,0,4,94,185,99,168,267,26,34,23,77,119,388
9000,Cliff Hammonds,2008,2008,Clemson,ACC,34,1162,150,321,90,161,60,160,28,61,43,98,141,133,66,7,60,56,388
9001,Olajide Hay,2008,2009,Tennessee-Martin,OVC,58,1431,143,221,143,221,0,0,102,156,118,156,274,36,35,28,50,172,388
9002,Ty Hudson,2016,2019,Total,Total,74,1149,130,340,76,176,54,164,74,93,6,96,102,106,37,4,88,100,388
9003,Antonio Jenifer,2015,2016,St. Francis (NY),NEC,64,1108,132,343,88,197,44,146,80,121,93,195,288,41,25,34,70,130,388
9004,Jon Killen,2008,2008,Southern Methodist,CUSA,30,1058,133,308,58,122,75,186,47,73,15,90,105,154,44,3,96,73,388
9005,Trantell Knight,2013,2014,Middle Tennessee,Total,67,1483,136,279,123,228,13,51,103,183,42,156,198,238,109,6,138,139,388
9006,Drew Lavender,2008,2008,Xavier,A-10,36,1110,125,295,66,150,59,145,79,91,11,85,96,162,37,2,61,52,388
9007,A.J. Lawson,2019,2019,South Carolina,SEC,29,868,130,316,82,182,48,134,80,120,27,98,125,83,32,7,74,59,388
9008,D.J. MacLeay,2014,2017,Bucknell,Patriot,110,1150,149,291,139,257,10,34,80,126,129,216,345,48,48,28,92,197,388
9009,Ricky McPhee,2009,2010,Georgia,SEC,56,1270,129,309,39,71,90,238,40,54,26,100,126,73,50,2,76,76,388
9010,Zach Mills,2014,2015,Sacramento State,Big Sky,63,1301,146,325,89,193,57,132,39,50,53,157,210,39,28,3,43,109,388
9011,Daeqwon Plowden,2018,2019,Bowling Green State,MAC,66,1219,153,344,118,237,35,107,47,88,98,159,257,28,35,45,58,144,388
9012,Logan Primerano,2016,2017,Massachusetts-Lowell,AEC,59,1142,132,292,104,213,28,79,96,121,33,126,159,89,37,14,88,110,388
9013,Brandon Smith,2010,2013,University of California,Total,117,2116,126,344,92,243,34,101,102,168,45,121,166,267,68,0,175,176,388
9014,Curtis Terry,2008,2008,Nevada-Las Vegas,MWC,35,1094,125,301,57,118,68,183,70,95,10,104,114,169,38,7,88,55,388
9015,Brandon Webb,2010,2011,Prairie View,SWAC,57,893,156,284,156,284,0,0,76,169,94,121,215,29,23,63,96,115,388
9016,Clive Weeden,2008,2011,Dartmouth,Ivy,109,1862,149,358,148,354,1,4,89,164,180,202,382,66,39,68,102,296,388
9017,Joe Wieskamp,2019,2019,Iowa,Big Ten,35,971,125,256,66,117,59,139,79,103,48,124,172,39,31,16,38,65,388
9018,Brandon Adams,2008,2010,Manhattan,MAAC,83,1394,125,288,124,286,1,2,136,196,143,161,304,36,61,61,73,224,387
9019,Ismail Ali,2016,2017,Bowling Green State,MAC,64,1429,121,306,108,258,13,48,132,195,21,112,133,247,67,18,138,159,387
9020,Mohamed Bamba,2018,2018,Texas,Big 12,30,906,146,270,132,219,14,51,81,119,96,220,316,15,23,111,46,76,387
9021,Rogers Barnes,2008,2009,Morgan State,MEAC,57,1403,144,350,101,208,43,142,56,89,33,93,126,87,71,6,77,122,387
9022,Stacy Beckton,2018,2019,American,Patriot,50,1191,135,313,91,169,44,144,73,100,41,133,174,47,50,47,74,123,387
9023,Kadeem Coleby,2012,2014,Total,Total,67,1219,149,282,149,282,0,0,89,178,78,173,251,31,15,118,92,159,387
9024,Moses Ehambe,2008,2008,Oral Roberts,Summit,33,880,132,326,46,114,86,212,37,43,13,62,75,43,13,2,33,34,387
9025,Andre Jones,2017,2018,Little Rock,Sun Belt,53,990,155,388,133,279,22,109,55,87,42,111,153,70,23,8,82,64,387
9026,Pierfrancesco Oliva,2016,2019,Saint Joseph's,A-10,77,1645,135,310,99,188,36,122,81,161,81,325,406,173,56,44,107,167,387
9027,Shaq Shannon,2013,2014,Quinnipiac,Total,61,1469,119,321,61,164,58,157,91,139,55,165,220,145,29,9,96,117,387
9028,Yaniv Simpson,2008,2010,Monmouth,NEC,50,909,134,332,35,87,99,245,20,23,14,73,87,38,19,4,63,100,387
9029,James Vincent,2010,2013,Georgia State,CAA,117,1536,156,304,156,304,0,0,75,130,138,221,359,19,31,132,93,201,387
9030,Jordan Whitehead,2016,2019,High Point,Big South,81,1553,153,296,150,278,3,18,78,126,119,211,330,78,42,18,63,154,387
9031,Cammeron Woodyard,2009,2012,Penn State,Big Ten,104,1384,129,384,60,168,69,216,60,76,68,125,193,33,33,8,51,72,387
9032,Karon Wright,2014,2015,South Carolina State,MEAC,63,918,128,404,34,107,94,297,37,52,26,35,61,30,19,0,62,109,387
9033,Adrian Banks,2008,2008,Arkansas State,Sun Belt,21,633,126,265,75,150,51,115,83,101,16,55,71,27,26,1,51,28,386
9034,Kavell Bigby-Williams,2017,2019,Total,Total,72,1104,146,257,146,257,0,0,94,158,136,202,338,23,14,95,51,156,386
9035,Jordan Burris,2011,2013,Nevada,Total,95,1460,132,349,94,199,38,150,84,117,46,177,223,91,40,36,88,136,386
9036,Mark Cornelius,2014,2016,Massachusetts-Lowell,AEC,82,1468,143,319,106,213,37,106,63,99,74,165,239,116,58,7,101,143,386
9037,Walter Foster,2014,2016,Towson,CAA,95,1832,152,353,152,352,0,1,82,148,180,240,420,42,27,101,89,216,386
9038,Laron Frazier,2008,2009,Ball State,MAC,58,1401,147,383,111,257,36,126,56,80,34,92,126,98,44,0,53,60,386
9039,Cecil Gresham,2011,2011,Bryant,NEC,27,814,134,292,64,128,70,164,48,61,44,75,119,25,16,13,35,79,386
9040,Justin Hopkins,2017,2019,Total,Total,68,1156,128,269,117,230,11,39,119,166,85,138,223,40,20,6,69,98,386
9041,DJ Miles,2017,2017,Northern Colorado,Big Sky,29,792,120,300,44,109,76,191,70,90,10,61,71,35,13,1,53,64,386
9042,Dalique Mingo,2015,2018,Howard,MEAC,91,1503,125,326,108,242,17,84,119,157,68,142,210,85,49,4,101,152,386
9043,Greg Robbins,2010,2013,Richmond,A-10,105,1693,151,328,103,185,48,143,36,71,36,189,225,130,65,36,85,162,386
9044,Jalen Smith,2019,2019,Maryland,Big Ten,33,880,145,295,126,224,19,71,77,117,90,135,225,29,14,39,41,65,386
9045,Terrance Birdette,2008,2011,Elon,Southern,88,1518,133,325,85,185,48,140,71,109,61,118,179,92,43,2,119,180,385
9046,C.J. Carr,2015,2016,Southern Illinois-Edwardsville,OVC,56,1228,130,370,83,214,47,156,78,98,27,99,126,149,50,2,103,87,385
9047,Eitan Chemerinski,2010,2013,Cornell,Ivy,84,1231,153,248,153,248,0,0,79,121,103,106,209,40,50,27,94,176,385
9048,Quade Green,2018,2019,Kentucky,SEC,43,1029,137,305,85,170,52,135,59,71,16,57,73,112,20,0,76,62,385
9049,Mark Hill,2008,2010,Total,Total,50,1177,114,321,61,162,53,159,104,147,20,70,90,120,64,3,105,132,385
9050,Enoch Hood,2012,2016,Total,Total,115,1485,160,320,160,319,0,1,65,122,107,196,303,25,28,37,70,234,385
9051,Derrick Jasper,2008,2011,Total,Total,73,1808,146,328,113,226,33,102,60,121,54,292,346,166,63,35,106,162,385
9052,Trumaine Johnson,2008,2011,Total,Total,59,1532,146,354,113,250,33,104,60,97,19,72,91,154,57,5,139,106,385
9053,Emarius Logan,2016,2017,Appalachian State,Sun Belt,60,1316,119,344,64,178,55,166,92,112,29,77,106,110,25,5,113,86,385
9054,B.J. Maxwell,2017,2019,Abilene Christian,Southland,72,1129,145,300,89,161,56,139,39,51,77,137,214,70,39,23,47,146,385
9055,Michael Ramey,2013,2017,Total,Total,70,1279,137,367,52,128,85,239,26,40,10,80,90,33,14,1,39,102,385
9056,Jeremy Saffore,2008,2011,Chattanooga,Southern,113,1407,160,289,160,288,0,1,65,124,98,167,265,28,24,55,88,173,385
9057,Matt Sundberg,2009,2013,College of Charleston,Southern,112,1349,127,352,43,102,84,250,47,69,60,180,240,31,36,15,48,135,385
9058,Bryce Taylor,2008,2008,Oregon,Pac-10,30,993,135,293,85,162,50,131,65,79,33,80,113,43,21,13,48,76,385
9059,Dom Uhl,2015,2018,Iowa,Big Ten,114,1463,131,344,89,213,42,131,81,135,94,206,300,85,29,32,87,102,385
9060,A.J. Avery,2013,2016,Western Michigan,MAC,111,1475,137,300,133,290,4,10,106,161,141,206,347,34,33,58,72,215,384
9061,Tanksley Efianayi,2016,2017,Central Florida,AAC,62,1223,124,330,87,200,37,130,99,136,43,120,163,59,30,7,74,79,384
9062,Riley Luettgerodt,2008,2008,Hawaii,WAC,30,1055,142,324,129,275,13,49,87,107,58,89,147,84,29,1,55,51,384
9063,Trey McGowens,2019,2019,Pittsburgh,ACC,33,917,113,271,81,173,32,98,126,165,20,85,105,55,64,3,79,93,384
9064,Devin White,2008,2009,Northwestern State,Southland,51,790,156,293,153,274,3,19,69,108,69,142,211,34,42,74,90,152,384
9065,Malik Williams,2018,2019,Louisville,ACC,66,958,132,315,84,165,48,150,72,103,86,199,285,14,21,53,42,114,384
9066,Mike Wilson,2008,2009,Chicago State,Ind,59,1373,129,364,58,139,71,225,55,90,38,131,169,169,57,2,122,120,384
9067,Kendall Chones,2008,2008,Colgate,Patriot,32,908,151,270,149,263,2,7,79,110,70,105,175,39,20,10,54,73,383
9068,Eric Diaz,2008,2009,Stetson,A-Sun,57,1120,143,357,100,216,43,141,54,91,88,123,211,12,46,25,64,160,383
9069,Travis Fuller,2016,2019,Brown,Ivy,91,1075,141,285,135,253,6,32,95,163,105,213,318,63,21,22,95,155,383
9070,Jonathan Isaac,2017,2017,Florida State,ACC,32,839,130,256,99,167,31,89,92,118,56,195,251,37,37,49,48,70,383
9071,Nate Johnson,2017,2019,Gardner-Webb,Big South,48,1218,135,309,67,115,68,194,45,62,15,142,157,75,59,22,49,87,383
9072,Chris Mullins,2019,2019,Rice,CUSA,32,922,123,314,94,219,29,95,108,150,25,66,91,85,38,3,76,68,383
9073,Mike Nelson,2009,2009,North Dakota State,Summit,33,1035,144,299,86,152,58,147,37,58,27,112,139,82,25,6,42,60,383
9074,Willy Nunez Jr.,2018,2019,Florida International,CUSA,40,844,123,342,29,64,94,278,43,62,15,76,91,32,20,3,31,51,383
9075,Tyler Olander,2011,2014,Connecticut,Total,135,1876,154,353,151,336,3,17,72,105,123,227,350,91,35,53,79,226,383
9076,Al Rapier,2011,2012,Stony Brook,AEC,63,1327,156,301,156,295,0,6,71,125,97,193,290,70,32,8,104,123,383
9077,Ardarius Simmons,2011,2012,Chicago State,GWC,60,1441,143,375,103,272,40,103,57,77,13,78,91,133,52,0,104,131,383
9078,Deshawn Stephens,2012,2013,San Diego State,MWC,68,1374,162,270,162,270,0,0,59,130,145,194,339,19,33,27,57,141,383
9079,Jay Watkins,2008,2011,Total,Total,42,1001,130,267,126,252,4,15,119,177,61,108,169,37,16,2,51,89,383
9080,Larry Williams,2008,2008,Arkansas-Pine Bluff,SWAC,31,1000,138,340,91,187,47,153,60,85,25,74,99,67,25,1,56,65,383
9081,Riley Benock,2008,2011,Mississippi State,SEC,131,2048,124,306,22,47,102,259,32,45,29,161,190,142,73,16,87,141,382
9082,Williams Byrd,2008,2008,Arkansas-Pine Bluff,SWAC,31,985,150,322,130,261,20,61,62,98,48,164,212,43,35,74,74,60,382
9083,Elijah Cunningham-Muhammad,2010,2010,Tennessee Tech,OVC,32,1027,125,297,81,190,44,107,88,105,22,106,128,143,44,1,100,64,382
9084,Jaren Jackson Jr.,2018,2018,Michigan State,Big Ten,35,764,119,232,81,136,38,96,106,133,52,151,203,39,21,106,62,112,382
9085,Marcio Lassiter,2008,2009,Cal State Fullerton,Big West,63,1124,128,322,67,130,61,192,65,74,50,78,128,74,38,6,65,113,382
9086,Desmond Lee,2014,2015,North Carolina State,ACC,64,1089,111,290,89,204,22,86,138,185,36,98,134,70,35,1,77,96,382
9087,Tanner Morgan,2016,2018,Northern Colorado,Big Sky,70,1513,149,342,143,317,6,25,78,121,98,257,355,46,27,33,82,193,382
9088,Jeff Mullahey,2013,2014,Troy,Sun Belt,63,1418,116,335,49,138,67,197,83,108,70,116,186,72,57,6,50,130,382
9089,Derrico Peck,2013,2017,Total,Total,114,1686,168,266,167,259,1,7,45,109,118,169,287,68,66,77,91,223,382
9090,Kelvin Penn,2012,2015,Florida Atlantic,Total,120,2804,168,309,168,309,0,0,46,109,262,327,589,57,78,223,115,358,382
9091,Marcus Schroeder,2008,2010,Princeton,Ivy,81,2331,130,347,76,181,54,166,68,86,34,202,236,208,105,6,107,123,382
9092,Ilija Stojiljkovic,2016,2019,Maine,AEC,109,1921,145,348,107,210,38,138,54,102,102,303,405,132,67,28,151,257,382
9093,David Appolon,2012,2015,Robert Morris,NEC,99,1552,130,322,110,237,20,85,101,142,98,153,251,91,71,2,88,178,381
9094,Devin Booker,2015,2015,Kentucky,SEC,38,816,135,287,77,146,58,141,53,64,17,59,76,42,17,2,37,58,381
9095,Brian Holmes,2013,2014,Georgia Southern,Southern,56,1413,123,313,65,151,58,162,77,106,20,109,129,117,47,5,82,95,381
9096,Justin Mazzulla,2018,2019,George Washington,A-10,66,1671,144,352,117,256,27,96,66,112,61,159,220,184,51,9,128,141,381
9097,Daon Merritt,2008,2008,South Alabama,Sun Belt,33,1075,116,263,80,149,36,114,113,159,16,74,90,182,27,1,93,70,381
9098,Malik Metoyer,2016,2019,Northwestern State,Southland,93,1463,130,296,106,198,24,98,97,135,95,189,284,81,43,32,114,156,381
9099,Bambale Osby,2008,2008,Maryland,ACC,33,881,134,257,134,256,0,1,113,170,76,138,214,27,19,69,91,96,381
9100,Develle Phillips,2016,2019,Total,Total,68,1099,156,266,156,265,0,1,69,149,108,174,282,48,15,53,81,186,381
9101,Kelvin Robinson,2017,2019,Total,Total,49,1073,138,336,115,255,23,81,82,128,58,126,184,145,50,3,87,122,381
9102,Todd Sowell,2008,2008,Saint Peter's,MAAC,30,913,148,309,148,308,0,1,85,144,134,178,312,35,30,67,75,98,381
9103,Morris Woods,2012,2013,Eastern Illinois,OVC,53,912,143,277,140,260,3,17,92,160,65,91,156,50,30,12,93,110,381
9104,Kevin Aronis,2013,2014,New Mexico State,WAC,71,1039,125,305,14,32,111,273,19,30,9,73,82,23,18,10,26,71,380
9105,Cameron Bowles,2018,2019,Chicago State,WAC,57,1450,139,334,133,290,6,44,96,138,47,150,197,46,34,43,105,167,380
9106,Ben Clifford,2012,2014,Utah State,Total,87,1425,125,264,103,199,22,65,108,136,112,167,279,49,27,45,69,201,380
9107,Jacara Cross,2017,2019,Jacksonville State,OVC,93,941,152,270,151,265,1,5,75,111,84,122,206,28,23,60,99,199,380
9108,Trevon Duval,2018,2018,Duke,ACC,37,1103,148,346,117,239,31,107,53,89,20,53,73,207,54,5,102,89,380
9109,Justin Edmonds,2015,2016,Marshall,CUSA,58,949,123,330,50,117,73,213,61,108,24,82,106,63,31,3,80,78,380
9110,Nikola Gajic,2013,2014,Stephen F. Austin,Southland,53,955,133,278,86,152,47,126,67,96,78,133,211,71,58,19,60,111,380
9111,John Hall,2018,2019,Evansville,MVC,64,1365,148,348,107,230,41,118,43,73,53,244,297,45,31,24,80,112,380
9112,Ryan Kriener,2017,2019,Iowa,Big Ten,90,1002,157,288,145,246,12,42,54,90,65,152,217,62,34,28,73,148,380
9113,Josh Lepley,2009,2011,Northern Arizona,Big Sky,86,1039,140,249,140,249,0,0,100,172,78,167,245,30,19,47,96,179,380
9114,Andre Marhold,2010,2013,Duquesne,A-10,96,1568,157,309,157,308,0,1,66,159,118,191,309,27,25,107,86,184,380
9115,Evan Maxwell,2015,2016,Liberty,Big South,61,863,151,241,151,241,0,0,78,125,69,116,185,17,11,11,85,95,380
9116,Mac McClung,2019,2019,Georgetown,Big East,29,767,127,324,88,183,39,141,87,109,22,54,76,58,24,4,59,51,380
9117,Tradarrius McPhearson,2013,2014,New Orleans,Total,49,1222,126,316,87,196,39,120,89,138,29,99,128,76,49,7,94,101,380
9118,William Nelson,2013,2013,Texas A&M-Corpus Christi,Southland,28,827,131,349,95,219,36,130,82,121,67,144,211,27,18,4,80,81,380
9119,JaColby Pemberton,2018,2019,Louisiana Tech,CUSA,60,1165,125,270,92,166,33,104,97,145,67,161,228,59,26,11,72,110,380
9120,Michael Sanchez,2009,2012,Arkansas,SEC,83,1574,123,295,122,292,1,3,133,209,104,195,299,44,47,22,108,198,380
9121,Emanual Shepherd,2017,2018,Southern,SWAC,65,1330,158,303,156,299,2,4,62,118,102,178,280,57,35,48,68,147,380
9122,Bubba Walther,2008,2008,Ohio,MAC,31,920,118,293,36,68,82,225,62,71,9,52,61,116,46,2,61,47,380
9123,O'Showen Williams,2018,2019,Appalachian State,Sun Belt,65,1500,123,315,58,128,65,187,69,100,33,99,132,134,58,9,78,106,380
9124,Kalif Young,2017,2019,Providence,Big East,101,1538,156,305,154,298,2,7,66,144,146,235,381,56,42,63,78,190,380
9125,Albert Abrahams,2010,2011,Bethune-Cookman,MEAC,59,914,157,304,157,304,0,0,65,114,87,152,239,26,19,27,64,122,379
9126,God'sgift Achiuwa,2012,2014,St. John's (NY),Big East,64,1246,138,255,137,248,1,7,102,167,119,135,254,10,19,52,67,100,379
9127,Riley Barker,2011,2015,Portland,WCC,112,1593,145,311,142,301,3,10,86,135,139,222,361,38,42,91,79,208,379
9128,Travis Brown,2008,2009,Northern Iowa,MVC,65,1403,126,319,65,150,61,169,66,88,39,100,139,47,18,3,64,157,379
9129,Jay Jay Chandler,2018,2019,Texas A&M,SEC,64,1112,133,316,104,211,29,105,84,118,36,100,136,65,49,7,69,127,379
9130,Marcus Garrett,2018,2019,Kansas,Big 12,69,1584,143,328,119,234,24,94,69,126,66,190,256,101,78,18,68,116,379
9131,Rasheem Jenkins,2010,2011,Florida A&M,MEAC,57,1397,118,344,50,129,68,215,75,107,9,80,89,144,45,1,136,117,379
9132,Aaron Jones,2012,2015,Mississippi,SEC,105,1777,156,335,153,315,3,20,64,91,189,223,412,37,60,139,56,193,379
9133,Darren Kent,2008,2009,Kansas State,Big 12,64,1183,132,325,113,258,19,67,96,132,115,151,266,80,28,28,99,163,379
9134,Gabriel Moore,2008,2008,Indiana State,MVC,31,1043,113,249,78,166,35,83,118,141,20,83,103,141,65,3,88,73,379
9135,Sarju Patel,2018,2019,Virginia Military Institute,Southern,59,1122,129,321,65,141,64,180,57,83,28,112,140,51,29,1,46,66,379
9136,Fred Peete,2008,2008,New Mexico State,WAC,35,1088,130,282,86,164,44,118,75,109,37,127,164,145,51,7,74,82,379
9137,Duran Porter,2015,2016,Abilene Christian,Southland,62,1035,155,280,155,280,0,0,69,115,67,120,187,28,15,40,73,160,379
9138,Remy Roberts-Burnett,2012,2015,Western Illinois,Summit,82,1660,173,400,166,374,7,26,26,54,13,112,125,105,36,11,70,66,379
9139,Jeremie Simmons,2009,2010,Ohio State,Big Ten,66,1144,122,304,47,102,75,202,60,81,11,59,70,108,33,4,59,86,379
9140,Wayde Sims,2017,2018,Louisiana State,SEC,63,1145,150,295,127,225,23,70,56,80,72,139,211,29,37,35,54,113,379
9141,Eric Stafford,2015,2018,Lafayette,Patriot,101,1793,122,321,78,187,44,134,91,122,39,168,207,178,51,19,130,187,379
9142,Trevor Stumpe,2016,2019,Wofford,Southern,56,993,129,285,74,146,55,139,66,77,45,97,142,79,31,5,48,113,379
9143,Trey Wertz,2019,2019,Santa Clara,WCC,31,1009,134,302,95,179,39,123,72,96,11,80,91,146,28,3,118,93,379
9144,Antonio Williams,2019,2019,Kent State,MAC,33,1049,139,290,122,245,17,45,84,115,36,96,132,86,58,33,51,98,379
9145,Zafir Williams,2018,2019,Loyola Marymount,WCC,65,1117,156,330,138,268,18,62,49,67,81,131,212,52,28,18,53,143,379
9146,Rasheed Worrell,2016,2017,Bowling Green State,MAC,65,1163,149,312,144,296,5,16,76,133,103,170,273,27,21,49,51,179,379
9147,Francisco Amiel,2016,2019,Colgate,Patriot,130,2542,122,377,53,137,69,240,65,89,41,175,216,219,113,11,143,181,378
9148,Terrance Banyard,2018,2019,Arkansas-Pine Bluff,SWAC,61,1098,128,253,123,228,5,25,117,178,75,161,236,28,30,56,65,143,378
9149,Marcus Brister,2011,2012,Southeast Missouri State,OVC,60,1527,146,320,146,316,0,4,86,195,53,183,236,198,48,3,172,112,378
9150,Montana Byrd,2015,2018,Chicago State,WAC,103,1395,129,386,45,128,84,258,36,48,38,130,168,38,38,14,74,186,378
9151,Manroop Clair,2013,2017,Total,Total,75,1118,118,340,22,59,96,281,46,61,12,79,91,55,23,0,68,71,378
9152,Bill Cole,2008,2011,Illinois,Big Ten,99,1627,135,296,65,106,70,190,38,62,80,152,232,85,48,47,45,159,378
9153,Jordan Coleman,2011,2014,Total,Total,62,1087,118,283,94,192,24,91,118,161,59,126,185,45,30,24,62,104,378
9154,Kenny Cooper,2009,2010,Total,Total,50,1170,127,294,127,291,0,3,124,215,93,148,241,31,16,20,67,96,378
9155,De'Andre Davis,2015,2016,Grand Canyon,WAC,63,1077,131,268,125,230,6,38,110,164,51,84,135,119,47,9,87,121,378
9156,Thomas Jacobs,2011,2015,Total,Total,99,1493,142,289,138,271,4,18,90,128,137,216,353,35,58,20,64,180,378
9157,Justin Johnson,2008,2008,Iowa,Big Ten,32,1142,128,356,35,87,93,269,29,39,31,126,157,68,19,17,62,55,378
9158,Rashard McGill,2010,2013,Total,Total,96,1658,130,348,99,251,31,97,87,131,98,187,285,51,52,18,88,177,378
9159,Hudson Price,2014,2018,Total,Total,90,1497,123,296,62,131,61,165,71,96,37,153,190,58,38,19,71,159,378
9160,Khailil Richard,2017,2018,Siena,MAAC,59,1061,141,314,98,215,43,99,53,65,27,82,109,64,19,3,75,85,378
9161,Elijah Schmidt,2017,2019,Texas A&M-Corpus Christi,Southland,92,1661,155,292,152,272,3,20,65,119,121,258,379,56,39,38,90,213,378
9162,Michael Starks,2010,2013,Alcorn State,SWAC,114,1904,145,302,145,302,0,0,88,169,152,245,397,19,31,102,86,332,378
9163,Isaac Taylor,2016,2019,Maryland-Eastern Shore,MEAC,86,1122,147,301,147,299,0,2,84,122,90,108,198,39,11,26,90,189,378
9164,Malik Thames,2016,2017,UC-Riverside,Big West,53,1437,120,328,67,177,53,151,85,109,17,134,151,131,49,8,69,85,378
9165,Jeron Trotman,2010,2013,Total,Total,93,1247,146,279,145,266,1,13,85,184,100,195,295,33,25,58,83,165,378
9166,Cullen VanLeer,2016,2018,Missouri,SEC,94,1734,130,372,37,66,93,306,25,39,15,121,136,96,46,9,61,131,378
9167,Gelaun Wheelwright,2012,2013,Weber State,Big Sky,63,1287,134,321,80,155,54,166,56,71,13,124,137,88,26,8,98,89,378
9168,Anthony Williams,2008,2008,Grambling,SWAC,26,719,129,298,106,232,23,66,97,140,66,162,228,53,22,16,83,83,378
9169,Quevyn Winters,2013,2015,Total,Total,57,958,139,351,67,137,72,214,28,37,40,112,152,45,27,5,83,91,378
9170,Jonathan Adams,2008,2009,Old Dominion,CAA,68,1452,138,346,95,205,43,141,58,74,72,196,268,121,28,29,61,73,377
9171,Colby Bargeman,2008,2008,Northwestern State,Southland,33,915,143,365,106,239,37,126,54,76,65,129,194,66,61,18,36,66,377
9172,Presano Bell,2011,2012,South Carolina State,MEAC,57,1220,137,288,137,285,0,3,103,197,88,152,240,26,35,64,68,114,377
9173,Quintin Brewer,2015,2016,Total,Total,62,1388,144,298,137,278,7,20,82,115,123,223,346,30,32,51,93,176,377
9174,Montez Downey,2008,2010,North Carolina-Wilmington,CAA,72,920,123,325,56,119,67,206,64,82,49,114,163,20,23,2,58,104,377
9175,Adam Fletcher,2008,2010,Miami (OH),MAC,87,1748,153,310,153,309,0,1,71,127,106,181,287,50,30,34,110,208,377
9176,Zach Garber,2014,2017,Toledo,MAC,114,1590,107,219,106,212,1,7,162,231,141,228,369,41,23,26,71,234,377
9177,Reginald Gardner,2018,2018,North Carolina Central,MEAC,35,1027,122,357,46,123,76,234,57,75,17,45,62,57,13,6,38,60,377
9178,Tyrell Green,2016,2017,Nevada-Las Vegas,MWC,38,834,126,320,77,174,49,146,76,95,47,131,178,36,20,4,40,66,377
9179,Jermaine Haley,2017,2019,Total,Total,67,1561,135,288,111,192,24,96,83,133,64,170,234,133,51,9,116,137,377
9180,Xavier Hansbro,2009,2010,Georgia State,CAA,60,1110,163,409,148,333,15,76,36,61,54,153,207,29,27,29,72,103,377
9181,Ousman Krubally,2008,2010,Georgia State,CAA,83,1315,141,253,141,253,0,0,95,168,164,168,332,29,43,30,86,217,377
9182,De'Quon Lake,2018,2019,Arizona State,Pac-12,65,977,150,205,150,205,0,0,77,118,111,177,288,7,18,69,38,178,377
9183,Marc Larson,2008,2010,Bowling Green State,MAC,78,1589,133,285,133,285,0,0,111,148,122,147,269,37,16,72,92,201,377
9184,Drew Lundberg,2008,2012,Total,Total,84,1258,128,303,84,180,44,123,77,109,8,91,99,93,23,0,58,72,377
9185,Prince Obasi,2012,2013,Seattle,Total,57,1440,131,327,97,219,34,108,81,123,49,152,201,203,62,8,118,112,377
9186,Daniel Oturu,2019,2019,Minnesota,Big Ten,35,834,152,276,151,274,1,2,72,117,88,158,246,19,16,46,53,95,377
9187,Jordan Roberts,2018,2019,Long Beach State,Big West,65,1250,151,333,150,327,1,6,74,137,83,138,221,68,45,17,84,125,377
9188,Lyrik Shreiner,2016,2019,Total,Total,86,1452,134,316,111,225,23,91,86,113,53,160,213,115,33,10,119,129,377
9189,Dante Sterling,2018,2018,Alcorn State,SWAC,32,867,116,299,58,138,58,161,87,107,21,84,105,48,31,4,67,46,377
9190,Aaron Adeoye,2012,2015,Total,Total,92,1610,145,329,139,304,6,25,80,127,140,248,388,46,39,46,113,215,376
9191,Luka Brajkovic,2019,2019,Davidson,A-10,34,846,157,286,152,272,5,14,57,81,72,132,204,48,13,37,63,102,376
9192,Dre Calloway,2011,2013,St. Francis (NY),NEC,62,1419,137,340,134,306,3,34,99,204,36,84,120,200,60,4,124,169,376
9193,Keith Charleston,2016,2019,Southeastern Louisiana,Southland,75,1735,145,333,115,239,30,94,56,107,96,235,331,85,28,16,122,172,376
9194,Nojel Eastern,2018,2019,Purdue,Big Ten,73,1481,144,292,141,280,3,12,85,148,104,188,292,128,60,17,91,142,376
9195,Jack Ferguson,2018,2019,Colgate,Patriot,65,909,115,300,29,67,86,233,60,79,19,75,94,52,35,7,38,78,376
9196,Brandon Horvath,2018,2019,Maryland-Baltimore County,AEC,61,1004,120,283,82,151,38,132,98,155,50,145,195,41,33,16,48,71,376
9197,Steven Jones,2013,2016,UC-Riverside,Big West,108,1970,144,393,105,250,39,143,49,92,27,159,186,184,50,8,112,228,376
9198,Fernandez Lockett,2008,2008,Austin Peay,OVC,35,1112,126,274,123,249,3,25,121,159,88,149,237,61,40,12,46,83,376
9199,Longar Longar,2008,2008,Oklahoma,Big 12,33,852,146,299,146,299,0,0,84,139,67,119,186,44,8,33,87,87,376
9200,Simon McCormack,2009,2012,American,Patriot,98,1683,153,310,153,310,0,0,70,114,82,191,273,125,27,3,114,213,376
9201,Warren McLendon,2008,2008,Hartford,AEC,31,716,130,267,123,226,7,41,109,189,40,124,164,38,20,51,73,97,376
9202,Sean Obi,2014,2018,Total,Total,61,945,152,258,152,258,0,0,72,132,94,235,329,26,17,25,68,123,376
9203,Dana Raysor,2016,2017,Delaware State,MEAC,58,1062,112,304,31,80,81,224,71,102,27,84,111,52,29,4,55,107,376
9204,RaySean Scott Jr.,2017,2019,Florida Gulf Coast,A-Sun,73,1017,151,296,131,221,20,75,54,84,83,211,294,48,19,25,69,162,376
9205,R.J. Scott,2010,2013,Total,Total,64,1056,128,378,40,119,88,259,32,47,37,109,146,43,30,9,77,87,376
9206,Ja'vonte Smart,2019,2019,Louisiana State,SEC,34,1016,131,353,90,222,41,131,73,87,15,96,111,81,45,4,63,57,376
9207,Keith Thompson,2011,2012,Utah Valley,GWC,62,1027,141,305,122,241,19,64,75,120,61,116,177,65,36,42,58,96,376
9208,David Watkins,2016,2019,New Hampshire,AEC,96,1213,132,372,72,166,60,206,52,89,52,209,261,36,9,13,75,137,376
9209,Andre Berry,2016,2018,Rhode Island,A-10,64,773,158,259,158,259,0,0,59,84,75,111,186,14,3,13,56,100,375
9210,Chris Darrington,2018,2019,Total,Total,58,734,110,277,59,138,51,139,104,126,10,61,71,55,31,1,54,82,375
9211,Jeremiah Davis,2012,2016,Total,Total,79,1249,134,360,94,217,40,143,67,90,19,145,164,138,54,15,110,122,375
9212,Mike Gordon,2008,2008,Binghamton,AEC,30,1076,135,308,95,193,40,115,65,83,31,90,121,114,66,7,62,85,375
9213,Corey Jefferson,2008,2009,Texas State,Southland,58,1462,128,278,79,162,49,116,70,99,,,133,265,83,4,123,,375
9214,Cory Joseph,2011,2011,Texas,Big 12,36,1166,136,322,84,196,52,126,51,73,23,105,128,109,37,11,54,65,375
9215,Josh Sain,2008,2010,Total,Total,35,750,132,342,73,181,59,161,52,84,44,73,117,47,36,4,80,48,375
9216,Junior Saintel,2017,2018,Stony Brook,AEC,64,1211,148,332,139,285,9,47,70,103,80,184,264,29,39,40,70,114,375
9217,Bira Seck,2014,2015,Idaho,Total,64,1383,162,306,161,305,1,1,50,90,123,250,373,57,23,11,95,221,375
9218,Taylor Young,2008,2011,Central Florida,CUSA,111,1742,116,312,70,160,46,152,97,126,23,91,114,240,73,2,105,168,375
9219,Brandon Adams,2009,2010,Hawaii,WAC,59,1130,135,270,134,263,1,7,103,156,94,144,238,34,10,20,72,131,374
9220,Michael Allen,2008,2009,Ohio,MAC,64,1914,126,320,88,215,38,105,84,126,24,113,137,280,82,4,145,163,374
9221,Kris Bankston,2018,2019,Little Rock,Sun Belt,61,1120,157,211,157,209,0,2,60,124,79,181,260,51,29,64,69,159,374
9222,Reggie Bishop,2008,2008,Campbell,A-Sun,30,934,123,325,52,147,71,178,57,68,33,93,126,31,38,1,52,67,374
9223,Brian Bryant,2011,2012,Mississippi State,SEC,61,1359,143,313,128,265,15,48,73,109,66,167,233,115,40,26,65,91,374
9224,Jared Bynum,2019,2019,Saint Joseph's,A-10,33,1208,126,303,91,201,35,102,87,126,15,104,119,147,44,5,63,52,374
9225,Danny Carter,2009,2012,Stony Brook,AEC,116,1781,136,341,84,177,52,164,50,74,81,183,264,47,32,23,85,176,374
9226,Nasir Core,2017,2019,Florida A&M,MEAC,91,1259,108,290,77,190,31,100,127,187,37,131,168,121,62,8,128,156,374
9227,Omar Habwe,2018,2019,Mount St. Mary's,NEC,62,1224,109,284,60,136,49,148,107,145,51,150,201,46,41,5,53,105,374
9228,Zack Moore,2016,2019,Total,Total,57,1002,122,287,34,60,88,227,42,47,23,119,142,45,29,8,41,96,374
9229,Quan Prowell,2008,2008,Auburn,SEC,25,813,142,261,103,166,39,95,51,71,50,108,158,38,32,11,47,81,374
9230,Ikenna Smart,2016,2019,Total,Total,120,1678,154,267,154,266,0,1,66,113,176,270,446,20,21,50,91,317,374
9231,Brandon Baker,2010,2013,Belmont,Total,131,1600,144,339,95,159,49,180,36,59,116,192,308,99,88,30,73,241,373
9232,Tim Blackwell,2008,2008,Missouri-Kansas City,Summit,31,1106,115,289,60,160,55,129,88,116,17,69,86,89,24,4,68,49,373
9233,Clayton Brothers,2009,2012,Hartford,AEC,115,2316,127,371,97,250,30,121,89,165,72,177,249,150,82,4,159,228,373
9234,Rashad Chase,2008,2009,Georgia State,CAA,60,1543,121,276,116,259,5,17,126,225,121,278,399,50,51,13,108,176,373
9235,Cedric Council Jr.,2018,2019,Coppin State,MEAC,65,1608,141,360,110,241,31,119,60,106,101,220,321,45,43,67,78,180,373
9236,Jaleel Cousins,2015,2016,South Florida,AAC,65,1192,127,278,127,277,0,1,119,222,133,212,345,18,27,77,105,182,373
9237,Noah Frederking,2018,2019,Evansville,MVC,64,1333,125,306,60,132,65,174,58,78,24,96,120,59,24,4,57,63,373
9238,Paul Gause,2008,2009,Seton Hall,Big East,48,1311,129,328,82,175,47,153,68,94,50,131,181,121,130,4,63,137,373
9239,Nick Gruninger,2014,2015,UC-Riverside,Big West,60,1371,118,296,73,168,45,128,92,103,12,115,127,176,56,0,92,127,373
9240,Sorena Orandi,2008,2011,Saint Francis (PA),NEC,91,1428,129,357,73,183,56,174,59,84,31,115,146,108,29,3,95,139,373
9241,Jaleel Roberts,2012,2015,North Carolina-Asheville,Big South,90,1106,154,265,154,264,0,1,65,100,94,192,286,24,15,129,71,187,373
9242,Jalen Robinson ,2013,2015,Dayton,A-10,76,1175,138,312,132,295,6,17,91,151,115,167,282,30,39,24,73,133,373
9243,Marcus Tarrance,2014,2015,Middle Tennessee,CUSA,66,1214,109,283,59,129,50,154,105,149,51,80,131,49,33,4,57,114,373
9244,Phillip Thomas,2008,2011,Total,Total,60,838,126,256,126,256,0,0,121,159,42,90,132,9,13,12,61,114,373
9245,Eric Thompson,2015,2016,Pacific,WCC,43,979,127,237,127,236,0,1,119,194,106,159,265,31,17,39,64,157,373
9246,Nouhoum Bocoum,2015,2016,Arkansas State,Sun Belt,57,865,139,300,138,295,1,5,93,135,92,149,241,14,7,32,58,88,372
9247,Maxime Boursiquot,2017,2018,Northeastern,CAA,64,1273,149,295,126,237,23,58,51,74,74,182,256,62,35,13,90,149,372
9248,Jarvis Bradley,2008,2008,McNeese State,Southland,29,888,136,316,136,314,0,2,100,136,58,152,210,30,26,20,82,98,372
9249,Dylan Carl,2018,2019,Purdue-Fort Wayne,Summit,65,1292,152,319,121,222,31,97,37,67,64,193,257,84,37,66,88,130,372
9250,Will Cook,2011,2013,Samford,Southern,77,1498,126,321,78,148,48,173,72,110,50,201,251,59,30,10,75,144,372
9251,Zach Hankins,2019,2019,Xavier,Big East,35,763,162,236,162,235,0,1,48,78,76,109,185,37,13,54,35,65,372
9252,Rayvon Harris,2012,2015,Total,Total,74,1112,119,239,109,210,10,29,124,193,87,144,231,39,31,13,115,158,372
9253,Bradley Hayes,2013,2017,Georgetown,Big East,94,1066,155,290,155,290,0,0,62,118,98,226,324,56,21,53,81,164,372
9254,Regis Huddleston,2009,2011,Troy,Sun Belt,50,904,123,352,24,64,99,288,27,36,12,55,67,32,25,1,32,63,372
9255,Ahmed Ismail,2017,2019,Total,Total,63,1088,137,243,132,233,5,10,93,141,114,200,314,34,10,51,102,191,372
9256,Lukas Jarrett,2017,2019,Lafayette,Patriot,89,1692,138,302,110,213,28,89,68,94,69,251,320,104,57,93,110,156,372
9257,Ian Krishnan,2019,2019,Central Connecticut State,NEC,31,1053,129,355,58,146,71,209,43,51,8,53,61,36,24,1,32,81,372
9258,Jeremy Landers,2008,2011,Northern Illinois,MAC,107,1455,125,348,98,252,27,96,95,152,49,133,182,100,59,16,121,202,372
9259,Moe McDonald,2014,2018,Texas-Rio Grande Valley,WAC,91,1515,110,319,67,146,43,173,109,153,31,121,152,131,42,3,110,125,372
9260,Joe Mvuezolo Jr.,2017,2018,Montana State,Big Sky,56,1088,130,342,83,207,47,135,65,89,30,132,162,48,29,31,73,84,372
9261,Miles Overton,2014,2018,Total,Total,68,996,111,369,56,168,55,201,95,128,18,71,89,63,32,6,83,109,372
9262,Brandon Sampay,2008,2009,Illinois State,MVC,65,1101,144,298,143,293,1,5,83,109,85,183,268,43,42,36,64,152,372
9263,Steven Samuels,2010,2011,Saint Peter's,MAAC,63,1397,136,343,78,176,58,167,42,70,63,137,200,71,70,16,110,140,372
9264,Marico Stinson,2008,2008,Indiana State,MVC,31,941,134,363,63,160,71,203,33,44,21,59,80,43,27,4,65,38,372
9265,Dane Watts,2008,2008,Creighton,MVC,33,830,127,238,93,158,34,80,84,117,78,134,212,34,18,30,57,92,372
9266,Aaron Bracket,2011,2012,North Carolina-Greensboro,Southern,63,1351,158,336,156,323,2,13,53,81,91,222,313,28,39,29,70,152,371
9267,C.J. Bray,2012,2015,Citadel,Southern,89,1382,141,330,106,222,35,108,54,84,74,212,286,36,22,14,64,134,371
9268,Isaac Cohen,2013,2016,Columbia,Ivy,109,2592,159,276,148,248,11,28,42,97,131,356,487,303,57,18,132,195,371
9269,Hamidou Diallo,2018,2018,Kentucky,SEC,37,918,134,313,108,236,26,77,77,125,33,102,135,46,28,13,51,96,371
9270,Dion Dowell,2008,2008,Houston,CUSA,34,994,120,282,47,103,73,179,58,66,80,151,231,35,21,52,36,108,371
9271,Stanley Hodge,2008,2008,Niagara,MAAC,28,969,118,266,71,136,47,130,88,118,42,109,151,94,29,3,64,75,371
9272,Dan Jech,2016,2019,South Dakota,Summit,89,875,143,277,129,222,14,55,71,110,61,129,190,17,10,33,59,144,371
9273,Branden Johnson,2016,2019,Alabama State,SWAC,68,1286,152,242,152,240,0,2,67,178,126,201,327,11,25,67,58,122,371
9274,Joseph Jones,2008,2008,Texas A&M,Big 12,36,883,132,274,124,254,8,20,99,144,80,113,193,45,17,15,47,102,371
9275,Vlad Kondratyev,2011,2013,Bryant,NEC,80,1315,158,323,142,277,16,46,39,65,98,188,286,24,11,29,66,204,371
9276,Derrick Millinghaus,2013,2014,Mississippi,SEC,63,1001,123,358,83,219,40,139,85,125,11,85,96,127,57,1,61,67,371
9277,Michael Ochereobia,2013,2014,Western Illinois,Summit,61,1031,148,250,148,250,0,0,75,134,78,165,243,24,21,58,75,163,371
9278,Drew Parker,2011,2014,North Carolina-Greensboro,Southern,126,2467,120,351,39,124,81,227,50,70,26,187,213,294,66,3,169,140,371
9279,Justin Payne,2008,2009,Nicholls State,Southland,62,1764,116,289,63,160,53,129,86,132,20,123,143,178,83,6,135,205,371
9280,Jeromy Rodriguez,2019,2019,East Tennessee State,Southern,33,1023,152,274,152,274,0,0,67,100,113,248,361,64,44,21,75,70,371
9281,K.J. Rose,2014,2015,Fairfield,MAAC,58,1584,130,337,106,250,24,87,87,158,44,132,176,188,49,2,149,153,371
9282,Darrick Wood,2015,2017,DePaul,Big East,75,1088,146,392,114,276,32,116,47,80,29,116,145,88,37,7,96,124,371
9283,Baptiste Bataille,2008,2010,Northeastern,CAA,93,1405,91,279,42,112,49,167,139,179,32,83,115,130,70,1,98,110,370
9284,Rasir Bolton,2019,2019,Penn State,Big Ten,32,861,113,295,61,151,52,144,92,105,20,44,64,47,20,2,83,61,370
9285,Trae Clark,2008,2009,Cal Poly,Big West,39,1143,127,323,87,182,40,141,76,104,14,78,92,127,44,1,94,83,370
9286,Calvin Douglas,2011,2012,San Jose State,WAC,63,1235,127,353,49,116,78,237,38,48,19,39,58,48,11,2,29,68,370
9287,Nathan Ekwu,2015,2019,Davidson,A-10,97,1305,141,283,136,264,5,19,83,151,117,261,378,51,33,64,84,247,370
9288,Chuck Ester,2015,2016,Chattanooga,Southern,65,1262,146,295,128,249,18,46,60,105,62,195,257,72,47,25,91,118,370
9289,Wesley Harris,2018,2019,West Virginia,Big 12,59,1316,114,304,66,154,48,150,94,132,77,156,233,32,37,24,68,151,370
9290,Mike Myers Keitt,2009,2010,Monmouth,NEC,56,1011,126,343,106,247,20,96,98,119,50,90,140,70,33,13,68,71,370
9291,Dontrell Shuler,2019,2019,Charleston Southern,Big South,34,908,137,317,107,203,30,114,66,108,21,72,93,62,33,4,55,69,370
9292,Kyron Stokes,2008,2011,Oral Roberts,Summit,77,1634,121,329,70,145,51,184,77,110,84,186,270,105,55,23,89,149,370
9293,Rico Tucker,2008,2009,Pepperdine,WCC,54,1004,129,325,100,223,29,102,83,110,33,56,89,136,80,5,160,76,370
9294,John Williamson,2008,2008,Cincinnati,Big East,32,848,142,294,137,281,5,13,81,132,80,120,200,20,26,9,45,95,370
9295,Josh Bright,2008,2011,Maryland-Eastern Shore,MEAC,104,1856,124,416,53,191,71,225,50,84,67,116,183,150,53,1,137,115,369
9296,Pawel Buczak,2008,2010,Princeton,Ivy,73,1394,147,304,128,254,19,50,56,92,80,142,222,115,45,40,116,191,369
9297,Lovell Cook,2013,2013,New Orleans,Ind,26,718,150,278,146,271,4,7,65,87,19,63,82,7,25,8,40,52,369
9298,Ceasar DeJesus,2018,2019,Central Florida,AAC,59,1184,128,297,105,233,23,64,90,122,19,79,98,78,31,3,87,70,369
9299,Darnell Dialls,2008,2008,Eastern Kentucky,OVC,30,937,142,266,129,227,13,39,72,108,49,133,182,66,18,21,67,89,369
9300,Dominique Dunning,2012,2016,Total,Total,111,1456,132,293,115,245,17,48,88,144,80,211,291,84,54,12,66,151,369
9301,Jailen Gill,2018,2019,Tennessee-Martin,OVC,60,1048,161,281,161,276,0,5,47,71,87,164,251,32,26,58,76,137,369
9302,Jordan Jackson,2018,2019,Texas-Rio Grande Valley,WAC,42,880,129,270,101,181,28,89,83,117,32,86,118,45,55,18,61,102,369
9303,Travis Lee,2009,2011,Troy,Sun Belt,56,797,118,302,25,61,93,241,40,51,12,54,66,27,28,1,29,36,369
9304,Shawn Lester,2014,2014,Charlotte,CUSA,31,757,126,300,77,142,49,158,68,90,19,111,130,48,24,2,76,65,369
9305,Michael Lizarraga,2008,2012,Cal State Northridge,Big West,99,1332,136,289,136,288,0,1,97,155,109,193,302,46,46,29,94,197,369
9306,Brandon McGee,2008,2012,Total,Total,78,1030,137,355,96,195,41,160,54,91,90,146,236,45,31,12,70,51,369
9307,Jack Perry,2018,2019,Eastern Washington,Big Sky,67,1645,127,313,38,81,89,232,26,32,15,107,122,137,26,2,74,71,369
9308,Michael Santos,2008,2011,Santa Clara,WCC,111,2024,128,270,104,193,24,77,89,135,76,174,250,129,57,14,148,171,369
9309,Landon Taliaferro,2019,2019,Fairfield,MAAC,30,863,124,311,34,98,90,213,31,42,9,52,61,30,21,3,31,50,369
9310,Keleaf Tate,2018,2019,Niagara,MAAC,64,1254,134,405,72,203,62,202,39,59,44,114,158,45,40,1,64,83,369
9311,Jacquil Taylor,2015,2019,Total,Total,73,1149,155,239,150,225,5,14,54,81,117,247,364,32,26,83,55,118,369
9312,Jeremy Thomas,2008,2011,Arkansas State,Sun Belt,99,1384,134,207,134,206,0,1,101,179,125,122,247,53,34,28,67,163,369
9313,Jamil Tucker,2008,2009,Virginia,ACC,59,1001,130,298,68,137,62,161,47,68,52,157,209,37,23,27,52,124,369
9314,Alexis Wangmene,2008,2012,Texas,Big 12,136,1616,115,252,115,250,0,2,139,207,168,209,377,16,42,70,92,271,369
9315,Tyler Wilson,2014,2017,Manhattan,MAAC,129,2666,99,275,92,251,7,24,164,273,36,149,185,364,143,4,238,332,369
9316,Nate Zastrow,2010,2013,North Dakota State,Summit,106,1284,91,304,25,116,66,188,121,147,10,107,117,153,25,0,101,87,369
9317,Josh Bone,2008,2011,Total,Total,71,1457,129,368,56,144,73,224,37,52,33,88,121,57,44,1,60,120,368
9318,Charles Buggs,2014,2017,Total,Total,101,1432,138,287,87,144,51,143,41,63,57,149,206,43,36,33,49,149,368
9319,Isaiah Crawley,2019,2019,Georgia Southern,Sun Belt,32,782,141,253,126,200,15,53,71,114,61,116,177,23,30,13,64,90,368
9320,Jeremiah Crutcher,2009,2010,Tennessee State,OVC,59,1576,126,336,58,128,68,208,48,71,17,100,117,232,47,0,132,77,368
9321,Alex Gordon,2008,2008,Vanderbilt,SEC,34,1014,111,275,34,83,77,192,69,88,5,75,80,104,33,1,70,66,368
9322,Kris Gulley,2013,2015,Total,Total,96,1610,128,346,61,122,67,224,45,67,67,181,248,55,39,11,89,143,368
9323,Taylor Johnston,2010,2013,Binghamton,AEC,107,1707,124,326,44,113,80,213,40,60,46,142,188,44,37,9,87,139,368
9324,Greg King,2016,2019,Total,Total,88,1262,158,289,158,289,0,0,52,126,123,262,385,26,20,47,96,184,368
9325,Taevion Kinsey,2019,2019,Marshall,CUSA,36,881,144,246,120,181,24,65,56,86,62,75,137,46,28,16,36,69,368
9326,Willy Kouassi,2012,2016,Total,Total,114,1576,144,282,144,282,0,0,80,168,131,260,391,14,12,106,102,241,368
9327,Nick Larson,2008,2010,Northern Arizona,Big Sky,87,1876,127,325,77,162,50,163,64,84,74,276,350,106,58,35,110,238,368
9328,Anthony Marshall,2008,2009,Georgia Southern,Southern,59,896,119,279,71,115,48,164,82,121,69,113,182,43,50,10,57,139,368
9329,Hajji Martin,2008,2011,Chicago State,Total,109,1514,151,385,145,350,6,35,60,109,118,208,326,24,22,42,61,216,368
9330,Emanuel Mayben,2009,2009,Binghamton,AEC,32,1061,125,295,80,174,45,121,73,105,22,108,130,149,35,8,110,98,368
9331,Greg Rice,2010,2013,IUPUI,Summit,69,1328,130,325,88,207,42,118,66,103,13,109,122,142,45,4,113,112,368
9332,KaVaughn Scott,2017,2019,Loyola (MD),Patriot,81,1268,132,244,130,238,2,6,102,181,95,172,267,46,31,28,100,193,368
9333,Lonnie Walker,2018,2018,Miami (FL),ACC,32,888,132,318,76,156,56,162,48,65,13,70,83,61,30,15,37,51,368
9334,Brandon Wheeless,2010,2012,Norfolk State,MEAC,89,1079,134,304,105,200,29,104,71,112,84,82,166,35,29,9,57,133,368
9335,Mo Williams,2012,2015,Army,Patriot,118,2002,110,314,63,151,47,163,101,144,29,94,123,93,54,5,103,202,368
9336,Gordo Castillo,2008,2010,New Mexico State,WAC,84,1219,125,279,30,48,95,231,22,25,47,97,144,49,37,7,52,101,367
9337,Tyler Cheese,2019,2019,Akron,MAC,33,932,144,342,115,243,29,99,50,72,30,133,163,82,35,3,68,64,367
9338,Markeys Deans,2010,2011,Central Connecticut State,NEC,42,1026,138,290,122,242,16,48,75,105,77,129,206,39,40,23,53,94,367
9339,Aaron Holmes,2008,2011,Total,Total,56,994,119,291,86,200,33,91,96,138,60,114,174,60,33,9,65,75,367
9340,Noel Johnson,2010,2013,Total,Total,90,1350,131,395,47,145,84,250,21,34,44,119,163,50,31,16,83,132,367
9341,Gus Leeper,2011,2015,Little Rock,Sun Belt,113,1502,141,322,138,318,3,4,82,111,112,160,272,19,15,59,89,249,367
9342,Robin Lopez,2008,2008,Stanford,Pac-10,36,883,140,262,139,261,1,1,86,132,93,111,204,22,18,83,63,94,367
9343,Mitch McGary,2013,2014,Michigan,Big Ten,47,967,164,279,164,277,0,2,39,76,122,190,312,37,57,34,60,117,367
9344,Joel Ntambwe,2019,2019,Nevada-Las Vegas,MWC,31,747,119,291,75,177,44,114,85,113,50,122,172,18,16,11,37,80,367
9345,Darius Paul ,2013,2013,Western Michigan,MAC,35,868,140,299,130,255,10,44,77,117,91,107,198,58,17,13,74,88,367
9346,Lance Potier,2014,2017,McNeese State,Southland,90,1545,145,360,103,214,42,146,35,62,74,241,315,64,31,48,77,175,367
9347,TeNale Roland,2013,2014,Utah State,Total,63,1399,123,314,53,134,70,180,51,76,24,109,133,152,28,5,73,102,367
9348,T.J. Taylor,2012,2016,UC-Santa Barbara,Big West,127,2053,129,354,49,123,80,231,29,39,25,120,145,275,42,0,120,120,367
9349,Christion Thompson,2016,2019,Rhode Island,A-10,88,1653,110,324,53,119,57,205,90,135,72,165,237,88,76,33,62,209,367
9350,LaShun Watson,2009,2010,South Alabama,Sun Belt,50,1202,141,333,116,265,25,68,60,103,75,149,224,98,37,10,80,104,367
9351,Jeff Wu,2016,2018,Sacramento State,Big Sky,69,1282,139,349,81,165,58,184,31,55,9,85,94,82,37,6,69,99,367
9352,Kenrick Zondervan,2008,2009,Central Florida,CUSA,62,1395,144,277,144,277,0,0,79,116,112,159,271,56,26,18,87,159,367
9353,Devon Agusi,2014,2014,Texas-San Antonio,CUSA,30,830,108,248,87,183,21,65,129,175,30,62,92,70,34,1,90,84,366
9354,Adrio Bailey,2017,2019,Arkansas,SEC,92,1272,151,308,149,296,2,12,62,109,69,143,212,48,54,55,56,177,366
9355,Mike Christensen,2008,2008,New Hampshire,AEC,29,885,107,277,56,137,51,140,101,132,43,131,174,75,22,17,87,77,366
9356,Brian Cole,2010,2013,North Carolina-Greensboro,Southern,78,970,151,336,121,250,30,86,34,54,48,74,122,12,13,32,52,129,366
9357,Marcus Dubose,2012,2013,East Tennessee State,A-Sun,33,860,132,328,93,189,39,139,63,81,29,66,95,19,25,4,65,31,366
9358,Tony Durant,2008,2009,Towson,CAA,59,1115,145,352,141,327,4,25,72,96,74,125,199,30,24,18,72,142,366
9359,James Foye,2017,2019,Dartmouth,Ivy,63,1168,134,300,70,133,64,167,34,42,14,108,122,84,28,5,33,97,366
9360,Jack Gordon,2016,2019,Cornell,Ivy,83,1449,114,257,45,87,69,170,69,100,38,100,138,106,30,2,97,134,366
9361,Jordon Granger,2013,2016,Auburn,SEC,109,1815,128,288,74,130,54,158,56,86,75,176,251,58,45,42,76,194,366
9362,Othello Hunter,2008,2008,Ohio State,Big Ten,37,1009,158,265,156,257,2,8,48,88,91,149,240,31,22,56,53,89,366
9363,Devin Joint,2012,2015,South Carolina State,MEAC,104,1852,150,382,129,294,21,88,45,94,152,239,391,94,95,42,97,226,366
9364,Alex Jones,2011,2011,Seattle,Ind,31,658,126,259,121,228,5,31,109,157,54,71,125,16,23,13,69,105,366
9365,Ben Louis,2008,2011,James Madison,CAA,123,1888,141,345,108,228,33,117,51,82,61,173,234,183,103,24,125,258,366
9366,Kevin Mickle,2016,2018,Total,Total,91,1310,152,311,147,292,5,19,57,87,99,154,253,44,42,27,86,138,366
9367,Keierre Richards,2011,2015,Savannah State,Total,109,2029,110,342,91,269,19,73,127,175,47,126,173,99,60,4,157,192,366
9368,D'Angelo Scott,2012,2014,Texas Southern,SWAC,64,1440,121,226,116,198,5,28,119,156,121,180,301,64,60,22,102,107,366
9369,Muhammad Abdul-Aleem,2013,2014,Florida A&M,MEAC,50,883,127,344,100,248,27,96,84,133,45,130,175,49,46,6,96,80,365
9370,Tim Abruzzo,2014,2017,Navy,Patriot,67,1103,124,364,53,115,71,249,46,66,38,147,185,52,54,15,45,51,365
9371,Kai Edwards,2017,2019,Northern Colorado,Big Sky,89,1317,157,217,157,217,0,0,51,120,141,254,395,37,18,16,49,213,365
9372,Shamar Johnson,2016,2017,Loyola Marymount,WCC,59,1252,145,309,145,308,0,1,75,125,102,150,252,76,32,12,84,186,365
9373,Tom Knight,2011,2014,Notre Dame,Total,99,1192,154,305,154,305,0,0,57,82,98,146,244,49,24,59,53,145,365
9374,Tyler Polley,2018,2019,Connecticut,AAC,65,1332,119,299,52,126,67,173,60,88,40,71,111,26,16,24,42,104,365
9375,Chris Sarbaugh,2014,2016,Total,Total,95,1805,133,287,122,250,11,37,88,130,56,195,251,180,59,12,128,175,365
9376,Jordan Tolbert,2018,2019,Sacramento State,Big Sky,47,845,131,314,71,171,60,143,43,54,17,75,92,80,42,0,65,81,365
9377,Filip Toncinic,2008,2010,Texas A&M-Corpus Christi,Southland,83,1426,130,353,103,260,27,93,78,126,64,205,269,79,42,77,92,133,365
9378,Jonathan Wallace,2008,2008,Georgetown,Big East,34,975,124,251,53,92,71,159,46,58,16,55,71,88,28,1,51,52,365
9379,Kimar Williams,2016,2019,Total,Total,80,1705,134,348,126,302,8,46,89,164,36,175,211,206,92,5,112,149,365
9380,Andrew Zimmermann,2008,2012,Total,Total,103,1464,146,328,137,282,9,46,64,111,95,165,260,66,49,30,113,228,365
9381,Ryan Bright,2008,2008,Sam Houston State,Southland,31,982,140,333,112,234,28,99,56,107,92,245,337,114,54,19,108,85,364
9382,Billy Brown,2017,2019,North Dakota,Total,83,1719,126,298,55,105,71,193,41,51,21,140,161,86,51,8,72,118,364
9383,John Brown,2015,2016,South Alabama,Sun Belt,64,1163,134,314,99,201,35,113,61,84,42,91,133,58,40,31,72,86,364
9384,Malik Crowfield,2017,2019,Virginia Commonwealth,A-10,96,1519,120,322,21,50,99,272,25,35,24,93,117,85,48,8,49,99,364
9385,Donaven Dorsey,2015,2019,Total,Total,87,1150,124,295,39,74,85,221,31,51,22,104,126,32,19,13,38,160,364
9386,Javon Freeman,2019,2019,Valparaiso,MVC,33,1033,133,294,105,197,28,97,70,101,37,105,142,66,60,12,53,71,364
9387,Drew Gibson,2008,2008,Wofford,Southern,30,1000,102,249,67,160,35,89,125,158,12,81,93,180,49,5,83,69,364
9388,Robert Goldsberry,2008,2011,Canisius,MAAC,115,2235,104,281,38,85,66,196,90,120,46,154,200,289,108,4,187,281,364
9389,Benas Griciunas,2014,2018,Total,Total,93,1009,154,330,143,285,11,45,45,78,68,165,233,27,15,41,57,151,364
9390,Baye Moussa Keita,2011,2014,Syracuse,Total,142,2110,142,237,142,237,0,0,80,138,229,258,487,25,62,155,78,316,364
9391,Donte Morales,2011,2012,North Carolina-Wilmington,CAA,59,1492,124,308,88,203,36,105,80,110,77,134,211,78,40,27,110,125,364
9392,TySean Powell,2015,2016,Duquesne,A-10,55,849,145,249,143,246,2,3,72,115,69,153,222,41,24,34,75,124,364
9393,Jordan Poydras,2016,2017,Utah Valley,WAC,35,837,115,312,52,115,63,197,71,93,11,78,89,73,30,1,45,58,364
9394,Imad Qahwash,2011,2011,Central Arkansas,Southland,29,664,111,265,78,169,33,96,109,159,35,47,82,48,31,0,83,48,364
9395,Remu Raitanen,2017,2019,San Francisco,WCC,94,1388,119,309,54,102,65,207,61,88,76,171,247,59,29,8,43,125,364
9396,Isaiah Thomas,2016,2019,Northern Arizona,Big Sky,110,1295,152,279,152,279,0,0,60,104,108,196,304,13,15,71,66,238,364
9397,Roman Tubner,2009,2011,Centenary (LA),Summit,57,976,109,316,85,220,24,96,122,179,21,82,160,114,78,4,133,100,364
9398,Eric Vianney,2008,2010,Tulane,CUSA,85,1383,121,317,54,120,67,197,55,81,21,127,148,124,66,3,89,156,364
9399,Jonah Antonio,2018,2018,Mount St. Mary's,NEC,32,1071,122,333,32,67,90,266,29,36,14,107,121,21,41,18,19,42,363
9400,Hal Bateman,2012,2013,Stephen F. Austin,Southland,64,1431,125,305,119,276,6,29,107,180,13,128,141,263,83,8,142,129,363
9401,Chris Bowling,2017,2019,Northern Arizona,Big Sky,81,1379,127,408,61,178,66,230,43,60,36,124,160,55,37,18,91,119,363
9402,Jamir Coleman,2019,2019,Central Connecticut State,NEC,30,856,131,298,106,225,25,73,76,90,51,134,185,28,32,21,46,56,363
9403,Stefan Cvrkalj,2012,2015,Lehigh,Patriot,109,1201,124,335,34,85,90,250,25,34,25,105,130,44,27,10,52,106,363
9404,Kevin Egee,2008,2009,Pennsylvania,Ivy,58,1230,129,313,72,152,57,161,48,76,49,83,132,63,39,16,59,114,363
9405,William Graham,2008,2009,Wright State,Horizon,64,1866,123,307,107,222,16,85,101,160,37,193,230,200,74,16,134,121,363
9406,Jordan Griffin,2017,2019,Long Beach State,Big West,93,1051,129,357,45,102,84,255,21,26,17,72,89,33,21,4,39,29,363
9407,Sam Grooms,2012,2013,Oklahoma,Big 12,62,1617,123,314,109,259,14,55,103,152,24,120,144,285,36,2,103,94,363
9408,Harvey Hale,2008,2009,Wake Forest,ACC,59,1025,110,325,43,105,67,220,76,95,21,82,103,41,56,3,48,111,363
9409,Herb Jones,2018,2019,Alabama,SEC,69,1460,137,329,124,282,13,47,76,153,67,174,241,115,76,42,123,188,363
9410,Giedrius Knysas,2008,2009,Charleston Southern,Big South,59,1299,153,283,147,264,6,19,51,111,101,151,252,25,13,10,59,123,363
9411,Nurideen Lindsey,2012,2013,Total,Total,41,1004,130,293,114,221,16,72,87,144,17,118,135,78,55,6,139,117,363
9412,Yauhen Massalski,2018,2019,San Diego,WCC,67,1019,148,238,147,236,1,2,66,139,104,206,310,50,18,93,95,157,363
9413,Joe Ross Merritt,2008,2008,Samford,OVC,30,1049,131,276,63,100,68,176,33,55,24,88,112,63,17,2,53,73,363
9414,Alex Reed,2018,2019,Citadel,Southern,62,1000,118,292,60,126,58,166,69,103,66,119,185,65,43,15,51,145,363
9415,Paul Scotland,2012,2013,Bethune-Cookman,MEAC,61,1033,110,310,58,154,52,156,91,123,33,64,97,97,55,1,83,110,363
9416,Donovan Smith,2016,2017,Quinnipiac,MAAC,51,946,143,342,132,315,11,27,66,91,104,183,287,33,24,83,67,136,363
9417,Noah Thomas,2018,2019,Drake,MVC,68,1162,128,324,77,162,51,162,56,77,17,105,122,123,44,3,116,104,363
9418,Admassu Williams,2016,2017,Prairie View,SWAC,38,905,134,268,134,268,0,0,95,150,79,142,221,21,14,24,96,89,363
9419,Noel Wilmore,2008,2009,George Washington,A-10,54,984,122,297,25,62,97,235,22,29,19,66,85,28,27,4,41,74,363
9420,Isaiah Brock,2017,2018,Oakland,Horizon,63,1552,161,232,161,232,0,0,40,62,134,313,447,37,41,158,58,173,362
9421,Pete Campbell,2008,2008,Butler,Horizon,31,713,126,265,24,42,102,223,8,12,25,62,87,17,15,4,19,51,362
9422,Sabatino Chen,2009,2013,Total,Total,128,2053,140,301,117,210,23,91,59,97,81,122,203,100,64,12,99,168,362
9423,Ricky Claitt,2008,2009,Oregon State,Pac-10,67,1888,123,255,79,139,44,116,72,100,21,101,122,160,44,1,86,140,362
9424,Alex Dragicevich,2011,2015,Total,Total,93,1272,116,295,50,102,66,193,64,90,22,98,120,66,22,24,51,72,362
9425,Jibreel Faulkner,2017,2019,Canisius,MAAC,55,899,140,290,95,167,45,123,37,59,50,82,132,42,24,10,38,59,362
9426,Montaque Gill-Caesar,2015,2018,Total,Total,60,1045,122,357,84,214,38,143,80,108,39,102,141,24,30,5,84,85,362
9427,Chris Iles,2009,2010,Nicholls State,Southland,61,1333,111,315,57,164,54,151,86,108,14,76,90,167,44,0,107,117,362
9428,Laimis Kisielius,2008,2008,William & Mary,CAA,32,931,126,325,84,197,42,128,68,103,27,83,110,79,31,5,64,71,362
9429,Isaiah Manderson,2015,2018,Total,Total,66,1053,151,303,151,297,0,6,60,105,74,140,214,26,18,13,74,97,362
9430,Houston Smith,2017,2019,Bethune-Cookman,MEAC,90,1784,141,294,115,216,26,78,54,101,108,175,283,94,40,28,105,182,362
9431,Evan Wessel,2012,2016,Wichita State,MVC,123,2182,131,356,55,103,76,253,24,52,133,183,316,80,59,14,50,183,362
9432,Dogus Balbay,2009,2011,Texas,Big 12,97,1988,148,296,146,280,2,16,63,123,84,179,263,293,94,40,127,215,361
9433,Seth Berger,2014,2018,Total,Total,120,1488,142,293,119,206,23,87,54,90,92,181,273,62,65,18,68,217,361
9434,Breaon Brady,2018,2019,Houston,AAC,70,927,152,267,152,267,0,0,57,89,103,180,283,23,24,34,80,217,361
9435,Mark Crowe,2017,2019,Cal Poly,Big West,61,1494,127,312,56,118,71,194,36,58,42,171,213,69,51,24,58,133,361
9436,James Fives,2016,2019,Loyola (MD),Patriot,90,1531,95,291,44,139,51,152,120,170,71,138,209,46,45,5,86,174,361
9437,Gabe Kalscheur,2019,2019,Minnesota,Big Ten,36,1106,118,283,41,95,77,188,48,64,21,50,71,40,28,12,37,97,361
9438,Jaquan Lynch,2016,2017,Arkansas-Pine Bluff,SWAC,49,1067,120,319,61,160,59,159,62,74,24,68,92,85,54,4,62,67,361
9439,DeVaughn Mallory,2016,2017,Delaware State,MEAC,54,1001,163,310,162,302,1,8,34,54,104,125,229,27,19,19,58,129,361
9440,Casey Schlatter,2016,2018,Drake,MVC,95,1314,136,297,120,251,16,46,73,107,95,187,282,107,30,23,79,146,361
9441,Jamal Shabazz,2015,2016,Samford,Southern,59,1151,117,298,72,157,45,141,82,115,69,133,202,34,32,32,63,156,361
9442,Mike Stovall,2008,2011,Total,Total,64,1123,129,363,100,245,29,118,74,98,35,95,130,89,56,7,91,67,361
9443,Willie Atwood,2015,2016,Arizona State,Pac-12,63,1225,103,269,60,136,43,133,111,152,70,123,193,55,20,11,46,148,360
9444,Gabe Bealer,2016,2018,Utah,Pac-12,77,1072,126,280,48,83,78,197,30,43,21,116,137,28,24,7,37,76,360
9445,Eric Bell,2008,2010,Stephen F. Austin,Southland,86,2398,121,352,82,242,39,110,79,121,15,124,139,382,119,5,162,162,360
9446,Will Brew,2009,2011,UC-Santa Barbara,Big West,91,1875,119,332,73,177,46,155,76,129,50,110,160,169,93,4,162,218,360
9447,Stanley Burrell,2008,2008,Xavier,A-10,37,1183,107,274,63,162,44,112,102,124,18,63,81,140,28,3,84,56,360
9448,Dewayne Dedmon,2012,2013,Southern California,Pac-12,51,1156,153,294,153,290,0,4,54,88,119,206,325,25,48,85,78,157,360
9449,Christopher Duncan,2010,2011,Alabama State,SWAC,57,1120,134,335,125,281,9,54,83,139,90,153,243,40,26,98,82,119,360
9450,Najee Garvin,2017,2018,Charlotte,CUSA,58,1140,142,297,142,291,0,6,76,118,51,201,252,33,15,16,80,128,360
9451,Alex Gavrilovic,2012,2015,Total,Total,97,1187,139,287,115,212,24,75,58,88,99,149,248,21,13,15,63,176,360
9452,Dexter Gray,2008,2008,Iona,MAAC,32,863,138,288,122,232,16,56,68,92,53,114,167,40,28,27,81,91,360
9453,Makhtar Gueye,2018,2019,Alabama-Birmingham,CUSA,67,1245,139,303,117,214,22,89,60,82,95,190,285,35,20,28,71,134,360
9454,Matt Gwynne,2008,2009,Total,Total,54,831,126,296,98,215,28,81,80,111,70,148,218,42,8,3,88,92,360
9455,Petr Herman,2015,2019,Loyola Marymount,WCC,110,1186,149,307,142,284,7,23,55,93,83,162,245,41,48,56,73,151,360
9456,Tom Jervis,2008,2009,Troy,Sun Belt,61,1071,129,260,126,246,3,14,99,145,132,194,326,17,29,105,67,136,360
9457,McKenzie Moore,2013,2014,Texas-El Paso,CUSA,36,911,114,253,84,169,30,84,102,133,37,142,179,81,42,25,89,94,360
9458,Derian Shaffer,2012,2013,Southern Illinois-Edwardsville,OVC,54,1231,141,278,141,278,0,0,78,143,116,162,278,24,27,36,86,154,360
9459,Camren Wynter,2019,2019,Drexel,CAA,32,1092,145,337,123,271,22,66,48,63,30,117,147,174,44,2,77,78,360
9460,Tyrin Atwood,2017,2019,Lamar,Southland,60,885,128,258,115,222,13,36,90,126,61,129,190,64,48,18,61,102,359
9461,Chris Daniels,2008,2008,Texas A&M-Corpus Christi,Southland,29,801,130,257,98,169,32,88,67,97,50,130,180,47,12,49,59,88,359
9462,Tevin Findlay,2014,2017,Green Bay,Horizon,107,1255,133,330,114,260,19,70,74,119,31,133,164,144,65,12,100,99,359
9463,Marcus Hammond,2008,2009,College of Charleston,Southern,68,1036,119,319,53,141,66,178,55,88,14,94,108,87,38,1,96,92,359
9464,Michael Hughes,2017,2019,Total,Total,49,849,134,233,132,226,2,7,89,148,60,152,212,33,31,76,65,117,359
9465,J.R. Lyle,2014,2016,Milwaukee,Horizon,85,1242,126,293,81,146,45,147,62,100,32,52,84,61,61,2,64,144,359
9466,Jarrel Marshall,2016,2017,Portland,WCC,49,939,129,336,103,245,26,91,75,96,33,126,159,46,22,32,49,85,359
9467,Mike Martin,2015,2016,Central Arkansas,Southland,38,1079,126,307,82,177,44,130,63,82,14,112,126,139,63,3,105,108,359
9468,Zach Moer,2013,2016,Air Force,MWC,77,897,133,280,117,232,16,48,77,102,52,121,173,47,19,46,84,148,359
9469,Sei Paye,2008,2012,Total,Total,94,1804,112,287,55,121,57,166,78,120,25,154,179,122,64,3,75,105,359
9470,Rupert Rose,2010,2011,Grambling,SWAC,53,1231,116,302,99,236,17,66,110,160,54,124,178,118,75,1,72,140,359
9471,Jamyron Steward,2008,2008,Morehead State,OVC,30,991,121,297,74,163,47,134,70,91,36,65,101,58,41,1,45,43,359
9472,Marcus Thomas,2009,2010,Loyola (IL),Horizon,62,969,121,332,33,91,88,241,29,43,20,51,71,24,21,0,49,67,359
9473,Isaiah Washington,2015,2018,Total,Total,78,1521,108,358,46,133,62,225,81,119,40,128,168,74,38,14,85,139,359
9474,Brody Angley,2008,2008,Santa Clara,WCC,31,1090,125,304,75,178,50,126,58,75,12,114,126,164,48,5,102,56,358
9475,Antuan Bootle,2009,2012,Sam Houston State,Southland,100,1234,156,293,156,293,0,0,46,87,153,294,447,48,29,31,96,214,358
9476,Dewan Clayborn,2011,2012,Central Arkansas,Southland,49,1079,117,327,54,136,63,191,61,100,22,67,89,104,59,0,102,105,358
9477,Travis Daniels,2015,2016,Mississippi State,SEC,61,1309,133,309,89,176,44,133,48,72,94,161,255,40,28,24,79,118,358
9478,Karol Gruszecki,2012,2013,Texas-Arlington,Total,63,973,121,313,45,119,76,194,40,63,28,90,118,41,46,2,72,110,358
9479,Dominique Keller,2009,2010,Illinois,Big Ten,69,827,152,310,133,253,19,57,35,59,53,104,157,27,25,30,56,94,358
9480,Brendon Knox,2009,2010,Auburn,SEC,64,940,139,210,139,209,0,1,80,165,90,91,181,22,24,43,71,141,358
9481,Chris Moore,2008,2009,Cleveland State,Horizon,71,1307,157,305,157,305,0,0,44,80,85,120,205,29,22,66,54,184,358
9482,Kevin Oleksiak,2008,2008,North Carolina-Greensboro,Southern,31,852,114,273,66,139,48,134,82,113,25,84,109,99,40,5,66,53,358
9483,Trey Pinkney,2013,2016,Stephen F. Austin,Southland,135,2911,97,266,74,168,23,98,141,212,31,177,208,422,150,2,164,305,358
9484,Jared Rodriguez,2019,2019,Idaho,Big Sky,32,851,131,278,102,208,29,70,67,82,65,144,209,31,13,18,71,102,358
9485,Anton Waters,2016,2017,Western Kentucky,CUSA,65,1053,145,277,142,263,3,14,65,102,114,150,264,17,13,18,62,132,358
9486,Nick Wiggins,2013,2014,Wichita State,MVC,72,1007,117,296,64,135,53,161,71,112,33,112,145,31,19,15,51,74,358
9487,Reggie Cameron,2014,2017,Georgetown,Big East,104,1225,116,310,44,89,72,221,53,71,23,108,131,64,14,8,56,86,357
9488,Ben Carter,2013,2018,Total,Total,107,1407,121,258,121,254,0,4,115,153,126,181,307,93,56,62,86,192,357
9489,Rayner Moquete,2010,2014,Total,Total,86,1479,124,357,60,157,64,200,45,70,40,129,169,73,49,2,75,145,357
9490,John Ryan,2011,2015,Total,Total,101,1240,146,269,146,269,0,0,65,117,106,206,312,76,22,79,91,182,357
9491,Julian Sullinger,2008,2009,Kent State,MAC,69,1267,148,273,147,269,1,4,60,120,89,140,229,60,25,13,60,132,357
9492,Alex Woodhouse,2008,2009,Colgate,Patriot,54,1386,136,268,136,267,0,1,85,132,98,243,341,74,49,123,110,140,357
9493,Leon Young,2008,2009,Loyola (IL),Horizon,40,867,111,221,111,221,0,0,135,175,107,93,200,29,12,6,51,80,357
9494,Maverick Ahanmisi,2011,2014,Minnesota,Big Ten,127,1413,106,275,58,137,48,138,96,132,27,103,130,143,47,4,113,127,356
9495,Devon Brewer,2017,2019,Alcorn State,SWAC,81,1450,143,283,143,282,0,1,70,141,71,210,281,53,27,65,95,182,356
9496,Donte Harrison,2008,2009,Hampton,MEAC,62,1360,145,267,145,264,0,3,66,109,124,172,296,20,45,68,76,124,356
9497,Zach Hillesland,2008,2009,Notre Dame,Big East,67,1543,131,285,130,283,1,2,93,149,98,242,340,160,47,23,96,159,356
9498,Jaren Jeffery,2009,2014,Southern Utah,Total,101,1315,134,276,125,246,9,30,79,144,92,170,262,48,42,27,68,236,356
9499,Josh Rivers,2008,2009,Western Illinois,Summit,54,1110,124,320,54,129,70,191,38,56,11,63,74,99,27,5,78,67,356
9500,Mehmet Sahan,2008,2011,Sacred Heart,NEC,100,1399,149,293,148,287,1,6,57,98,122,161,283,51,52,37,89,178,356
9501,Chris Shields,2016,2018,Longwood,Big South,66,1468,140,335,98,204,42,131,34,48,41,185,226,57,25,11,114,160,356
9502,Aaron Thompson,2018,2019,Butler,Big East,68,1737,135,288,123,243,12,45,74,129,12,103,115,260,77,22,126,205,356
9503,Milos Vranes,2017,2018,Southeast Missouri State,OVC,61,1135,127,271,66,110,61,161,41,69,59,162,221,35,34,8,64,141,356
9504,Timmy Allen,2019,2019,Utah,Pac-12,29,834,127,221,123,214,4,7,97,132,45,103,148,71,25,5,59,88,355
9505,Ben Boggs,2010,2013,Total,Total,86,1336,111,286,66,144,45,142,88,107,51,135,186,53,34,4,80,123,355
9506,Tyrik Dixon,2017,2018,Middle Tennessee,CUSA,68,1625,125,316,79,189,46,127,59,83,24,177,201,219,72,6,88,160,355
9507,Marek Dolezaj,2018,2019,Syracuse,ACC,71,1769,131,240,118,202,13,38,80,120,111,187,298,111,73,44,89,196,355
9508,Nolan Gerrity,2016,2019,Maryland-Baltimore County,AEC,107,1364,156,287,156,287,0,0,43,105,112,207,319,53,25,57,77,169,355
9509,Jordan Gibson,2008,2010,Yale,Ivy,76,1168,130,282,123,258,7,24,88,116,71,108,179,51,60,37,65,126,355
9510,T.J. Gwynn,2008,2010,Virginia Commonwealth,CAA,84,1202,123,245,115,219,8,26,101,148,71,167,238,75,39,11,72,99,355
9511,Lavar Harewood,2016,2019,Total,Total,53,986,114,303,53,138,61,165,66,90,37,112,149,44,43,9,61,98,355
9512,Hassan Hussein,2015,2019,Total,Total,90,1118,152,310,149,297,3,13,48,69,64,125,189,18,17,31,58,146,355
9513,Pervis Louder,2016,2019,Air Force,MWC,89,1130,122,297,94,193,28,104,83,134,37,111,148,81,35,12,92,141,355
9514,Anali Okoloji,2011,2015,Total,Total,100,1185,115,308,96,226,19,82,106,152,87,178,265,37,55,22,73,130,355
9515,Ricky Parks,2008,2011,Arkansas-Pine Bluff,SWAC,82,994,119,366,47,122,72,244,45,83,33,116,183,49,26,8,95,110,355
9516,T.J. Shipes,2013,2016,Georgia State,Total,112,1809,144,247,144,247,0,0,67,142,141,210,351,18,49,51,71,284,355
9517,Bakari Turner,2013,2014,Morehead State,OVC,41,776,114,294,70,137,44,157,83,132,27,44,71,38,20,4,61,91,355
9518,David Wacker,2015,2019,Boise State,MWC,123,1605,118,212,118,209,0,3,119,179,139,188,327,53,16,39,75,219,355
9519,Gary Williams Jr.,2016,2017,San Jose State,MWC,51,740,114,310,94,220,20,90,107,129,39,85,124,60,20,5,68,75,355
9520,Joe Wolfinger,2008,2010,Total,Total,73,867,133,298,91,178,42,120,47,75,67,114,181,11,7,25,58,121,355
9521,Thomas Allen,2018,2019,Nebraska,Big Ten,61,1194,130,306,77,159,53,147,41,49,15,97,112,76,45,6,49,37,354
9522,Dillon Avare,2015,2018,Total,Total,76,1417,115,320,5,13,110,307,14,18,18,60,78,70,26,1,45,101,354
9523,Osborn Blount,2016,2018,North Florida,A-Sun,82,1069,115,334,56,155,59,179,65,84,14,75,89,64,52,2,76,93,354
9524,Tolga Cerrah,2011,2012,Radford,Big South,55,1278,141,279,141,279,0,0,72,135,118,133,251,31,28,25,89,179,354
9525,Chase Cormier,2014,2017,Grambling,SWAC,106,2467,93,346,61,225,32,121,136,237,50,173,223,274,103,0,194,250,354
9526,Sergio El Darwich,2017,2019,Total,Total,43,1102,135,280,104,181,31,99,53,74,24,141,165,121,44,8,108,92,354
9527,Hayes Garrity,2014,2018,Total,Total,58,979,123,325,78,187,45,138,63,78,23,90,113,68,25,2,60,53,354
9528,Cal Hanks,2012,2015,Southern Utah,Total,93,1098,121,278,121,277,0,1,112,178,59,166,225,21,18,67,92,212,354
9529,Shawn James,2008,2008,Duquesne,A-10,28,665,138,252,123,207,15,45,63,84,67,127,194,30,12,111,57,73,354
9530,Trevon Lewis,2012,2012,Nicholls State,Southland,28,684,131,262,117,225,14,37,78,123,43,101,144,28,27,20,56,84,354
9531,Malik Massey,2017,2019,North Carolina-Greensboro,Southern,98,1653,119,323,58,150,61,173,55,75,11,100,111,117,49,4,81,129,354
9532,Cameron Miles,2010,2013,San Diego,WCC,113,1586,122,353,92,249,30,104,80,111,20,98,118,140,85,4,123,103,354
9533,Eddie Murray,2011,2013,Florida Gulf Coast,A-Sun,92,1431,129,228,122,201,7,27,89,125,107,137,244,31,36,48,54,147,354
9534,Brandon Patterson,2008,2009,Little Rock,Sun Belt,59,1707,132,309,121,262,11,47,79,114,61,150,211,164,51,45,135,125,354
9535,Danny Pippen,2017,2018,Kent State,MAC,62,1010,121,298,81,178,40,120,72,98,107,193,300,25,20,71,67,149,354
9536,Jordan Railey,2011,2015,Total,Total,100,1282,147,319,146,316,1,3,59,138,88,138,226,57,31,85,86,218,354
9537,Keith Ramsey,2009,2010,Missouri,Big 12,72,1432,145,247,135,220,10,27,54,102,124,176,300,79,79,69,82,136,354
9538,Kameron Rooks,2014,2018,Total,Total,111,1468,134,243,134,243,0,0,86,152,162,240,402,31,18,80,56,224,354
9539,Zaquavian Smith,2018,2019,Total,Total,35,822,124,333,56,119,68,214,38,50,27,68,95,37,33,11,41,70,354
9540,Corey Stern,2013,2014,Texas State,Total,61,1112,123,264,114,231,9,33,99,166,78,158,236,42,14,25,62,121,354
9541,Dimi Cook,2016,2017,Southeastern Louisiana,Southland,60,1109,101,236,75,165,26,71,125,162,20,67,87,83,34,1,76,133,353
9542,Luis Guzman,2008,2010,Temple,A-10,92,2062,129,321,90,196,39,125,56,98,55,217,272,216,58,7,131,167,353
9543,Alex Hart,2015,2018,UC-Santa Barbara,Big West,89,1053,134,294,121,245,13,49,72,123,107,170,277,27,15,30,57,118,353
9544,Ben Hazel,2011,2015,Princeton,Ivy,88,1391,102,284,38,87,64,197,85,110,17,134,151,48,41,15,58,87,353
9545,Jeremy Jeffers,2011,2013,Drake,MVC,71,1295,116,281,67,156,49,125,72,91,15,115,130,56,18,1,64,114,353
9546,Wade Knapp,2008,2009,Missouri State,MVC,62,1040,126,259,126,256,0,3,101,166,57,92,149,19,17,37,83,151,353
9547,Joe Latas,2009,2012,Total,Total,103,1034,137,278,137,278,0,0,79,143,110,136,246,32,26,32,89,158,353
9548,Nassir Little,2019,2019,North Carolina,ACC,36,656,131,273,117,221,14,52,77,100,57,109,166,23,19,19,48,59,353
9549,Marquel McKinney,2012,2015,Sam Houston State,Southland,126,1817,109,319,45,113,64,206,71,117,96,144,240,82,42,2,74,192,353
9550,Abner Moreira,2011,2012,Idaho State,Big Sky,59,1811,131,287,131,285,0,2,91,128,152,258,410,57,53,21,127,168,353
9551,Aaron Nesmith,2019,2019,Vanderbilt,SEC,32,928,114,291,55,116,59,175,66,80,34,143,177,45,23,18,51,98,353
9552,Romario Souza,2011,2012,Louisiana Tech,WAC,62,1004,137,243,136,240,1,3,78,113,76,105,181,25,20,16,53,139,353
9553,Tavaris Watts,2008,2009,Texas-El Paso,CUSA,57,1272,121,310,85,187,36,123,75,116,84,127,211,36,27,33,53,147,353
9554,Jalen White,2014,2015,South Carolina State,MEAC,51,1033,120,316,104,266,16,50,97,139,27,83,110,114,29,7,97,84,353
9555,Marlon Bright,2009,2010,Florida International,Sun Belt,52,1020,147,319,139,289,8,30,50,83,103,91,248,42,36,10,75,96,352
9556,Eric Frederick,2011,2011,Florida International,Sun Belt,28,709,134,281,108,207,26,74,58,101,33,149,182,17,20,9,51,79,352
9557,Tevin Glass,2015,2017,Total,Total,54,892,127,244,121,223,6,21,92,125,73,168,241,35,28,22,56,86,352
9558,Raphael Jordan,2011,2013,Bryant,NEC,63,1303,124,326,72,165,52,161,52,78,33,105,138,57,51,5,70,101,352
9559,Aleer Leek,2016,2019,Missouri-Kansas City,WAC,119,1613,121,326,83,205,38,121,72,106,60,181,241,13,20,54,99,213,352
9560,Luke McDonnell,2017,2019,Northern Iowa,MVC,67,1059,127,250,103,184,24,66,74,118,85,128,213,69,31,35,68,131,352
9561,Kojo Mensah,2008,2008,Duquesne,A-10,29,688,106,279,90,212,16,67,124,158,49,48,97,99,41,1,89,54,352
9562,Curtis Oakley,2013,2016,Bryant,NEC,104,1140,127,342,73,158,54,184,44,71,30,139,169,49,21,2,56,124,352
9563,Osasumwen Osaghae,2017,2019,Florida International,CUSA,61,1032,134,222,134,221,0,1,84,144,131,226,357,11,27,130,54,148,352
9564,Deric Rudolph,2012,2012,Savannah State,MEAC,33,949,109,324,11,42,98,282,36,47,18,41,59,52,31,0,45,31,352
9565,Carter Sanderson,2012,2015,Total,Total,77,1010,112,315,56,141,56,174,72,121,17,86,103,65,41,0,85,79,352
9566,Drew Shubik,2008,2008,Sacred Heart,NEC,32,1069,112,245,86,163,26,82,102,134,40,144,184,176,73,16,121,99,352
9567,Taylor Stewart,2009,2012,Air Force,MWC,91,1505,128,296,111,242,17,54,79,137,48,117,165,120,36,11,104,103,352
9568,Darren Townes,2008,2009,Hofstra,CAA,60,1361,143,267,143,267,0,0,66,122,126,198,324,24,39,50,83,160,352
9569,Rob Whitfield,2019,2019,Missouri-Kansas City,WAC,32,969,118,285,34,84,84,201,32,37,17,70,87,53,46,4,40,51,352
9570,Jamal Wilson,2009,2012,Rhode Island,A-10,73,1031,127,315,106,240,21,75,77,101,63,112,175,67,33,7,74,71,352
9571,Tovi Bailey,2008,2009,Charleston Southern,Big South,55,1314,129,323,102,231,27,92,66,109,38,111,149,144,30,3,108,139,351
9572,Tarekeyi Edogi,2014,2018,Total,Total,79,1075,146,257,145,251,1,6,58,96,111,191,302,14,20,48,64,118,351
9573,Nnamdi Ezenwa,2013,2015,Idaho State,Big Sky,60,1495,113,264,77,176,36,88,89,140,55,164,219,66,54,14,79,135,351
9574,Luke Frampton,2019,2019,Davidson,A-10,34,1050,113,298,13,32,100,266,25,38,14,94,108,69,29,11,34,87,351
9575,Robert Goff,2012,2013,Marshall,CUSA,64,1360,143,300,143,297,0,3,65,148,110,154,264,35,29,59,65,216,351
9576,Jayson Guerrier,2010,2013,Total,Total,76,1118,121,287,56,115,65,172,44,63,63,109,172,34,19,13,43,83,351
9577,Evann Hall,2014,2016,Idaho State,Big Sky,76,1095,123,315,107,259,16,56,89,145,28,138,166,45,51,8,92,138,351
9578,Joe Ikhinmwin,2011,2012,South Carolina State,MEAC,59,1082,147,303,144,297,3,6,54,87,69,112,181,31,20,17,83,149,351
9579,Davon Jefferson,2008,2008,Southern California,Pac-10,29,805,138,240,134,232,4,8,71,102,59,123,182,22,24,28,69,82,351
9580,Brad Jones,2008,2008,Wyoming,MWC,29,1042,90,233,72,180,18,53,153,209,50,104,154,105,26,0,97,71,351
9581,Kevin Kaspar,2012,2015,Western Kentucky,Total,73,1396,113,316,41,106,72,210,53,71,22,118,140,108,37,0,81,93,351
9582,Kimani Lawrence,2018,2019,Arizona State,Pac-12,53,1038,121,284,85,164,36,120,73,96,46,106,152,46,26,16,55,120,351
9583,Xzavier Malone,2017,2019,Total,Total,52,1011,130,301,81,159,49,142,42,66,28,98,126,58,33,13,65,81,351
9584,Nathaniel Mason,2013,2014,Sam Houston State,Southland,68,906,113,273,87,195,26,78,99,135,52,100,152,38,20,3,63,73,351
9585,Edrico McGregor,2013,2014,Texas-San Antonio,Total,61,1250,145,234,144,233,1,1,60,106,117,196,313,44,24,21,104,168,351
9586,Wassef Methnani,2018,2019,Fairfield,MAAC,59,824,136,302,100,200,36,102,43,58,52,137,189,42,23,43,89,167,351
9587,Julian Moore,2014,2018,Penn State,Big Ten,141,1728,131,273,130,270,1,3,88,137,121,213,334,32,29,85,78,220,351
9588,Jordan Naughton,2016,2019,Wyoming,MWC,92,1130,129,217,129,216,0,1,93,155,75,131,206,18,15,36,58,164,351
9589,Eddie Odio,2012,2015,Boston College,ACC,117,1856,131,288,99,179,32,109,57,92,96,207,303,70,41,60,75,234,351
9590,Michael Ojo,2013,2017,Florida State,ACC,131,1282,126,240,126,240,0,0,99,174,122,203,325,25,23,78,96,211,351
9591,Brian Pearson,2015,2016,Savannah State,MEAC,62,1413,146,265,146,263,0,2,59,126,105,201,306,34,31,27,85,172,351
9592,Haminn Quaintance,2008,2008,Kent State,MAC,35,949,137,229,137,228,0,1,77,126,100,164,264,72,63,69,76,91,351
9593,Paul Velander,2008,2009,Nebraska,Big 12,62,1095,103,269,7,25,96,244,49,60,7,65,72,42,30,3,26,97,351
9594,Dan Waterstradt,2008,2009,Oakland,Summit,67,1365,135,307,114,255,21,52,60,75,110,219,329,47,32,40,45,138,351
9595,David Bruce,2012,2013,Hampton,MEAC,38,867,139,283,139,283,0,0,72,113,97,169,266,11,12,29,73,90,350
9596,Dustin Dibble,2009,2012,Missouri-Kansas City,Summit,110,1575,121,315,91,191,30,124,78,107,44,106,150,62,33,8,79,145,350
9597,Emmanuel Ejeh,2018,2019,Mississippi Valley State,SWAC,64,1229,137,300,135,290,2,10,74,116,156,277,433,46,28,38,61,158,350
9598,Anthony Gaines,2018,2019,Northwestern,Big Ten,64,1449,106,292,85,209,21,83,117,151,57,173,230,107,44,23,68,130,350
9599,David Humphries,2015,2016,Loyola Marymount,WCC,60,1324,117,304,51,125,66,179,50,71,55,170,225,84,42,6,65,97,350
9600,DJ Jackson,2008,2009,Penn State,Big Ten,69,1497,108,259,88,189,20,70,114,150,96,135,231,44,35,17,55,148,350
9601,Greg Lewis,2012,2016,Rutgers,Total,113,1833,139,340,139,340,0,0,72,133,131,251,382,64,33,83,114,254,350
9602,Jamar Nutter,2008,2008,Seton Hall,Big East,32,945,113,292,44,115,69,177,55,70,24,61,85,69,33,1,62,67,350
9603,Torye Pelham,2010,2012,Southern Mississippi,CUSA,69,1204,142,241,136,220,6,21,60,83,165,123,288,20,64,43,54,155,350
9604,Marko Pirovic,2014,2017,Maine,AEC,80,1189,117,294,84,161,33,133,83,133,70,154,224,56,43,2,68,140,350
9605,Devearl Ramsey,2017,2019,Total,Total,58,1191,116,285,76,179,40,106,78,100,12,126,138,127,33,8,69,80,350
9606,Lamar Sanders,2008,2008,Lamar,Southland,30,856,145,226,140,206,5,20,55,123,85,126,211,75,47,38,79,97,350
9607,Simisola Shittu,2019,2019,Vanderbilt,SEC,32,854,131,280,130,262,1,18,87,151,52,162,214,59,21,16,93,75,350
9608,George Tandy,2008,2009,Cleveland State,Horizon,70,1428,132,273,132,270,0,3,86,121,113,217,330,44,52,74,81,192,350
9609,Gerard Andrus,2019,2019,Prairie View,SWAC,35,1022,150,315,146,304,4,11,45,63,77,122,199,36,40,18,40,106,349
9610,Bryan Bouchie,2008,2010,Total,Total,48,810,136,264,124,224,12,40,65,124,44,115,159,25,14,30,57,112,349
9611,Asa Cantwell,2016,2017,Houston Baptist,Southland,63,1056,111,290,10,30,101,260,26,31,9,65,74,67,25,0,51,105,349
9612,Coreontae DeBerry,2015,2016,Cincinnati,AAC,67,845,129,232,129,232,0,0,91,139,66,128,194,10,14,66,42,115,349
9613,Ernest Fields,2008,2010,Austin Peay,OVC,78,1149,125,229,121,217,4,12,95,146,94,188,282,33,55,49,69,155,349
9614,Kyle Foster,2018,2019,Howard,MEAC,64,882,104,309,19,51,85,258,56,81,10,69,79,35,24,9,53,101,349
9615,Brent Hackett,2008,2008,Texas Christian,MWC,30,781,116,320,63,140,53,180,64,81,12,35,47,48,43,1,43,65,349
9616,Ramon Harris,2008,2010,Kentucky,SEC,94,1688,118,249,98,168,20,81,93,152,92,197,289,103,59,28,133,129,349
9617,Bodie Hume,2019,2019,Northern Colorado,Big Sky,32,843,112,258,43,75,69,183,56,76,40,97,137,28,12,39,39,66,349
9618,Scott King,2013,2016,Total,Total,112,1028,125,305,60,119,65,186,34,48,41,106,147,43,15,25,50,145,349
9619,Miles Latimer,2019,2019,Stony Brook,AEC,33,1046,108,278,45,115,63,163,70,91,21,97,118,45,31,8,43,58,349
9620,Zach LaVine,2014,2014,UCLA,Pac-12,37,904,127,288,79,160,48,128,47,68,18,76,94,66,33,6,42,73,349
9621,Aaron Smith,2008,2008,Prairie View,SWAC,30,897,115,293,46,90,69,203,50,69,14,30,44,41,12,0,43,50,349
9622,Ronnie Suggs,2016,2019,Total,Total,75,1323,114,347,76,194,38,153,83,125,35,156,191,54,28,7,77,120,349
9623,Darrin Williams,2008,2009,Loyola (IL),Horizon,63,1182,144,271,144,271,0,0,61,89,93,145,238,25,20,58,47,117,349
9624,Colin Beatty,2012,2013,Pacific,Big West,65,1406,142,328,102,214,40,114,24,44,75,141,216,88,32,15,57,96,348
9625,Jordan Brooks,2008,2008,Idaho,WAC,28,828,120,266,119,250,1,16,107,164,61,112,173,132,48,6,121,85,348
9626,Jared Butler,2019,2019,Baylor,Big 12,34,910,117,296,57,125,60,171,54,68,22,84,106,93,33,3,67,77,348
9627,DJ Clayton,2015,2017,Total,Total,64,1327,132,335,101,227,31,108,53,102,93,128,221,71,41,8,76,105,348
9628,Matt Faw,2018,2019,Holy Cross,Patriot,63,945,123,281,61,122,62,159,40,52,18,133,151,30,36,36,52,159,348
9629,Josh Hall,2017,2018,Nevada,MWC,64,1266,131,273,106,197,25,76,61,87,65,147,212,78,36,13,59,91,348
9630,Myles Hamilton,2013,2016,Total,Total,64,1304,121,331,93,228,28,103,78,107,35,96,131,149,62,8,119,167,348
9631,Deion James,2016,2018,Total,Total,52,915,133,303,120,249,13,54,69,107,83,113,196,60,26,21,61,123,348
9632,David-Lee Jones Jr.,2018,2019,Georgia Southern,Sun Belt,63,1053,122,288,73,153,49,135,55,79,13,75,88,81,44,7,69,113,348
9633,Isaac Mack,2013,2014,New Orleans,Total,51,1184,129,347,95,228,34,119,56,83,28,81,109,103,43,1,103,92,348
9634,Darryl Monroe,2009,2009,George Mason,CAA,33,978,141,246,141,246,0,0,66,115,90,164,254,68,37,15,57,81,348
9635,Aaron Ray,2018,2019,Southern,SWAC,59,1132,102,296,53,151,49,145,95,130,37,147,184,63,47,2,97,142,348
9636,Myles Smith,2018,2019,Texas A&M-Corpus Christi,Southland,40,998,119,275,83,171,36,104,74,91,28,81,109,82,29,3,78,114,348
9637,Standford Speech,2008,2008,Mississippi Valley State,SWAC,33,1080,109,320,73,215,36,105,94,139,27,99,126,86,43,5,81,85,348
9638,Jeremy Washington,2012,2013,Tennessee-Martin,OVC,55,1355,138,331,135,303,3,28,69,89,89,155,244,102,39,29,63,153,348
9639,Travis Wilkins,2013,2014,Ohio,MAC,67,1255,116,266,38,83,78,183,38,50,16,79,95,75,32,3,32,85,348
9640,Eduardo Bermudez,2008,2009,Appalachian State,Southern,54,1164,123,292,83,176,40,116,61,90,57,111,168,71,52,7,104,100,347
9641,Marquise Carter,2011,2012,Gonzaga,WCC,68,1115,107,238,83,162,24,76,109,142,30,77,107,128,59,4,85,88,347
9642,Dainius Chatkevicius,2018,2019,Evansville,MVC,61,1084,139,264,138,258,1,6,68,118,103,204,307,30,18,67,85,154,347
9643,Finis Craddock,2010,2013,Central Michigan,MAC,114,1565,113,330,79,198,34,132,87,140,59,121,180,64,54,6,114,196,347
9644,Sean Crawford,2009,2012,Fairfield,MAAC,91,1169,99,296,40,114,59,182,90,111,36,107,143,98,63,7,79,134,347
9645,Isaiah Dennis,2014,2017,Georgia State,Sun Belt,92,1282,141,244,137,237,4,7,61,123,40,105,145,136,65,16,88,134,347
9646,Kenny George,2008,2008,North Carolina-Asheville,Big South,28,553,151,217,151,217,0,0,45,69,41,156,197,32,3,93,46,33,347
9647,Leonard Hayes,2010,2013,Stony Brook,AEC,95,1300,120,342,44,117,76,225,31,41,44,106,150,56,18,5,39,108,347
9648,Jordan Horn,2018,2019,Total,Total,55,886,121,317,55,118,66,199,39,50,19,88,107,49,31,4,44,54,347
9649,Zach Horstman,2012,2015,South Dakota State,Summit,106,1198,121,284,83,163,38,121,67,98,58,130,188,51,20,15,41,127,347
9650,Aaron Jackson,2015,2018,Total,Total,114,1330,116,308,54,121,62,187,53,88,65,122,187,42,34,9,64,158,347
9651,Jacques Jones,2008,2009,Texas Southern,SWAC,35,1047,121,274,112,250,9,24,96,143,53,132,185,75,39,23,107,109,347
9652,Tim Lang,2008,2010,Stetson,A-Sun,63,1150,119,294,76,168,43,126,66,114,99,149,248,30,22,51,62,169,347
9653,JaJuan Maxwell,2009,2010,Southeast Missouri State,OVC,55,1067,126,296,112,247,14,49,81,115,101,152,253,47,33,26,68,137,347
9654,Shamir McDaniel,2008,2008,Sam Houston State,Southland,31,1040,106,270,36,90,70,180,65,89,34,95,129,92,37,9,56,54,347
9655,De'End Parker,2012,2013,Total,Total,31,825,115,279,86,213,29,66,88,125,12,79,91,59,18,4,35,41,347
9656,Tommy Pereira,2011,2014,Rider,MAAC,106,1297,116,297,12,24,104,273,11,16,27,74,101,52,42,2,35,81,347
9657,Xavier Richards,2015,2016,Tennessee State,OVC,61,1171,138,259,137,255,1,4,70,131,79,157,236,63,33,38,75,128,347
9658,Mark Robertson,2010,2012,Maryland-Eastern Shore,MEAC,89,1451,112,380,22,81,90,299,33,52,37,135,172,36,48,20,84,162,347
9659,Nick Rogers,2016,2019,Total,Total,90,1378,102,273,56,140,46,133,97,140,18,86,104,159,39,2,108,128,347
9660,Kiel Turpin,2013,2015,Florida State,ACC,67,948,141,264,141,262,0,2,65,98,78,99,177,13,21,66,61,168,347
9661,Negus Webster-Chan,2013,2015,Total,Total,64,1330,119,332,39,117,80,215,29,46,55,144,199,72,40,6,74,75,347
9662,Elliott Berry,2011,2012,UC-Riverside,Big West,60,1128,155,340,146,305,9,35,27,51,70,127,197,14,19,18,60,84,346
9663,Eddie Denard,2011,2014,Total,Total,68,1165,138,309,138,303,0,6,70,151,68,147,215,44,46,15,79,204,346
9664,Danilo Djuricic,2018,2019,Harvard,Ivy,62,1094,126,286,77,141,49,145,45,69,74,132,206,35,12,28,45,90,346
9665,Nyles Evans,2014,2015,Akron,MAC,69,1379,114,322,44,107,70,215,48,72,24,122,146,106,56,5,66,128,346
9666,Jontray Harris,2017,2019,Total,Total,69,1235,116,288,65,136,51,152,63,87,50,145,195,82,17,5,55,94,346
9667,Justin McFadden,2015,2017,Binghamton,AEC,65,1528,94,246,67,155,27,91,131,180,66,161,227,84,48,27,99,170,346
9668,Rob Montgomery,2019,2019,Central Michigan,MAC,32,897,128,291,107,222,21,69,69,116,50,132,182,24,27,29,41,97,346
9669,Lourawls Nairn,2015,2018,Michigan State,Big Ten,137,2666,136,344,113,265,23,79,51,102,12,200,212,415,42,8,130,217,346
9670,Troy Payne,2010,2011,Santa Clara,WCC,70,1716,127,287,127,277,0,10,92,158,159,252,411,91,111,32,103,161,346
9671,Hunter Vick,2019,2019,Tennessee Tech,OVC,31,1008,119,300,65,164,54,136,54,65,26,91,117,64,31,20,62,60,346
9672,Neftali Alvarez,2019,2019,Fairfield,MAAC,30,961,135,326,105,215,30,111,45,73,17,94,111,98,42,2,93,60,345
9673,Saleik Edwards,2018,2019,Delaware State,MEAC,53,1104,115,388,44,144,71,244,44,61,25,95,120,44,29,2,65,81,345
9674,JoJo Fallas,2014,2017,Cornell,Ivy,100,1486,115,326,28,84,87,242,28,37,12,114,126,86,50,2,63,137,345
9675,Alex Floresca,2016,2019,San Diego,WCC,97,1378,119,233,107,195,12,38,95,148,70,157,227,78,23,15,96,229,345
9676,Michael Flowers,2008,2008,Wisconsin,Big Ten,36,1139,123,276,74,157,49,119,50,71,34,105,139,97,59,5,73,90,345
9677,Jerome Hunter,2011,2015,Total,Total,120,1810,139,296,138,293,1,3,66,110,109,262,371,44,45,62,98,257,345
9678,Tim Jarmusz,2008,2011,Wisconsin,Big Ten,122,2144,105,267,32,62,73,205,62,82,72,182,254,78,38,6,49,110,345
9679,Paul Johnson,2008,2009,La Salle,A-10,62,1547,119,278,111,240,8,38,99,138,117,164,281,96,71,22,79,123,345
9680,Derrick Jones Jr.,2016,2016,Nevada-Las Vegas,MWC,30,646,129,219,121,180,8,39,79,133,52,82,134,24,27,40,36,93,345
9681,Marvin Jones,2016,2017,Total,Total,62,1087,119,221,111,183,8,38,99,127,86,201,287,22,20,62,39,143,345
9682,Leek Leek,2013,2014,Campbell,Big South,59,1250,116,292,60,153,56,139,57,73,43,115,158,50,22,53,58,121,345
9683,Collin Mangrum,2009,2011,Total,Total,74,1332,123,316,67,127,56,189,43,58,17,133,150,77,46,10,69,148,345
9684,Caleb Morris,2017,2019,Air Force,MWC,64,1056,111,268,47,89,64,179,59,73,14,138,152,68,20,7,56,89,345
9685,Luka Radovic,2012,2016,South Carolina State,MEAC,123,1609,135,307,125,261,10,46,65,100,166,180,346,23,24,34,105,220,345
9686,Matt Samuels,2012,2012,Chicago State,GWC,30,861,118,295,100,227,18,68,91,149,39,60,99,56,33,2,85,69,345
9687,Keith Smith,2017,2018,Virginia Military Institute,Southern,59,1388,122,310,71,167,51,143,50,77,14,101,115,147,63,17,112,126,345
9688,Myles Turner,2015,2015,Texas,Big 12,34,755,117,257,100,195,17,62,94,112,44,178,222,20,10,89,47,82,345
9689,Jermaine Bishop,2016,2017,Saint Louis,A-10,36,852,118,302,74,172,44,130,64,75,8,71,79,104,26,5,77,54,344
9690,Jahir Cabeza,2017,2018,Savannah State,MEAC,59,1048,122,312,67,118,55,194,45,76,64,146,210,67,49,61,52,136,344
9691,Alex Davis,2014,2015,Fresno State,MWC,63,1551,121,254,119,243,2,11,100,159,96,143,239,39,38,94,95,214,344
9692,Malik Dime,2016,2017,Washington,Pac-12,54,1149,133,230,133,230,0,0,78,112,125,175,300,19,22,135,50,162,344
9693,Chester Frazier,2008,2009,Illinois,Big Ten,65,2165,117,303,66,144,51,159,59,100,76,237,313,286,71,14,144,116,344
9694,David Jackson,2009,2010,Louisiana Tech,WAC,66,1511,125,304,94,211,31,93,63,95,38,100,250,38,26,32,58,59,344
9695,Jernard Jarreau,2013,2016,Total,Total,71,1307,129,302,117,273,12,29,74,118,79,201,280,61,35,57,90,155,344
9696,Mike O'Donnell,2008,2008,Central Florida,CUSA,29,994,106,278,31,76,75,202,57,71,4,63,67,88,47,7,45,52,344
9697,Ruslan Pateev,2010,2013,Arizona State,Total,109,1292,143,270,143,270,0,0,58,98,96,157,253,53,23,84,89,167,344
9698,Tyler Relph,2008,2008,St. Bonaventure,A-10,29,938,103,235,40,87,63,148,75,80,16,62,78,112,25,0,85,69,344
9699,Briahn Smith,2011,2012,Fairleigh Dickinson,NEC,57,1206,116,357,54,154,62,203,50,70,32,107,139,43,39,6,50,88,344
9700,Andre Washington,2013,2017,Total,Total,100,1237,127,240,127,239,0,1,90,173,118,198,316,34,19,152,69,170,344
9701,Treshaad Williams,2016,2017,Morehead State,OVC,66,980,133,190,133,190,0,0,78,113,115,97,212,25,30,7,38,136,344
9702,Will Bell,2011,2012,Colorado State,MWC,61,999,120,231,120,231,0,0,103,132,52,110,162,23,12,30,64,130,343
9703,DeVince Boykins,2013,2016,Total,Total,115,1701,132,317,87,192,45,125,34,119,61,137,198,99,55,5,119,176,343
9704,Jayden Hodgson,2017,2019,Bradley,MVC,86,1705,109,287,47,121,62,166,63,84,19,117,136,122,52,2,112,151,343
9705,Von Julien,2016,2019,Total,Total,81,1918,117,305,67,158,50,147,59,86,13,125,138,225,52,1,133,132,343
9706,Jordan Lewis,2009,2012,Cal Poly,Big West,98,1655,138,300,122,247,16,53,51,73,92,108,200,72,39,25,73,219,343
9707,Tremell Murphy,2019,2019,Drake,MVC,33,873,131,260,115,221,16,39,65,108,59,144,203,55,23,15,67,81,343
9708,Roderick Perkins,2016,2017,Winthrop,Big South,48,915,119,299,53,113,66,186,39,61,39,84,123,48,30,13,45,67,343
9709,Mike'l Simms,2018,2019,Virginia Commonwealth,A-10,66,1098,122,327,60,117,62,210,37,51,32,101,133,59,35,5,45,81,343
9710,Ben Smith,2008,2010,Texas-Rio Grande Valley,Total,80,1239,112,355,22,50,90,305,29,44,15,102,117,97,58,12,67,118,343
9711,Alex Thomas,2016,2019,Towson,CAA,121,1700,135,289,133,282,2,7,71,116,169,213,382,37,38,84,84,277,343
9712,D.J. Ursery,2015,2017,Pacific,WCC,71,998,122,308,111,257,11,51,88,134,38,113,151,86,26,3,86,126,343
9713,Montell Watson,2008,2008,Elon,Southern,32,948,118,303,63,142,55,161,52,67,11,70,81,114,51,7,93,79,343
9714,D.J. Wilkins,2019,2019,Drake,MVC,31,1016,112,288,49,126,63,162,56,66,9,84,93,87,25,0,62,65,343
9715,Cornell Williams,2008,2009,Long Beach State,Big West,60,1211,129,310,75,156,54,154,31,54,67,143,210,45,27,8,58,134,343
9716,Nyika Williams,2010,2011,Pacific,Big West,66,806,138,239,138,239,0,0,67,116,72,123,195,11,26,30,56,91,343
9717,OG Anunoby,2016,2017,Indiana,Big Ten,50,868,134,238,107,164,27,74,47,90,70,107,177,41,48,47,54,85,342
9718,Josh Ayeni,2017,2018,St. Bonaventure,A-10,56,898,129,279,128,275,1,4,83,111,65,84,149,13,26,9,46,186,342
9719,Will Bond,2013,2014,Sam Houston State,Southland,69,1062,109,286,24,62,85,224,39,52,27,102,129,51,25,9,27,109,342
9720,Ben Brackney,2011,2014,Bucknell,Patriot,94,1065,109,268,37,105,72,163,52,59,32,125,157,28,12,0,40,85,342
9721,Terry Fields,2009,2010,Texas-San Antonio,Southland,43,1057,133,263,128,244,5,19,71,102,71,150,221,49,40,20,61,87,342
9722,Lamin Fulton,2012,2014,Total,Total,60,1228,118,328,47,115,71,213,35,49,10,57,67,72,43,1,82,102,342
9723,Andrew Garcia,2018,2019,Stony Brook,AEC,44,825,115,268,90,181,25,87,87,127,86,107,193,23,19,6,76,101,342
9724,Jonathan Heard,2008,2008,Cal State Northridge,Big West,30,817,133,260,123,227,10,33,66,119,65,101,166,49,41,9,61,63,342
9725,Denell Henderson,2014,2015,Oral Roberts,Total,48,887,126,250,122,235,4,15,86,127,79,121,200,32,14,54,80,145,342
9726,Albert Jackson,2008,2010,Georgia,SEC,89,1629,140,291,140,291,0,0,62,112,145,191,336,35,25,85,140,211,342
9727,Klayton Korver,2008,2008,Drake,MVC,33,890,111,300,28,57,83,243,37,43,34,96,130,38,23,3,23,66,342
9728,Steffon Mitchell,2018,2019,Boston College,ACC,61,1914,104,248,81,150,23,98,111,204,175,318,493,135,69,67,58,126,342
9729,Jon Nwannunu,2011,2013,North Carolina-Asheville,Big South,66,965,139,272,139,270,0,2,64,85,90,116,206,28,20,32,55,127,342
9730,Jonathan Peoples,2008,2010,Notre Dame,Big East,104,1459,122,301,72,164,50,137,48,66,71,117,188,125,40,11,81,87,342
9731,Laytwan Porter,2016,2017,Northern Illinois,MAC,61,1106,110,286,64,154,46,132,76,104,23,113,136,138,69,10,109,129,342
9732,Rusty Reigel,2015,2018,Davidson,A-10,107,1939,116,277,51,99,65,178,45,62,56,213,269,145,33,7,78,181,342
9733,Rashad Savage,2011,2012,Cal State Bakersfield,Ind,59,1538,135,265,135,265,0,0,72,124,220,247,467,34,36,29,66,146,342
9734,Ryan Silva,2008,2012,UC-Davis,Big West,78,1127,110,281,27,71,83,210,39,54,27,77,104,110,70,0,119,118,342
9735,Derrick Strings,2009,2011,UC-Irvine,Big West,75,978,119,324,47,131,72,193,32,39,18,75,93,40,15,7,42,82,342
9736,Travis Strong,2008,2008,East Tennessee State,A-Sun,32,682,99,246,26,63,73,183,71,86,11,59,70,24,41,3,28,54,342
9737,Malcolm White,2011,2012,Louisiana State,SEC,61,1044,134,293,134,293,0,0,74,130,83,141,224,18,18,44,76,134,342
9738,Will Adams,2014,2017,Presbyterian,Big South,103,1344,118,337,43,115,75,222,30,38,23,85,108,58,41,6,45,105,341
9739,Jeffrey Altidort,2017,2018,Bethune-Cookman,MEAC,56,1336,114,290,75,177,39,113,74,117,12,107,119,155,49,15,115,135,341
9740,Larry Brown,2012,2014,Winthrop,Big South,82,1401,147,306,147,302,0,4,47,99,131,203,334,29,68,57,89,220,341
9741,Jamal Coombs-McDaniel,2010,2011,Connecticut,Big East,75,1061,113,297,73,154,40,143,75,101,32,115,147,41,18,10,45,64,341
9742,Zion Cousins,2018,2019,Howard,MEAC,63,1812,137,304,131,282,6,22,61,104,141,310,451,43,30,69,53,169,341
9743,Darnell Cowart,2019,2019,Murray State,OVC,33,660,131,239,131,237,0,2,79,120,78,136,214,36,25,13,39,89,341
9744,Jaime Echenique,2019,2019,Wichita State,AAC,37,664,134,246,122,215,12,31,61,94,68,153,221,13,19,51,48,113,341
9745,Barkley Falkner,2008,2009,Sam Houston State,Southland,60,1187,118,232,111,211,7,21,98,154,108,199,307,44,32,16,75,127,341
9746,Amir Garrett,2012,2013,St. John's (NY),Big East,55,1254,124,279,117,249,7,30,86,157,97,133,230,51,45,17,73,120,341
9747,B.J. Gladden,2015,2018,Total,Total,89,1244,109,299,94,230,15,69,108,215,61,192,253,53,32,23,85,123,341
9748,Vincent James,2008,2008,North Carolina-Asheville,Big South,33,829,114,242,106,214,8,28,105,146,49,101,150,47,38,21,69,66,341
9749,Michael Javes,2012,2013,Little Rock,Sun Belt,62,1202,134,339,132,332,2,7,71,168,92,158,250,28,18,81,85,171,341
9750,Cedric Martin,2012,2013,Utah,Pac-12,61,1779,105,288,38,99,67,189,64,106,28,140,168,119,54,14,73,123,341
9751,John Peckinpaugh,2009,2012,Purdue-Fort Wayne,Summit,108,1970,127,313,101,222,26,91,61,98,89,217,306,133,52,11,114,287,341
9752,Kyson Rawls,2018,2019,Morgan State,MEAC,49,841,96,270,25,69,71,201,78,97,15,52,67,60,36,1,54,73,341
9753,Jarred Riley,2008,2009,Grambling,SWAC,53,1197,134,278,134,277,0,1,73,122,62,121,183,27,14,54,83,134,341
9754,Yankuba Sima,2016,2018,Total,Total,62,1158,139,287,138,284,1,3,62,135,111,150,261,45,33,93,71,167,341
9755,Bruno Skokna,2017,2019,Loyola (IL),MVC,102,1600,114,294,65,125,49,169,64,86,16,122,138,78,46,7,78,104,341
9756,Perry Webster,2011,2012,Cal State Fullerton,Big West,61,1494,104,272,55,142,49,130,84,123,22,122,144,255,54,9,98,145,341
9757,Jonathon Belt,2008,2009,Alabama A&M,SWAC,56,1090,124,257,124,253,0,4,92,144,78,142,220,35,24,8,75,142,340
9758,Kevin Bulger,2008,2010,Columbia,Ivy,84,1860,133,375,120,301,13,74,61,85,56,179,235,174,79,9,130,202,340
9759,Harrison Butler,2019,2019,Southern Utah,Big Sky,33,848,119,242,106,201,13,41,89,148,55,160,215,37,30,19,65,93,340
9760,Sincere Carry,2019,2019,Duquesne,A-10,28,938,116,267,82,159,34,108,74,103,16,85,101,161,68,6,83,53,340
9761,Tehran Cox,2010,2011,High Point,Big South,61,1452,111,343,87,254,24,89,94,132,29,116,145,190,59,8,155,143,340
9762,Farnold Degand,2008,2010,North Carolina State,ACC,63,1411,113,268,77,166,36,102,78,127,20,111,131,159,44,24,115,120,340
9763,Andre Drummond,2012,2012,Connecticut,Big East,34,967,157,292,157,290,0,2,26,88,114,143,257,15,28,92,52,75,340
9764,Julian Edmonson,2012,2014,Total,Total,40,587,104,258,61,149,43,109,89,121,15,43,58,30,22,2,54,63,340
9765,Bryan Hammond,2011,2012,Nicholls State,Southland,58,1316,131,315,107,213,24,102,54,94,19,95,114,120,26,2,80,67,340
9766,Nigel Hawkins,2019,2019,Texas-El Paso,CUSA,27,914,104,307,69,179,35,128,97,122,26,96,122,48,25,7,84,58,340
9767,Jarvis Hill,2009,2010,Louisiana-Monroe,Sun Belt,49,1146,114,274,85,183,29,91,83,113,23,77,100,54,45,1,91,113,340
9768,Cedrick Middleton,2008,2008,Akron,MAC,35,928,110,274,44,112,66,162,54,70,17,55,72,52,49,5,48,72,340
9769,Jacob Schulte,2015,2016,South Carolina Upstate,A-Sun,68,1218,140,225,140,224,0,1,60,131,114,99,213,34,27,53,51,128,340
9770,Eddie Stansberry,2019,2019,Hawaii,Big West,30,822,116,297,39,82,77,215,31,43,9,72,81,22,19,8,28,43,340
9771,Keon Williams,2016,2019,St. Francis (NY),NEC,103,1921,119,342,70,155,49,187,53,91,90,217,307,54,56,18,61,151,340
9772,Jason Wills,2008,2008,North Carolina A&T,MEAC,31,915,122,253,117,241,5,12,91,161,58,148,206,83,25,6,102,76,340
9773,Kieron Achara,2008,2008,Duquesne,A-10,30,573,109,205,90,153,19,52,102,125,38,83,121,27,16,45,44,75,339
9774,Ameer Bennett,2018,2019,Delaware State,MEAC,60,1176,118,288,112,254,6,34,97,152,77,120,197,23,19,25,98,152,339
9775,Rod Days,2012,2016,Total,Total,105,1523,115,300,66,130,49,170,60,99,62,166,228,58,52,25,69,126,339
9776,Nigel Jackson,2018,2019,Wagner,NEC,54,990,125,348,62,141,63,207,26,36,66,112,178,40,24,34,64,167,339
9777,Dave Neal,2008,2009,Maryland,ACC,57,1002,131,303,90,191,41,112,36,47,55,124,179,31,30,7,37,82,339
9778,Ty Nurse,2012,2013,Texas Tech,Big 12,59,1323,104,265,41,87,63,178,68,77,9,62,71,81,39,2,66,111,339
9779,Ny Redding,2015,2019,Total,Total,101,1654,90,247,64,157,26,90,133,160,21,115,136,202,43,3,120,185,339
9780,Kendall Stafford,2019,2019,North Alabama,A-Sun,32,1027,133,318,87,172,46,146,27,41,52,162,214,61,20,4,65,74,339
9781,Marcus Washington,2016,2017,Louisiana-Monroe,Sun Belt,53,937,126,294,108,222,18,72,69,95,44,110,154,78,34,15,71,107,339
9782,JaMarcus Weatherspoon,2015,2017,Total,Total,64,1093,118,276,116,261,2,15,101,152,67,119,186,38,31,15,69,119,339
9783,Thurgood Wynn,2011,2014,Navy,Patriot,102,1169,114,265,97,204,17,61,94,160,48,111,159,65,54,2,70,104,339
9784,Keith Benjamin,2008,2008,Pittsburgh,Big East,37,988,123,281,72,143,51,138,41,62,35,75,110,78,31,4,58,68,338
9785,Matt Betley,2008,2008,Lafayette,Patriot,30,843,116,246,68,125,48,121,58,88,59,114,173,52,28,6,64,79,338
9786,Cameron Butler,2010,2011,Southeast Missouri State,OVC,47,1168,114,225,114,224,0,1,110,186,90,174,264,25,27,35,95,154,338
9787,Qa'rraan Calhoun,2009,2009,Houston,CUSA,33,1026,130,279,88,159,42,120,36,61,58,117,175,36,23,36,36,68,338
9788,Cornelius Chatt,2011,2011,Southern Illinois-Edwardsville,Ind,28,766,118,290,68,137,50,153,52,75,14,52,66,64,27,1,66,41,338
9789,Keon Clergeot,2017,2019,Total,Total,58,969,102,255,58,132,44,123,90,115,18,72,90,69,21,2,57,90,338
9790,Caleb Forrest,2008,2009,Washington State,Pac-10,67,1169,136,272,131,258,5,14,61,73,63,114,177,39,19,25,39,114,338
9791,Tre Jones,2019,2019,Duke,ACC,36,1230,132,319,105,216,27,103,47,62,32,103,135,192,68,6,53,56,338
9792,Luke Kraus,2010,2013,Bowling Green State,MAC,96,1663,105,330,46,123,59,207,69,94,16,129,145,112,77,4,72,185,338
9793,Noah Locke,2019,2019,Florida,SEC,36,913,113,301,32,87,81,214,31,40,22,60,82,21,16,0,13,47,338
9794,Mike Mercer,2009,2010,South Florida,Big East,37,1069,141,322,130,259,11,63,45,73,49,106,155,54,50,11,54,64,338
9795,Chris Miller,2017,2019,Oral Roberts,Summit,73,810,148,267,148,267,0,0,42,67,74,94,168,16,12,22,83,197,338
9796,Noah Vonleh,2014,2014,Indiana,Big Ten,30,794,113,216,97,183,16,33,96,134,71,198,269,18,26,41,64,81,338
9797,Caleb Willis,2010,2013,Pepperdine,WCC,91,1771,112,269,83,183,29,86,85,127,62,141,203,224,54,6,123,159,338
9798,Payton Willis,2017,2018,Vanderbilt,SEC,66,1187,110,280,47,91,63,189,55,86,23,99,122,108,30,9,85,76,338
9799,Marcellous Bell,2013,2016,Jacksonville,A-Sun,78,876,104,314,31,89,73,225,56,68,20,51,71,40,30,2,26,57,337
9800,Matt Bradley,2019,2019,University of California,Pac-12,31,880,109,264,59,158,50,106,69,87,28,83,111,63,27,11,58,84,337
9801,Steven Burrough,2014,2016,North Carolina A&T,MEAC,91,1400,123,235,123,235,0,0,91,162,78,152,230,25,19,108,71,212,337
9802,Aaron Dotson,2010,2013,Total,Total,71,1464,103,289,72,177,31,112,100,154,39,109,148,94,34,21,107,160,337
9803,Will Goff,2015,2018,Boston University,Patriot,93,1500,105,258,19,44,86,214,41,60,21,90,111,60,37,10,58,94,337
9804,Cory Hightower,2019,2019,Presbyterian,Big South,36,880,125,264,113,229,12,35,75,100,54,172,226,70,28,22,59,93,337
9805,Quentin Jones,2012,2014,Maryland-Baltimore County,AEC,69,1522,111,301,60,170,51,131,64,92,49,90,139,123,46,2,100,167,337
9806,Philip Martin,2008,2010,Radford,Big South,84,1596,128,272,111,210,17,62,64,120,92,145,237,100,32,26,111,213,337
9807,Elridge Moore,2011,2014,Total,Total,90,1936,129,311,128,298,1,13,78,143,121,181,302,103,65,37,132,232,337
9808,Kylan Phillips,2016,2018,Mississippi Valley State,SWAC,84,1926,121,427,84,283,37,144,58,83,28,132,160,142,73,2,110,146,337
9809,Chris Smith,2018,2019,UCLA,Pac-12,66,1078,122,292,101,207,21,85,72,110,35,149,184,61,22,15,84,94,337
9810,Jeremis Smith,2008,2008,Georgia Tech,ACC,32,848,116,212,115,205,1,7,104,159,78,149,227,61,45,12,52,91,337
9811,Ronald Spencer,2010,2013,Total,Total,57,1295,123,268,123,267,0,1,91,157,155,189,344,16,12,65,73,157,337
9812,Daquan Brickhouse,2014,2015,Coppin State,MEAC,48,1002,99,280,62,175,37,105,101,119,35,75,110,112,48,1,51,56,336
9813,Zane Gay,2008,2009,Eastern Michigan,MAC,56,1029,116,281,64,120,52,161,52,83,48,102,150,60,28,19,63,85,336
9814,Casey Harriman,2008,2011,Creighton,MVC,104,1476,103,262,35,71,68,191,62,90,97,145,242,58,47,6,53,135,336
9815,Shawndale Jones,2018,2019,NJIT,A-Sun,65,1015,118,272,83,175,35,97,65,91,41,120,161,49,28,4,46,60,336
9816,Haralds Karlis,2012,2015,Seton Hall,Big East,120,1806,108,293,44,85,64,208,56,83,48,134,182,85,42,13,78,160,336
9817,Jeremy Lieberman,2015,2017,Wyoming,MWC,94,1737,120,323,61,127,59,196,37,49,21,137,158,155,53,3,93,169,336
9818,T.J. Lindsay,2012,2013,Southern Illinois,MVC,62,1287,123,314,62,147,61,167,29,46,25,94,119,78,46,3,64,103,336
9819,Cameron Monroe,2012,2015,Southern,SWAC,124,1678,123,331,114,289,9,42,81,131,42,114,156,100,61,7,141,245,336
9820,Grayson Murphy,2018,2019,Belmont,OVC,37,1034,141,289,114,207,27,82,27,49,24,128,152,221,55,4,86,78,336
9821,Brian Pfohl,2008,2008,Mercer,A-Sun,30,829,141,249,141,249,0,0,54,104,77,91,168,29,17,17,65,81,336
9822,Assane Sene,2009,2012,Virginia,ACC,95,1749,128,278,128,278,0,0,80,144,146,279,425,19,20,108,84,253,336
9823,BJ Shearry,2011,2012,UC-Riverside,Big West,60,1407,135,314,135,311,0,3,66,118,110,166,276,47,68,103,71,166,336
9824,ShunQuez Stephens,2014,2015,South Carolina Upstate,A-Sun,67,1203,123,296,94,181,29,115,61,89,93,231,324,60,42,15,62,145,336
9825,Mario Telfair,2008,2009,Troy,Sun Belt,57,910,121,221,121,219,0,2,94,149,85,122,207,13,28,14,52,120,336
9826,Jordan Watkins,2015,2018,Davidson,A-10,95,1345,106,282,29,72,77,210,47,62,32,105,137,80,33,3,54,108,336
9827,Rashad Williams,2019,2019,Cleveland State,Horizon,31,726,111,274,20,51,91,223,23,30,3,54,57,23,18,1,39,48,336
9828,Anthony Criswell,2011,2014,Total,Total,80,1268,129,283,120,251,9,32,68,97,115,204,319,38,21,9,62,189,335
9829,Brandon Dowdy,2009,2010,UC-Riverside,Big West,55,1147,123,333,59,144,64,189,25,36,17,92,109,49,46,5,39,64,335
9830,Chris Gaynor,2008,2008,Winthrop,Big South,34,1120,110,250,44,98,66,152,49,81,14,105,119,140,97,4,56,52,335
9831,Jaron Griffin,2008,2009,Rutgers,Big East,58,1063,119,341,62,158,57,183,40,52,46,92,138,28,20,11,54,60,335
9832,Brice Kofane,2012,2015,Total,Total,111,1672,124,248,124,248,0,0,87,157,150,245,395,29,31,125,123,253,335
9833,Lawson Korita,2017,2019,Tulsa,AAC,88,1474,113,320,54,122,59,198,50,70,32,141,173,84,32,1,50,66,335
9834,Travion Leonard,2013,2014,Fordham,A-10,62,1019,141,300,141,298,0,2,53,97,124,141,265,19,27,38,82,179,335
9835,Joseph Lewis,2016,2018,Delaware State,MEAC,85,1228,135,368,120,307,15,61,50,91,50,202,252,71,35,33,123,171,335
9836,Brandon Moore,2009,2013,Total,Total,98,1769,124,274,120,257,4,17,83,116,125,232,357,51,62,127,94,166,335
9837,Eric Obeysekere,2010,2013,Holy Cross,Patriot,91,1549,135,293,133,281,2,12,63,99,120,316,436,49,32,123,85,158,335
9838,Nick Richards,2018,2019,Kentucky,SEC,74,989,118,194,118,194,0,0,99,140,112,173,285,16,7,80,52,152,335
9839,Sammy Schickel,2010,2012,NJIT,GWC,88,1121,124,326,58,127,66,199,21,30,37,138,175,53,14,9,65,105,335
9840,William Tinsley,2018,2019,Illinois State,MVC,64,1526,124,340,46,87,78,253,9,19,50,253,303,46,28,57,43,119,335
9841,Marcus Zegarowski,2019,2019,Creighton,Big East,32,915,112,247,52,106,60,141,51,66,16,84,100,108,30,1,57,61,335
9842,Marques Bolden,2017,2019,Duke,ACC,88,1195,130,227,130,220,0,7,74,108,120,166,286,35,30,93,52,145,334
9843,John Boyer,2008,2010,Buffalo,MAC,81,1744,98,281,26,64,72,217,66,92,25,197,222,237,58,4,87,115,334
9844,Corey Brown,2016,2018,Northern Arizona,Big Sky,82,1015,135,231,135,230,0,1,64,117,77,132,209,16,27,20,66,192,334
9845,Chris Cyprian,2008,2009,Southeastern Louisiana,Southland,44,1077,120,299,76,148,44,151,50,75,31,98,129,98,55,7,92,122,334
9846,Darren Hopkins,2008,2008,Lamar,Southland,30,866,115,277,69,153,46,124,58,89,42,93,135,69,24,2,59,67,334
9847,Elijah Mayes,2018,2018,Florida A&M,MEAC,30,885,130,270,100,203,30,67,44,51,8,55,63,85,27,0,53,78,334
9848,Brandon Mitchell,2014,2018,San Jose State,MWC,97,1452,117,298,100,233,17,65,83,134,113,228,341,29,54,46,84,205,334
9849,Scott Morrison,2008,2008,Portland State,Big Sky,32,761,123,214,123,214,0,0,88,139,73,114,187,34,22,53,37,52,334
9850,Oto Osenieks,2012,2014,Minnesota,Big Ten,96,1231,122,308,96,197,26,111,64,102,62,135,197,67,40,23,74,127,334
9851,Larry Owens,2018,2019,Northwestern State,Southland,59,911,138,277,138,275,0,2,58,118,68,153,221,17,25,29,82,92,334
9852,Manny Patterson,2018,2019,Green Bay,Horizon,63,964,122,253,122,251,0,2,90,131,92,180,272,25,28,34,55,152,334
9853,Ronnie Thomas,2008,2010,Wright State,Horizon,89,1357,134,300,105,206,29,94,37,65,62,138,200,38,19,25,75,183,334
9854,Christopher Walker,2010,2011,Florida A&M,MEAC,52,1087,121,288,101,208,20,80,72,118,82,170,252,50,35,24,74,106,334
9855,Ricky Boyles,2009,2010,Texas Southern,SWAC,53,940,138,239,138,238,0,1,57,90,95,125,220,16,27,24,76,153,333
9856,Chas Brown,2017,2018,Total,Total,45,935,131,265,129,261,2,4,69,138,102,139,241,30,25,32,90,158,333
9857,James Butler,2017,2019,Total,Total,36,881,133,223,131,216,2,7,65,91,93,173,266,17,11,16,32,88,333
9858,Ty Gadsden,2019,2019,North Carolina-Wilmington,CAA,29,728,91,204,25,65,66,139,85,98,12,28,40,67,24,2,31,70,333
9859,Gary Gibson,2008,2010,Eastern Washington,Big Sky,82,1693,111,293,71,147,40,146,71,101,22,121,143,150,67,1,110,155,333
9860,Jerome Hairston,2013,2014,Towson,CAA,36,1007,121,316,81,193,40,123,51,70,8,58,66,86,39,2,91,69,333
9861,Mike Hornbuckle,2008,2009,Pepperdine,WCC,64,1332,123,309,66,148,57,161,30,50,52,123,175,75,55,7,74,82,333
9862,Ray Kraemer,2008,2010,Nevada,WAC,96,1144,108,239,26,56,82,183,35,46,35,103,138,38,25,18,36,108,333
9863,Seth LeDay,2017,2019,Total,Total,30,747,125,238,125,237,0,1,83,122,67,109,176,46,42,24,70,81,333
9864,Nikola Maric,2019,2019,Little Rock,Sun Belt,31,756,120,232,105,197,15,35,78,121,41,99,140,52,7,20,98,106,333
9865,Todd O'Brien,2008,2011,Total,Total,85,1371,132,295,132,295,0,0,69,118,121,238,359,31,43,76,105,179,333
9866,Kelly Oubre,2015,2015,Kansas,Big 12,36,756,110,248,76,153,34,95,79,110,41,138,179,28,41,13,43,71,333
9867,Faith Pope,2016,2017,Texas-Arlington,Sun Belt,70,817,127,257,106,182,21,75,58,92,58,136,194,39,30,32,42,97,333
9868,Brandon Rosser,2017,2018,UC-Riverside,Big West,60,1239,120,284,95,189,25,95,68,104,59,154,213,49,13,36,77,188,333
9869,David Singleton,2009,2010,High Point,Big South,60,1376,128,297,125,280,3,17,74,136,69,157,226,206,93,12,167,158,333
9870,Orlando Smith,2008,2011,Mississippi Valley State,SWAC,92,1342,126,260,126,255,0,5,81,146,107,190,297,36,33,4,86,167,333
9871,Julius Van Sauers,2016,2019,Long Island University,NEC,104,1693,99,259,58,137,41,122,94,127,104,223,327,75,34,24,95,246,333
9872,Alexis Dargenton,2017,2018,Utah State,MWC,61,1137,113,242,105,210,8,32,98,149,85,156,241,56,23,49,78,140,332
9873,Michael Dominguez,2009,2009,Florida International,Sun Belt,33,1087,105,273,29,71,76,202,46,58,30,92,122,78,39,6,61,82,332
9874,Ilker Er,2017,2018,Maine,AEC,39,737,120,344,62,147,58,197,34,48,39,107,146,16,12,2,30,95,332
9875,Gary Ervin,2008,2008,Arkansas,SEC,35,1015,113,261,92,189,21,72,85,122,28,64,92,134,42,4,75,62,332
9876,Justin Harris,2012,2015,Quinnipiac,Total,74,1112,118,295,117,276,1,19,95,129,116,157,273,32,12,43,63,90,332
9877,Noah Kirkwood,2019,2019,Harvard,Ivy,30,784,122,264,79,156,43,108,45,66,29,102,131,56,27,6,87,80,332
9878,Jefferson Mason,2008,2009,Northern Colorado,Big Sky,35,843,99,255,79,180,20,75,114,153,62,133,195,62,40,21,70,95,332
9879,Petey McClain,2013,2016,East Tennessee State,Total,124,2579,107,282,90,208,17,74,101,157,43,224,267,412,118,3,187,257,332
9880,Eric Pollitz,2008,2009,Miami (OH),MAC,59,1566,126,280,95,203,31,77,49,70,38,139,177,123,25,13,92,129,332
9881,Xavier Roberson,2010,2013,Total,Total,45,829,109,252,46,103,63,149,51,70,19,56,75,54,34,2,58,104,332
9882,Hayden Schenck,2016,2019,Utah Valley,WAC,73,1306,92,206,66,123,26,83,122,168,50,173,223,116,67,19,94,167,332
9883,Keyron Sheard,2008,2009,Chattanooga,Southern,60,1293,86,254,42,113,44,141,116,165,12,113,125,185,81,5,128,155,332
9884,Joe Thomas,2012,2015,Total,Total,125,1550,151,271,151,271,0,0,30,99,153,187,340,37,36,72,70,251,332
9885,Adam Thoseby,2012,2015,Total,Total,83,920,111,311,70,170,41,141,69,92,13,90,103,36,16,12,56,71,332
9886,James Washington,2016,2018,American,Patriot,72,1408,122,341,77,174,45,167,43,64,11,107,118,58,43,6,79,111,332
9887,Ta'Jon Welcome,2015,2016,Northwestern State,Southland,60,940,125,297,87,152,38,145,44,69,30,80,110,58,26,14,54,86,332
9888,Darian Adams,2018,2019,Troy,Sun Belt,62,1386,110,309,68,154,42,155,69,93,30,118,148,133,37,10,79,105,331
9889,Danny Berger,2012,2014,Utah State,Total,64,1239,108,282,61,138,47,144,68,87,40,136,176,105,21,5,60,102,331
9890,Ahman Fells,2012,2015,Illinois-Chicago,Horizon,87,1126,134,272,101,177,33,95,30,54,72,129,201,22,47,14,42,105,331
9891,Japhet Kadji,2015,2018,Total,Total,79,1062,118,297,70,153,48,144,47,63,55,164,219,26,30,16,53,153,331
9892,Jacob Ledoux,2017,2018,McNeese State,Southland,53,801,119,272,94,181,25,91,68,96,26,89,115,66,42,2,79,73,331
9893,Bryson Lockley,2016,2019,Total,Total,62,1470,108,297,107,288,1,9,114,176,123,196,319,79,32,43,96,138,331
9894,Todd Nelson,2012,2013,Southeastern Louisiana,Southland,55,967,107,290,29,69,78,221,39,65,12,54,66,34,20,3,52,58,331
9895,Aaron Simpson,2015,2016,DePaul,Big East,62,1262,110,291,46,122,64,169,47,69,33,112,145,85,35,5,65,123,331
9896,Chris Walker,2008,2010,Army,Patriot,87,1282,144,275,144,275,0,0,43,72,110,119,229,29,51,39,111,223,331
9897,Luke Worthington,2014,2019,Brigham Young,WCC,131,1516,123,258,123,258,0,0,85,146,101,154,255,37,38,13,61,302,331
9898,Daniel Alexander,2012,2015,Total,Total,58,1006,121,276,78,134,43,142,45,54,42,162,204,45,27,31,58,107,330
9899,Raymond Cody,2010,2011,Cal State Northridge,Big West,64,1181,110,302,74,183,36,119,74,95,39,101,140,62,54,9,76,148,330
9900,Darko Cohadarevic,2009,2010,Texas Tech,Big 12,60,1026,136,308,135,296,1,12,57,78,82,145,227,52,14,16,81,148,330
9901,Josh Duinker,2009,2012,Richmond,A-10,121,1128,126,290,96,189,30,101,48,80,44,139,183,67,22,14,66,110,330
9902,Jalen Dupree,2017,2018,Murray State,OVC,63,1042,111,213,111,213,0,0,108,174,119,132,251,12,15,50,58,166,330
9903,Richard Forbes,2008,2008,Binghamton,AEC,29,811,112,265,78,159,34,106,72,85,24,48,72,71,42,4,78,62,330
9904,Ty Gough,2008,2009,Texas State,Southland,59,868,126,287,126,284,0,3,78,130,105,169,274,25,17,18,88,157,330
9905,Demetrius Harris,2012,2013,Milwaukee,Horizon,51,950,121,259,120,253,1,6,87,202,83,120,203,22,36,38,90,111,330
9906,Corbin Kaufusi,2015,2017,Brigham Young,WCC,86,1225,119,203,119,203,0,0,92,156,125,184,309,13,26,80,80,233,330
9907,Ivan Madunic,2017,2019,Southern Utah,Big Sky,95,1444,111,307,48,112,63,195,45,68,85,247,332,38,27,81,65,154,330
9908,Noah McCarty,2017,2019,Northern Illinois,MAC,95,1271,128,292,112,229,16,63,58,92,80,185,265,51,33,31,80,196,330
9909,Noah Morgan,2018,2018,Fairleigh Dickinson,NEC,30,838,117,246,69,136,48,110,48,58,39,108,147,41,24,20,61,83,330
9910,Reggie Perry,2019,2019,Mississippi State,SEC,34,813,118,235,107,196,11,39,83,116,89,156,245,21,19,24,50,98,330
9911,Steve Peterson,2009,2010,Morehead State,OVC,67,1185,118,281,85,176,33,105,61,82,93,114,207,58,46,17,72,96,330
9912,Alex Rubin,2008,2011,Illinois State,MVC,105,1936,103,302,20,67,83,235,41,64,19,108,127,141,74,7,64,162,330
9913,Josh Sewell,2011,2013,Miami (OH),MAC,82,1084,114,277,63,146,51,131,51,74,46,64,110,34,24,8,72,75,330
9914,Avery Smith,2009,2009,Milwaukee,Horizon,29,872,125,315,102,237,23,78,57,87,46,106,152,91,34,9,72,82,330
9915,Gorkem Sonmez,2010,2011,Radford,Big South,52,934,115,327,51,138,64,189,36,67,16,80,96,40,27,11,82,94,330
9916,Ezra Talbert,2015,2018,Liberty,Big South,100,966,118,265,73,145,45,120,49,71,55,96,151,18,15,12,45,150,330
9917,Calvin Walls,2008,2008,Tulsa,CUSA,39,1121,123,265,123,259,0,6,84,129,99,181,280,58,28,27,70,110,330
9918,Colby Wohlleb,2009,2010,Georgia Southern,Southern,51,911,108,260,25,55,83,205,31,41,23,95,118,21,20,6,38,122,330
9919,Justin Banks,2011,2014,Alabama A&M,SWAC,92,1299,134,235,134,233,0,2,61,81,110,249,359,17,13,71,75,152,329
9920,JeJuan Brown,2009,2010,Arkansas State,Sun Belt,49,983,115,276,102,243,13,33,86,122,67,139,206,38,18,29,71,124,329
9921,Rocky Coleman,2008,2009,Towson,CAA,61,1009,108,284,75,177,33,107,80,134,34,88,122,77,29,4,56,70,329
9922,Roberto Colonette,2012,2013,Manhattan,MAAC,66,1186,112,242,108,226,4,16,101,155,139,123,262,37,45,50,79,142,329
9923,Tre Gray,2018,2019,Texas A&M-Corpus Christi,Southland,53,678,112,267,65,123,47,144,58,75,9,31,40,40,23,0,71,79,329
9924,Antwan Harrison,2008,2008,Coppin State,MEAC,36,846,112,242,108,218,4,24,101,140,28,55,83,33,33,8,71,108,329
9925,Joey Hauser,2019,2019,Marquette,Big East,34,992,106,237,61,131,45,106,72,91,30,150,180,82,12,3,70,94,329
9926,Sermaj Inge,2008,2009,Temple,A-10,64,1337,127,305,106,246,21,59,54,78,56,116,172,158,61,22,98,135,329
9927,Johnny McCants,2018,2019,New Mexico State,WAC,65,1081,135,218,125,185,10,33,49,107,119,175,294,34,26,48,56,125,329
9928,Trevor Morris,2008,2009,Idaho,WAC,49,1000,108,301,43,104,65,197,48,57,12,57,69,47,27,5,54,94,329
9929,Odera Nweke,2012,2015,NJIT,Total,94,1540,112,261,111,254,1,7,104,167,107,201,308,71,48,52,92,191,329
9930,Taevaunn Prince,2012,2013,South Dakota State,Summit,59,888,105,223,95,186,10,37,109,159,61,107,168,23,25,4,60,84,329
9931,Robert Allen,2019,2019,Samford,Southern,33,1058,124,261,101,178,23,83,57,87,70,203,273,49,28,30,64,87,328
9932,Kofi Andoh,2014,2017,Howard,MEAC,109,1561,90,247,81,208,9,39,139,192,57,154,211,60,51,8,94,150,328
9933,Mohamed Bah,2014,2017,Drexel,CAA,104,1578,125,230,125,226,0,4,78,126,122,245,367,32,28,45,61,203,328
9934,Cameron Bell,2011,2013,Florida International,Sun Belt,64,964,99,244,78,181,21,63,109,130,49,104,153,54,47,10,77,124,328
9935,Tyler Blount,2017,2018,Texas State,Sun Belt,68,1091,119,291,46,103,73,188,17,27,11,74,85,50,15,1,32,53,328
9936,John Clifford,2008,2009,Southern Utah,Summit,50,1082,118,199,118,199,0,0,92,123,98,201,299,32,26,17,67,135,328
9937,JR Coronado,2013,2014,Liberty,Big South,68,1437,130,244,130,244,0,0,68,132,158,309,467,34,20,43,66,141,328
9938,Michael Diggins,2018,2019,Illinois-Chicago,Horizon,68,1166,118,226,82,135,36,91,56,81,48,148,196,44,28,25,52,110,328
9939,Dezmon Harris,2008,2008,Weber State,Big Sky,30,835,103,246,57,143,46,103,76,92,9,46,55,66,20,0,76,68,328
9940,Earnest Jones,2008,2010,Southern,SWAC,42,909,95,228,79,179,16,49,122,185,79,133,212,27,20,9,71,120,328
9941,Jalyn Pennie,2015,2017,New Mexico State,WAC,86,1385,130,302,91,177,39,125,29,65,94,167,261,50,19,37,78,103,328
9942,Clint Robinson,2017,2018,Illinois-Chicago,Horizon,69,1039,93,181,93,178,0,3,142,192,141,179,320,14,17,66,65,165,328
9943,Harrison Smith,2008,2011,Total,Total,51,823,106,280,69,145,37,135,79,125,48,65,113,28,41,6,39,72,328
9944,Austin Thornton,2009,2012,Michigan State,Big Ten,131,1479,101,251,58,128,43,123,83,95,80,170,250,82,35,9,67,169,328
9945,Steve Weingarten,2009,2011,La Salle,A-10,75,1103,121,234,95,160,26,74,60,82,105,138,243,45,34,13,56,146,328
9946,Solomon Young,2017,2019,Iowa State,Big 12,60,1259,128,236,123,213,5,23,67,100,93,166,259,19,34,43,48,147,328
9947,Akoy Agau,2014,2019,Total,Total,100,1131,101,205,93,174,8,31,117,158,92,200,292,49,16,49,100,146,327
9948,Christian Agnew,2019,2019,North Alabama,A-Sun,29,765,115,294,89,197,26,97,71,107,21,68,89,31,33,4,65,90,327
9949,Keve Aluma,2018,2019,Wofford,Southern,68,1370,124,194,124,193,0,1,79,137,137,215,352,52,29,44,56,144,327
9950,Isaac Belton,2014,2017,Longwood,Big South,99,1073,105,310,68,149,37,161,80,107,30,107,137,46,37,11,61,144,327
9951,Tanveer Bhullar,2015,2018,Total,Total,90,1018,130,249,130,247,0,2,67,126,113,170,283,42,11,34,68,129,327
9952,Patrick Britton,2008,2008,Rice,CUSA,29,870,106,266,106,263,0,3,115,163,65,85,150,19,28,24,56,97,327
9953,Jonathan Dupre',2010,2011,Pepperdine,WCC,55,1057,126,308,92,211,34,97,41,57,46,129,175,22,15,20,52,117,327
9954,Lucas Eitel,2011,2014,Indiana State,MVC,120,1489,109,264,25,55,84,209,25,46,29,119,148,86,40,14,54,107,327
9955,Michael Gerrity,2008,2010,Total,Total,48,1297,104,264,81,192,23,72,96,138,6,91,97,170,34,8,83,84,327
9956,Zach Gordon,2013,2017,Cal Poly,Big West,124,1529,110,240,110,238,0,2,107,179,155,245,400,17,38,67,74,266,327
9957,Karl Harris,2016,2018,Total,Total,57,852,114,309,89,209,25,100,74,96,21,84,105,29,20,7,52,104,327
9958,Alfred Hollins,2018,2019,Oregon State,Pac-12,62,1087,112,261,86,170,26,91,77,121,57,140,197,52,36,16,70,127,327
9959,Darian Hooker,2013,2013,Campbell,Big South,32,944,111,285,69,149,42,136,63,83,10,50,60,56,42,3,57,61,327
9960,Theryn Hudson,2008,2010,Middle Tennessee,Sun Belt,47,947,138,216,138,216,0,0,51,97,81,127,208,17,13,34,64,143,327
9961,Adrease Jackson,2018,2019,Dartmouth,Ivy,48,751,118,268,77,151,41,117,50,67,51,158,209,23,14,23,46,79,327
9962,Elijah Jordan,2018,2019,New Hampshire,AEC,54,1221,119,332,66,174,53,158,36,59,23,90,113,143,15,10,86,89,327
9963,Adrian Joseph,2008,2008,Virginia,ACC,33,808,118,278,62,124,56,154,35,46,53,136,189,30,21,12,41,43,327
9964,Michal Kozak,2018,2019,Weber State,Big Sky,64,1421,114,246,83,146,31,100,68,84,58,226,284,58,21,45,65,146,327
9965,Cedric Latimer,2008,2010,Total,Total,60,986,114,268,62,131,52,137,47,69,49,81,130,51,16,10,69,125,327
9966,Mouhamed Lo,2008,2010,Toledo,MAC,80,1317,126,274,126,270,0,4,75,148,107,183,290,22,21,50,96,206,327
9967,Xavier Martin,2011,2012,High Point,Big South,62,1067,101,292,78,214,23,78,102,154,19,68,87,103,27,2,105,109,327
9968,Khalid Nwandu,2014,2017,Mount St. Mary's,NEC,120,1705,114,258,111,246,3,12,96,175,62,164,226,157,86,6,151,217,327
9969,Darryl Reynolds,2014,2017,Villanova,Big East,119,1634,120,179,120,179,0,0,87,138,126,272,398,38,36,67,79,181,327
9970,Brion Sanchious,2016,2019,Murray State,OVC,116,2183,136,232,136,232,0,0,55,116,134,232,366,50,49,65,93,254,327
9971,JD Wallace,2017,2018,Prairie View,SWAC,54,1438,131,197,131,194,0,3,65,116,126,239,365,15,44,67,42,134,327
9972,Percy Woods,2012,2012,Maryland-Eastern Shore,MEAC,30,998,108,299,71,166,37,133,74,107,13,64,77,96,50,2,100,57,327
9973,James Banks III,2019,2019,Georgia Tech,ACC,31,931,128,227,128,227,0,0,70,103,82,159,241,44,17,78,72,91,326
9974,Oumar Barry,2016,2019,Total,Total,59,1059,126,244,118,205,8,39,66,127,64,116,180,31,17,39,71,121,326
9975,David Beatty,2018,2019,Total,Total,60,1141,113,346,70,181,43,165,57,73,14,101,115,71,34,16,66,132,326
9976,Trevian Bell,2018,2019,Green Bay,Horizon,62,862,120,268,81,161,39,107,47,62,43,120,163,33,26,16,53,70,326
9977,Jalen Chapman,2015,2016,Western Illinois,Summit,53,924,128,276,128,276,0,0,70,121,61,144,205,25,48,38,74,138,326
9978,Jake Flaggert,2014,2018,Texas-El Paso,CUSA,122,2066,95,260,10,28,85,232,51,69,18,170,188,87,23,13,50,253,326
9979,Justas Furmanavicius,2017,2018,Mississippi,SEC,68,1439,106,230,83,160,23,70,91,143,118,159,277,50,41,60,51,164,326
9980,Larry Gurganious,2008,2010,Total,Total,54,1141,114,247,113,238,1,9,97,165,123,133,256,76,40,15,101,93,326
9981,Ben Harvey,2019,2019,Eastern Illinois,OVC,32,695,118,257,83,167,35,90,55,73,28,97,125,32,17,3,63,59,326
9982,Devarick Houston,2014,2015,Maryland-Baltimore County,AEC,59,1710,124,293,97,184,27,109,51,88,80,205,285,85,93,63,114,185,326
9983,Karl Madison,2012,2016,Drake,MVC,120,2238,101,311,77,224,24,87,100,147,20,130,150,258,65,2,170,202,326
9984,Justin Manns,2011,2012,Kent State,MAC,66,1131,136,225,136,224,0,1,54,97,96,187,283,16,24,59,44,135,326
9985,Matthew Mondesir,2018,2019,Central Arkansas,Southland,67,1251,119,290,99,228,20,62,68,124,52,122,174,109,40,8,71,97,326
9986,Jontay Porter,2018,2018,Missouri,SEC,33,808,104,238,64,128,40,110,78,104,50,174,224,74,28,55,63,97,326
9987,Keith Washington,2013,2014,Rice,CUSA,55,1200,110,323,79,207,31,116,75,111,15,104,119,128,35,1,125,84,326
9988,Matt Balkema,2010,2013,Eastern Michigan,MAC,106,1352,122,292,122,289,0,3,81,153,122,153,275,31,28,14,77,178,325
9989,Shamar Coombs,2009,2010,Texas A&M-Corpus Christi,Southland,55,1056,100,283,49,120,51,163,74,99,31,85,116,94,24,4,114,77,325
9990,Kelvin Downs,2013,2016,Arkansas State,Sun Belt,99,1419,126,283,125,277,1,6,72,110,69,159,228,28,21,53,106,221,325
9991,Amaurys Fermin,2012,2012,Cal Poly,Big West,33,976,117,308,80,194,37,114,54,79,14,50,64,119,22,1,75,49,325
9992,Matt Fox,2015,2018,Bowling Green State,MAC,96,1210,103,259,16,45,87,214,32,37,23,100,123,51,26,5,30,77,325
9993,Spencer Franklin,2018,2019,Longwood,Big South,62,1207,103,203,100,187,3,16,116,167,96,128,224,26,26,23,74,207,325
9994,Heath Hoffman,2011,2012,Sacramento State,Big Sky,55,1135,105,256,56,113,49,143,66,81,29,108,137,52,31,6,56,94,325
9995,Pat Magnarelli,2008,2010,Harvard,Ivy,39,836,133,228,133,228,0,0,59,84,64,127,191,28,25,26,44,68,325
9996,Auraum Nuiriankh,2011,2014,Buffalo,MAC,99,1525,101,313,52,127,49,186,74,102,65,200,265,98,32,18,104,184,325
9997,Orren Tims,2008,2010,Total,Total,60,940,127,304,121,262,6,42,65,98,70,114,184,22,26,6,91,108,325
9998,Luke Zeller,2008,2009,Notre Dame,Big East,69,917,120,293,50,98,70,195,15,26,58,114,172,36,19,14,25,104,325
9999,Danny Agbelese,2011,2012,Hampton,MEAC,66,1507,132,241,132,241,0,0,60,144,141,248,389,25,20,184,42,173,324
10000,Chris Berry,2008,2008,Saint Francis (PA),NEC,29,846,113,249,98,203,15,46,83,121,79,104,183,27,33,6,51,51,324
10001,Terrell Brown,2018,2019,Pittsburgh,ACC,64,1163,124,290,118,259,6,31,70,108,94,160,254,23,14,106,65,137,324
10002,Jalen Cobb,2019,2019,Fordham,A-10,32,943,111,292,71,171,40,121,62,85,12,77,89,71,46,12,63,81,324
10003,Eric Hamilton,2016,2019,Total,Total,83,845,114,220,108,197,6,23,90,139,70,156,226,8,12,23,43,114,324
10004,Bennett Holley,2016,2019,Appalachian State,Sun Belt,109,940,101,237,22,39,79,198,43,52,44,123,167,28,10,5,24,147,324
10005,Osa Izevbuwa,2015,2017,NJIT,Total,90,1153,118,316,64,151,54,165,34,52,39,89,128,46,34,1,60,86,324
10006,Shaun Johnson,2013,2016,McNeese State,Southland,105,1038,104,363,23,83,81,280,35,44,32,63,95,62,31,3,37,88,324
10007,Damien Leonard,2012,2013,South Carolina,SEC,59,1066,110,354,34,108,76,246,28,42,30,66,96,30,22,3,65,71,324
10008,Dante Milligan,2008,2008,Massachusetts,A-10,36,677,132,207,132,207,0,0,60,112,82,112,194,26,27,69,61,123,324
10009,DJ Mlachnik,2014,2016,Massachusetts-Lowell,AEC,69,1194,103,288,38,98,65,190,53,71,21,105,126,50,23,0,61,88,324
10010,DeVon Mosley,2008,2008,Dartmouth,Ivy,28,855,108,277,57,128,51,149,57,65,40,65,105,52,49,2,51,42,324
10011,Shane Nichols,2008,2008,Wofford,Southern,24,688,101,250,35,83,66,167,56,71,5,28,33,18,15,2,28,36,324
10012,Tyrone O'Garro,2013,2017,Total,Total,105,1773,132,270,132,268,0,2,60,135,149,278,427,73,52,21,105,251,324
10013,Gunnar Olafsson,2015,2018,St. Francis (NY),NEC,100,1684,126,309,79,139,47,170,25,50,93,170,263,44,42,10,73,169,324
10014,Adam Tanner,2008,2008,Denver,Sun Belt,30,1027,101,220,75,143,26,77,96,123,23,86,109,86,18,23,69,95,324
10015,Antonio Weary,2009,2011,Central Michigan,MAC,84,1760,115,274,99,214,16,60,78,142,106,151,257,102,67,18,125,265,324
10016,Troy Baxter,2017,2019,Total,Total,53,903,124,302,88,173,36,129,39,63,46,95,141,45,15,44,75,113,323
10017,Jaylen Butz,2018,2019,DePaul,Big East,57,1065,130,220,130,220,0,0,63,115,113,183,296,47,25,29,64,124,323
10018,Ryan Canty,2012,2016,Fordham,A-10,103,1267,138,259,138,259,0,0,47,108,185,282,467,15,23,76,59,227,323
10019,Jovan Crnic,2016,2017,Abilene Christian,Southland,44,1007,105,275,50,116,55,159,58,75,13,98,111,118,31,4,87,87,323
10020,Evan Cummins,2013,2016,Harvard,Ivy,87,1269,137,232,137,232,0,0,49,86,80,169,249,88,35,74,77,147,323
10021,Davide Curletti,2009,2012,Northwestern,Big Ten,108,1447,103,231,84,177,19,54,98,150,68,151,219,118,30,32,69,221,323
10022,DJ Draper,2017,2019,North Texas,CUSA,82,1302,100,240,15,35,85,205,38,53,14,78,92,54,39,2,36,120,323
10023,Rico Ferguson,2011,2012,Campbell,Total,59,1205,107,250,106,245,1,5,108,156,28,76,104,113,54,2,87,166,323
10024,Nate Hicks,2011,2015,Total,Total,113,1424,131,231,131,230,0,1,61,105,122,263,385,22,8,95,56,144,323
10025,David Onuorah,2014,2018,Total,Total,117,2128,130,260,129,257,1,3,62,147,194,273,467,32,51,131,131,329,323
10026,Koreem Ozier,2019,2019,Sacred Heart,NEC,23,653,109,288,65,158,44,130,61,81,16,91,107,35,18,1,46,65,323
10027,Sam Pearson,2008,2010,Total,OVC,63,1232,108,275,97,218,11,57,96,155,19,89,108,139,41,2,133,122,323
10028,Victor Scott,2010,2011,Chicago State,GWC,58,1338,110,330,41,97,69,233,34,60,35,124,159,69,32,4,82,125,323
10029,Kobi Simmons,2017,2017,Arizona,Pac-12,37,871,111,281,79,183,32,98,69,89,13,47,60,73,24,3,46,70,323
10030,Miryne Thomas,2018,2018,Maryland-Eastern Shore,MEAC,29,764,116,265,108,214,8,51,83,127,72,154,226,25,17,11,73,99,323
10031,Robert Tibbs,2009,2010,Southeastern Louisiana,Southland,58,995,101,199,83,146,18,53,103,145,67,97,164,52,39,13,73,104,323
10032,Tyson Batiste,2017,2019,Central Connecticut State,NEC,83,1952,133,310,104,233,29,77,27,80,42,171,213,208,57,12,134,203,322
10033,Christian Benzon,2014,2017,Evansville,MVC,112,1403,109,240,103,224,6,16,98,187,54,196,250,72,36,12,71,128,322
10034,DeAndre Bray,2008,2009,Jacksonville State,OVC,57,1642,107,275,47,120,60,155,48,63,25,90,115,323,92,1,126,134,322
10035,Bassirou Dieng,2008,2009,Total,Total,38,943,109,230,104,220,5,10,99,149,52,150,202,13,14,32,66,96,322
10036,Rob Giles,2008,2009,Ball State,MAC,52,1185,110,284,60,146,50,138,52,93,40,106,146,42,21,13,70,123,322
10037,Curtis Jones,2017,2019,Total,Total,63,954,110,326,47,131,63,195,39,58,20,103,123,57,27,5,40,53,322
10038,Joe Kasperzyk,2019,2019,Bryant,NEC,30,756,105,244,88,174,17,70,95,118,14,62,76,71,32,8,88,84,322
10039,Hunter Miller,2011,2014,Total,A-Sun,92,1755,95,262,48,124,47,138,85,117,24,158,182,189,50,3,121,144,322
10040,Christian Musoko,2017,2018,Southern Utah,Big Sky,61,921,122,244,122,243,0,1,78,132,82,156,238,19,10,33,71,196,322
10041,Jawan Nelson,2009,2011,Texas A&M-Corpus Christi,Southland,91,1048,122,304,93,210,29,94,49,71,42,91,133,29,7,14,98,179,322
10042,Dennis Tunstall,2017,2019,Towson,CAA,93,1545,141,223,139,218,2,5,38,73,172,270,442,28,47,79,38,165,322
10043,Sheryn Devonish-Prince Jr.,2019,2019,Morgan State,MEAC,30,837,104,301,88,242,16,59,97,112,17,47,64,67,29,1,63,76,321
10044,Richie Edwards,2012,2014,Total,Total,45,635,115,241,89,170,26,71,65,82,38,69,107,20,14,7,44,82,321
10045,Aaron Harwell,2011,2013,Total,Total,95,1736,108,301,92,230,16,71,89,149,15,159,174,214,103,6,164,188,321
10046,Chris Hines,2010,2011,Alabama,SEC,69,1686,129,267,128,263,1,4,62,111,122,236,358,60,85,76,103,195,321
10047,DeAngelo Jones,2008,2011,Total,Total,64,914,119,264,101,193,18,71,65,101,49,78,127,45,48,6,84,104,321
10048,DeVante Jones,2019,2019,Coastal Carolina,Sun Belt,23,686,107,232,72,128,35,104,72,86,19,71,90,83,31,1,52,52,321
10049,Steven Julian,2018,2019,Cornell,Ivy,59,1722,119,277,102,210,17,67,66,118,87,273,360,106,67,87,65,143,321
10050,Ron Manigault,2008,2009,Long Island University,NEC,60,1635,120,270,120,269,0,1,81,137,138,292,430,98,40,17,88,183,321
10051,Craig Sealey,2011,2014,Bowling Green State,MAC,97,1068,125,297,122,284,3,13,68,128,73,128,201,25,32,15,70,109,321
10052,Marcus Simmons,2008,2011,Southern California,Pac-10,105,1791,118,288,104,244,14,44,71,117,64,143,207,86,49,22,107,236,321
10053,Tobias Sjoberg,2017,2019,Marist,MAAC,90,1652,135,227,135,227,0,0,51,83,139,213,352,93,22,66,111,271,321
10054,Basil Smotherman,2014,2017,Purdue,Big Ten,84,1259,134,249,125,203,9,46,44,77,73,139,212,67,41,11,46,143,321
10055,Shaquille Stokes,2012,2013,Total,Total,37,800,99,311,56,176,43,135,80,106,7,47,54,84,28,2,73,54,321
10056,Justin Thomas,2017,2018,Northern Illinois,MAC,64,1389,115,252,93,181,22,71,69,116,16,129,145,98,76,5,60,90,321
10057,Darnell Wilks,2008,2011,Cincinnati,Big East,116,1194,121,260,88,166,33,94,46,85,86,121,207,75,44,37,88,190,321
10058,Jalil Abdul-Bassit,2014,2015,Oregon,Pac-12,52,805,110,261,44,107,66,154,34,46,20,50,70,29,25,12,40,89,320
10059,Leandro Allende,2017,2018,Citadel,Southern,65,1128,114,276,76,143,38,133,54,81,57,128,185,78,26,6,51,135,320
10060,Isiah Brown,2017,2018,Northwestern,Big Ten,60,789,102,292,76,199,26,93,90,113,15,49,64,71,28,7,64,96,320
10061,Roland Brown,2011,2014,Total,Total,70,1021,125,285,125,283,0,2,70,111,78,134,212,22,22,30,87,147,320
10062,Chris Bryant,2013,2016,Total,Total,75,1179,114,238,113,234,1,4,91,142,86,145,231,24,33,21,64,152,320
10063,Marcus Carr,2018,2018,Pittsburgh,ACC,32,916,106,268,70,160,36,108,72,88,8,82,90,129,20,4,88,70,320
10064,Trinity Fields,2009,2012,Iona,MAAC,112,1206,101,288,61,162,40,126,78,102,17,91,108,87,39,2,86,92,320
10065,Eric Flato,2008,2008,Yale,Ivy,27,862,104,285,43,105,61,180,51,63,6,40,46,70,36,2,75,37,320
10066,Jaxson Hayes,2019,2019,Texas,Big 12,32,747,123,169,123,169,0,0,74,100,56,104,160,9,19,71,29,107,320
10067,Shawn King,2008,2008,Oral Roberts,Summit,33,710,127,226,127,226,0,0,66,97,85,128,213,19,25,68,47,108,320
10068,Kodi Maduka,2011,2012,Tulsa,CUSA,62,1053,112,223,112,221,0,2,96,171,89,194,283,29,18,78,73,164,320
10069,Mike McChristian,2012,2013,Idaho,WAC,58,1153,121,254,78,140,43,114,35,51,54,132,186,108,55,11,59,80,320
10070,Levan Patsatsia,2008,2011,Total,Total,70,1139,114,285,81,176,33,109,59,101,70,130,200,67,35,13,59,88,320
10071,Darius Perry,2018,2019,Louisville,ACC,69,1053,99,246,49,104,50,142,72,86,11,78,89,104,35,3,79,131,320
10072,Leslee Smith,2012,2015,Total,Total,74,1128,126,261,120,238,6,23,62,107,101,190,291,52,60,40,97,167,320
10073,Travis Walton,2008,2009,Michigan State,Big Ten,74,1901,124,309,121,297,3,12,69,103,39,117,156,283,89,3,117,177,320
10074,Lucas Williamson,2018,2019,Loyola (IL),MVC,54,1247,102,224,42,79,60,145,56,84,25,155,180,65,56,15,51,112,320
10075,Renaldo Woolridge,2009,2013,Total,Total,113,1166,118,329,65,147,53,182,31,56,68,173,241,42,17,28,56,112,320
10076,Jordan Allard,2011,2013,North Dakota,Total,94,1439,121,311,110,254,11,57,66,128,97,201,298,40,32,52,78,181,319
10077,Dallas Anglin,2013,2016,Total,Total,32,738,95,231,65,136,30,95,99,121,7,60,67,60,28,1,65,63,319
10078,Derek Brown,2018,2019,Portland State,Big Sky,51,777,109,260,92,190,17,70,84,111,61,75,136,68,46,2,73,118,319
10079,Pete Brown,2008,2010,North Carolina-Greensboro,Southern,91,1510,124,284,124,284,0,0,71,114,109,148,257,35,28,75,79,169,319
10080,Simi Fajemisin,2012,2015,San Diego,WCC,131,1497,109,221,109,220,0,1,101,167,131,167,298,19,32,55,104,318,319
10081,Skyler Hogan,2019,2019,Southeast Missouri State,OVC,30,790,120,274,74,153,46,121,33,43,16,82,98,33,21,5,35,42,319
10082,Papa Ndao,2012,2016,Saint Joseph's,A-10,115,1383,107,275,35,70,72,205,33,44,40,163,203,71,34,35,86,168,319
10083,Jeff Pelage,2009,2012,Boston University,AEC,116,1594,126,268,126,267,0,1,67,154,161,280,441,20,42,67,111,252,319
10084,Henry Salter,2008,2008,Texas Christian,MWC,24,608,113,257,51,127,62,130,31,55,26,93,119,14,16,2,34,31,319
10085,Kyle Sharp,2008,2009,Montana,Big Sky,59,1081,125,231,114,196,11,35,58,85,78,185,263,34,31,33,48,132,319
10086,Anthony Wright,2017,2018,Cleveland State,Horizon,56,1095,124,253,99,172,25,81,46,62,80,164,244,62,49,18,61,94,319
10087,Dimitry Akanda-Coronel,2013,2014,Maine,AEC,39,704,113,290,78,177,35,113,57,93,21,66,87,43,35,7,64,69,318
10088,Terrell Brown,2014,2015,Montana State,Big Sky,59,1089,102,269,73,180,29,89,85,99,37,93,130,38,31,4,46,111,318
10089,Boubacar Coly,2008,2008,Morgan State,MEAC,33,1125,119,229,119,229,0,0,80,116,108,253,361,23,29,84,77,99,318
10090,Stephen DuCharme,2008,2008,Utah State,WAC,34,788,125,216,124,203,1,13,67,90,36,134,170,27,12,11,48,55,318
10091,Kessler Edwards,2019,2019,Pepperdine,WCC,32,912,114,256,65,128,49,128,41,58,37,139,176,31,38,32,45,74,318
10092,Elyjah Goss,2018,2019,IUPUI,Horizon,61,1122,120,243,109,206,11,37,67,93,99,203,302,35,31,35,48,97,318
10093,Damontre Harris,2011,2012,South Carolina,SEC,60,1294,130,233,130,231,0,2,58,78,122,153,275,28,43,97,59,147,318
10094,Jermyl Jackson-Wilson,2008,2009,Colorado,Big 12,63,1248,130,263,130,260,0,3,58,99,85,174,259,72,44,46,98,188,318
10095,Marcus Johnson,2009,2010,Southern California,Pac-10,44,1084,127,323,115,280,12,43,52,105,29,128,157,53,54,17,95,111,318
10096,Andrew McAuliffe,2014,2017,Davidson,Total,120,1323,147,262,146,253,1,9,23,72,80,169,249,50,25,27,77,210,318
10097,Liam McInerney,2010,2013,Stetson,A-Sun,119,1988,116,288,86,193,30,95,56,92,140,204,344,90,58,35,100,228,318
10098,Brock Miller,2018,2019,Utah State,MWC,40,998,107,287,28,70,79,217,25,28,16,52,68,44,13,3,29,64,318
10099,Markus Mitchell,2008,2009,Mount St. Mary's,NEC,67,1575,137,253,137,253,0,0,44,75,130,251,381,91,75,43,104,206,318
10100,Eric Norman,2012,2015,Total,Total,87,1441,112,312,67,153,45,159,49,69,94,260,354,90,38,77,90,142,318
10101,Efe Odigie,2019,2019,Texas-El Paso,CUSA,25,682,117,242,117,241,0,1,84,122,67,185,252,13,15,13,76,75,318
10102,Djero Riedewald,2008,2009,Tennessee-Martin,OVC,62,1348,125,217,125,217,0,0,68,106,134,141,275,34,22,25,48,140,318
10103,Cody Stetler,2014,2017,Houston Baptist,Southland,101,1029,119,273,116,260,3,13,77,120,79,157,236,50,17,40,67,191,318
10104,Devon Thomas,2014,2017,Total,Total,96,1547,122,266,110,211,12,55,62,104,25,125,150,176,63,7,92,137,318
10105,Courtney Wallace,2008,2011,Louisiana,Sun Belt,72,1064,118,226,118,225,0,1,82,141,77,123,200,19,21,27,67,142,318
10106,Collin Welp,2019,2019,UC-Irvine,Big West,37,591,131,256,109,194,22,62,34,46,40,118,158,25,15,10,39,56,318
10107,Donte Williams,2015,2015,Utah Valley,WAC,30,809,91,253,49,112,42,141,94,116,1,79,80,47,13,8,50,55,318
10108,Dedric Boyd,2018,2018,Eastern Kentucky,OVC,24,651,104,294,70,173,34,121,75,90,14,65,79,48,22,2,60,48,317
10109,Justin Colvin,2013,2016,Alabama A&M,SWAC,84,1043,104,311,48,126,56,185,53,87,23,62,85,53,28,3,68,90,317
10110,Kennedy Edwards,2015,2017,Army,Patriot,61,884,117,285,88,171,29,114,54,95,76,144,220,32,31,22,64,100,317
10111,Kaylin Johnson,2009,2012,Samford,Southern,90,1326,107,276,53,113,54,163,49,69,16,109,125,61,29,2,93,120,317
10112,Jason Massey,2015,2018,Brown,Ivy,84,1175,122,249,113,217,9,32,64,113,58,142,200,59,25,7,62,131,317
10113,Devin McDonald,2010,2011,Total,Total,50,1099,102,266,50,128,52,138,61,82,18,59,77,70,35,1,98,124,317
10114,Avery Patterson,2015,2018,Total,Total,75,1129,104,274,60,128,44,146,65,89,29,86,115,110,43,1,109,110,317
10115,Jakub Petras,2015,2018,Stony Brook,AEC,113,1192,129,256,128,255,1,1,58,104,121,129,250,40,28,33,51,149,317
10116,Franklin Session,2010,2010,Weber State,Big Sky,31,948,122,274,105,200,17,74,56,111,81,100,181,83,55,28,81,95,317
10117,Sam Singh,2008,2010,Bradley,MVC,98,1353,122,230,122,230,0,0,73,103,101,172,273,48,45,35,94,189,317
10118,Sid Tomes,2017,2019,Air Force,MWC,78,1430,111,318,48,98,63,220,32,49,14,144,158,121,45,7,57,118,317
10119,Phil Wait,2009,2012,Total,Total,72,1049,133,265,133,264,0,1,51,112,85,140,225,16,9,37,84,114,317
10120,Robert Wilson,2009,2012,Wisconsin,Big Ten,117,1170,108,254,71,135,37,119,64,87,43,96,139,47,22,7,51,93,317
10121,Kenneth Averette,2008,2010,Louisiana-Monroe,Sun Belt,68,1398,98,255,67,162,31,93,89,118,13,72,85,158,57,0,116,91,316
10122,Jason Averkamp,2008,2010,Milwaukee,Horizon,82,1070,95,220,71,129,24,91,102,133,82,135,217,34,16,20,42,113,316
10123,Corey Butler,2008,2009,Georgia,SEC,66,1378,93,230,45,103,48,127,82,112,61,142,203,80,56,4,71,120,316
10124,Jeremy Campbell,2011,2014,Southeastern Louisiana,Southland,80,1290,115,303,107,261,8,42,78,132,35,111,146,55,30,17,79,80,316
10125,Joel Davis,2016,2019,Cornell,Ivy,90,1150,106,285,84,205,22,80,82,131,50,123,173,69,50,26,76,109,316
10126,DJ Funderburk,2019,2019,North Carolina State,ACC,36,716,107,194,100,168,7,26,95,121,75,77,152,16,19,38,36,105,316
10127,Adam Gore,2008,2009,Cornell,Ivy,41,865,90,211,24,50,66,161,70,76,15,51,66,47,34,0,32,69,316
10128,Dane Johnson,2008,2009,Hofstra,CAA,60,1090,125,234,125,234,0,0,66,118,105,198,303,13,17,89,73,141,316
10129,Tajion Jones,2019,2019,North Carolina-Asheville,Big South,31,982,120,298,75,136,45,162,31,45,35,64,99,37,35,9,52,44,316
10130,Luka Kamber,2014,2017,Total,Total,82,1245,106,313,29,66,77,247,27,39,38,109,147,50,32,9,69,138,316
10131,Bronson Kessinger,2017,2019,Indiana State,MVC,87,1099,135,305,128,276,7,29,39,78,79,129,208,25,36,23,45,159,316
10132,Sandi Marcius,2011,2014,Total,Total,108,1200,120,219,120,219,0,0,76,126,129,180,309,17,27,56,89,178,316
10133,Matt Martin,2008,2008,Montana,Big Sky,29,679,99,235,34,67,65,168,53,71,12,46,58,77,18,1,40,50,316
10134,Michael Nuga,2019,2019,Portland State,Big Sky,30,603,117,264,68,121,49,143,33,46,24,60,84,27,13,2,38,48,316
10135,Charles Winborne,2010,2012,Total,Total,35,754,113,250,55,118,58,132,32,44,10,51,61,46,15,1,42,27,316
10136,Trevor Wiseman,2011,2012,Hawaii,WAC,61,1281,107,206,105,200,2,6,100,138,99,159,258,60,45,3,89,141,316
10137,Akini Akini,2008,2008,Florida A&M,MEAC,32,,123,252,123,248,0,4,69,113,74,129,203,17,11,30,64,103,315
10138,James Baker,2018,2019,Morehead State,OVC,57,1063,114,252,72,141,42,111,45,67,57,134,191,19,15,62,46,126,315
10139,Tervell Beck,2018,2019,Nevada-Las Vegas,MWC,51,751,114,200,102,162,12,38,75,122,49,66,115,22,13,10,57,79,315
10140,RaShad Coleman,2009,2010,Charlotte,A-10,48,969,124,305,87,144,37,161,30,48,64,76,140,72,34,8,64,51,315
10141,Isaiah Gable,2018,2019,Southeast Missouri State,OVC,46,892,107,239,43,76,64,163,37,49,21,102,123,40,11,6,38,78,315
10142,Anthony Gatlin,2008,2012,Total,Total,76,128,123,274,88,185,35,89,34,49,4,14,162,29,23,27,62,20,315
10143,DJ Haley,2011,2014,Total,Total,133,1561,135,247,135,247,0,0,45,110,142,221,363,17,36,76,63,249,315
10144,Brian Henderson,2008,2008,Old Dominion,CAA,33,818,110,271,51,107,59,164,36,43,26,55,81,47,28,7,35,62,315
10145,Damien Jefferson,2017,2019,Total,Total,55,904,121,251,98,175,23,76,50,90,38,135,173,50,22,6,58,84,315
10146,Theo John,2018,2019,Marquette,Big East,67,1060,126,214,126,214,0,0,63,125,88,153,241,24,21,96,76,207,315
10147,Greg Parham,2018,2019,Virginia Military Institute,Southern,61,1136,118,317,69,152,49,165,30,46,14,90,104,116,43,2,62,76,315
10148,Edwin Santiago,2008,2011,Delaware,CAA,102,1208,111,334,78,201,33,133,60,92,42,77,119,58,61,6,103,156,315
10149,Terrance Syon,2014,2015,New Orleans,Southland,54,1100,117,237,117,236,0,1,81,152,114,156,270,27,29,29,78,162,315
10150,Drew Wiley,2009,2012,Total,Total,74,959,106,273,24,60,82,213,21,32,40,79,119,36,14,14,43,96,315
10151,Daivien Williamson,2019,2019,East Tennessee State,Southern,33,731,109,213,82,143,27,70,70,85,10,55,65,81,18,1,44,34,315
10152,Jerrah Young,2008,2008,Toledo,MAC,30,923,117,240,117,240,0,0,81,132,79,115,194,22,36,43,65,104,315
10153,Dennis Ashley,2017,2019,Maine,AEC,85,1020,102,301,39,109,63,192,47,69,15,67,82,59,24,0,47,76,314
10154,Jarred Axon,2008,2008,Eastern Michigan,MAC,31,687,99,262,34,94,65,168,51,60,20,43,63,52,21,2,38,42,314
10155,Ezekiel Balogun,2017,2019,Total,Total,64,663,125,236,102,172,23,64,41,79,78,135,213,21,35,32,68,97,314
10156,Cason Burk,2009,2011,Jackson State,SWAC,97,2182,101,241,84,184,17,57,95,163,169,261,430,145,76,18,105,273,314
10157,Marcus Dove,2008,2008,Oklahoma State,Big 12,33,1118,113,261,87,178,26,83,62,95,62,125,187,41,62,37,57,105,314
10158,Will Ginn,2008,2008,Jacksonville State,OVC,29,922,105,277,35,86,70,191,34,41,10,60,70,83,14,0,61,51,314
10159,Jermaine Jackson Jr.,2018,2018,Detroit Mercy,Horizon,30,893,102,301,49,122,53,179,57,67,15,76,91,80,34,3,54,54,314
10160,C.J. Jones,2018,2019,Northwestern State,Southland,55,1351,99,305,73,198,26,107,90,126,9,63,72,106,32,1,93,100,314
10161,El Hadji Ndieguene,2013,2014,Coastal Carolina,Big South,60,1563,123,275,123,275,0,0,68,110,148,263,411,37,30,20,84,163,314
10162,Alex Ramon,2013,2016,Colgate,Patriot,85,1217,110,230,67,121,43,109,51,73,37,107,144,77,40,6,78,129,314
10163,Monty Sanders,2008,2009,Elon,Southern,58,956,121,281,94,213,27,68,45,73,56,111,167,47,31,19,77,112,314
10164,LaRon Smith,2013,2017,Total,Total,80,1220,137,242,137,242,0,0,40,107,129,170,299,25,22,129,61,173,314
10165,Charles Thomas,2008,2008,Arkansas,SEC,34,731,113,216,108,203,5,13,83,114,56,96,152,47,16,6,76,97,314
10166,Jake Troyli,2011,2011,Presbyterian,Big South,30,792,111,263,96,222,15,41,77,89,33,91,124,12,10,15,47,64,314
10167,Ben Wheeler,2008,2011,Lafayette,Patriot,110,1612,114,324,51,127,63,197,23,38,41,167,208,189,66,7,132,124,314
10168,Michael Williams,2014,2017,Texas Christian,Big 12,103,1515,103,293,61,159,42,134,66,96,18,110,128,123,34,3,73,105,314
10169,Tiegbe Bamba,2015,2015,Portland State,Big Sky,27,822,111,202,97,163,14,39,77,112,52,131,183,30,33,5,46,66,313
10170,Joel Embiid,2014,2014,Kansas,Big 12,28,647,107,171,106,166,1,5,98,143,65,162,227,38,25,72,66,94,313
10171,Kelvin Grady,2008,2009,Michigan,Big Ten,64,1356,104,267,41,92,63,175,42,54,26,78,104,150,33,2,66,66,313
10172,Jaalam Hill,2019,2019,Cleveland State,Horizon,28,741,139,235,129,215,10,20,25,48,54,116,170,36,20,31,44,74,313
10173,Ryan Holmes,2008,2009,Pepperdine,WCC,51,1245,115,270,101,212,14,58,69,93,28,81,109,105,44,3,74,66,313
10174,Jordan Lee,2009,2012,Coppin State,MEAC,33,687,100,273,46,114,54,159,59,73,31,68,99,15,28,10,35,67,313
10175,J.L. Lewis,2010,2013,Total,Total,124,1565,121,268,111,231,10,37,61,104,138,185,323,28,33,33,91,270,313
10176,Te'Jon Lucas,2017,2018,Illinois,Big Ten,60,1262,111,249,94,198,17,51,74,123,19,104,123,189,63,4,107,132,313
10177,Trey Lyles,2015,2015,Kentucky,SEC,36,828,117,240,113,211,4,29,75,102,65,123,188,38,19,16,41,57,313
10178,Nathan Mann,2008,2008,William & Mary,CAA,33,1011,104,291,31,80,73,211,32,44,14,90,104,74,30,3,62,62,313
10179,Montell McRae,2018,2019,Buffalo,MAC,72,1033,116,226,76,104,40,122,41,68,76,135,211,30,21,22,45,160,313
10180,Joshua Phillips,2014,2018,Total,Total,90,1013,120,235,120,234,0,1,73,130,90,171,261,20,15,25,75,135,313
10181,Ronald Ramon,2008,2008,Pittsburgh,Big East,37,1174,101,260,34,80,67,180,44,62,16,79,95,133,34,2,51,66,313
10182,Brandon Roberts,2014,2015,Samford,Southern,61,760,115,294,74,154,41,140,42,58,14,50,64,49,21,0,58,56,313
10183,Zavier Sanders,2009,2012,Eastern Illinois,OVC,97,1254,123,269,123,266,0,3,67,113,83,150,233,46,28,9,65,122,313
10184,Jordan Schakel,2018,2019,San Diego State,MWC,61,1107,96,241,25,57,71,184,50,63,39,131,170,49,34,7,24,151,313
10185,Steadman Short,2009,2012,Total,Total,74,1366,130,253,130,253,0,0,53,107,126,178,304,25,29,39,80,150,313
10186,Jericho Sims,2018,2019,Texas,Big 12,68,1135,127,215,127,214,0,1,59,118,84,171,255,13,19,36,60,122,313
10187,Anthony Slack,2008,2008,Illinois State,MVC,33,813,124,188,124,188,0,0,65,125,79,155,234,31,32,47,72,95,313
10188,Tyler Storm,2009,2012,Northern Illinois,MAC,106,1217,107,313,64,161,43,152,56,73,85,110,195,52,30,12,84,125,313
10189,Sam Timmins,2017,2019,Washington,Pac-12,101,1436,132,239,130,232,2,7,47,97,130,225,355,26,38,78,102,201,313
10190,Donovann Toatley,2019,2019,Chattanooga,Southern,28,697,113,269,86,177,27,92,60,87,6,51,57,82,11,1,69,68,313
10191,Noah Yates,2017,2019,Total,Total,75,1125,106,257,37,60,69,197,32,43,26,154,180,60,41,16,50,97,313
10192,Moataz Aly,2017,2018,Cal State Bakersfield,WAC,61,976,132,197,132,197,0,0,48,121,78,102,180,15,13,110,92,183,312
10193,Austin Anderson,2013,2015,Presbyterian,Big South,81,1942,110,332,62,148,48,184,44,60,18,165,183,196,47,4,117,91,312
10194,Henry Baddley,2017,2019,Butler,Big East,92,1206,112,242,71,121,41,121,47,62,37,123,160,40,49,20,44,111,312
10195,Michael Bizoukas,2008,2012,Total,Total,118,2407,118,323,88,227,30,96,46,85,54,189,243,338,90,13,141,203,312
10196,D'Lancy Carter,2008,2009,St. Bonaventure,A-10,60,1142,124,274,124,271,0,3,64,113,117,175,292,30,20,32,64,139,312
10197,Jamere Dismukes,2013,2014,Chicago State,Total,35,849,104,284,71,173,33,111,71,91,15,60,75,114,55,0,84,46,312
10198,Jason Ebie,2008,2009,Texas Christian,MWC,61,1561,102,272,76,184,26,88,82,123,36,118,154,200,88,4,116,128,312
10199,Keith Fisher III,2018,2018,San Jose State,MWC,30,769,122,248,122,248,0,0,68,105,56,134,190,26,25,7,61,97,312
10200,Jimmy Graham,2008,2009,Miami (FL),ACC,62,1145,122,240,122,239,0,1,68,131,107,226,333,33,37,73,86,163,312
10201,Chuks Iroegbu,2015,2016,Northern Illinois,MAC,64,887,105,168,101,146,4,22,98,167,48,77,125,34,37,18,49,96,312
10202,Justin Jenkins,2013,2019,Total,Total,108,1012,101,290,58,153,43,137,67,94,19,91,110,64,31,7,83,80,312
10203,Jordan Johnson,2014,2015,Tennessee Tech,OVC,61,1016,102,277,31,82,71,195,37,54,10,70,80,59,32,5,56,69,312
10204,Tre Johnson,2011,2012,Montana State,Big Sky,55,1003,127,282,127,281,0,1,58,92,88,134,222,30,35,48,71,125,312
10205,Jorden Kite,2017,2019,Incarnate Word,Southland,76,1033,94,255,17,40,77,215,47,53,7,79,86,35,23,1,40,83,312
10206,Adam Liberty,2008,2008,Oral Roberts,Summit,33,1078,94,249,68,174,26,75,98,127,16,98,114,110,27,3,81,76,312
10207,Drew McGhee,2011,2013,Miami (OH),MAC,78,957,140,251,140,251,0,0,32,47,61,90,151,17,14,24,49,123,312
10208,Hatila Passos,2008,2008,New Mexico State,WAC,29,729,116,181,116,181,0,0,80,137,94,118,212,33,8,9,47,64,312
10209,Malachi Peay,2008,2011,Maine,AEC,88,1159,108,247,103,229,5,18,91,147,58,141,199,97,66,23,98,120,312
10210,DeWitt Scott,2008,2008,Purdue-Fort Wayne,Summit,30,828,104,233,37,68,67,165,37,46,11,66,77,19,14,7,18,77,312
10211,Johnny Thomas,2009,2011,Total,Total,55,956,126,252,110,191,16,61,44,59,80,97,177,26,18,26,29,65,312
10212,Ramon Vila,2017,2019,Total,Total,55,938,128,203,126,195,2,8,54,85,68,112,180,28,11,27,45,129,312
10213,D.J. Weaver,2019,2019,Oral Roberts,Summit,32,792,108,250,31,67,77,183,19,24,21,65,86,27,16,26,33,62,312
10214,Austin Williams,2018,2019,Marist,MAAC,60,992,123,248,116,212,7,36,59,111,32,125,157,70,42,8,110,138,312
10215,Quatarrius Wilson,2018,2018,McNeese State,Southland,29,868,125,247,119,222,6,25,56,91,105,192,297,39,22,28,67,69,312
10216,Wajid Aminu,2017,2017,North Florida,A-Sun,34,884,123,227,115,199,8,28,57,116,90,130,220,25,14,36,71,121,311
10217,Michael Bradley,2014,2015,Samford,Southern,60,963,121,218,121,217,0,1,69,92,88,185,273,19,13,31,64,149,311
10218,Hayden Brown,2018,2019,Citadel,Southern,51,827,120,259,92,163,28,96,43,59,68,122,190,45,46,14,58,123,311
10219,Moses Brown,2019,2019,UCLA,Pac-12,31,746,133,219,133,219,0,0,45,128,108,158,266,9,19,62,49,75,311
10220,Darrius Garrett,2009,2012,Richmond,A-10,116,1869,109,268,106,248,3,20,90,171,152,349,501,52,33,231,94,206,311
10221,Keith Gray,2012,2015,Northern Illinois,MAC,88,1206,95,236,95,236,0,0,121,170,101,113,214,18,21,15,93,223,311
10222,Deion James,2008,2009,Milwaukee,Horizon,59,914,93,254,53,126,40,128,85,111,33,107,140,51,23,5,65,100,311
10223,Evan Jefferson,2008,2009,Jacksonville,A-Sun,63,966,105,291,49,124,56,167,45,63,22,74,96,45,33,3,92,84,311
10224,Skye Johnson,2015,2018,Delaware,CAA,92,991,123,218,123,218,0,0,65,105,105,123,228,27,27,28,89,140,311
10225,Marcel Jones,2008,2008,Oregon State,Pac-10,30,803,121,339,85,225,36,114,33,59,60,110,170,32,21,12,42,51,311
10226,Kaza Keane,2013,2015,Total,Total,98,1689,111,304,83,204,28,100,61,112,43,133,176,231,58,4,141,182,311
10227,Keishawn Mayes,2009,2011,Total,Total,55,1017,115,291,100,245,15,46,66,112,79,121,200,33,29,16,82,163,311
10228,Fab Melo,2011,2012,Syracuse,Big East,63,1090,132,229,132,229,0,0,47,85,102,137,239,29,25,113,68,145,311
10229,Simon Okolue,2018,2018,Delaware State,MEAC,27,720,134,219,134,218,0,1,43,68,77,114,191,7,16,29,43,88,311
10230,Darris Santee,2009,2010,Nevada-Las Vegas,MWC,64,887,124,222,124,222,0,0,63,117,68,117,185,13,19,32,50,116,311
10231,Stephen Spinella,2010,2013,Total,Total,75,1210,106,277,73,163,33,114,66,99,52,121,173,38,30,8,61,87,311
10232,Malik Alvin,2009,2009,Binghamton,AEC,27,809,92,236,75,174,17,62,109,133,17,64,81,99,34,9,83,68,310
10233,Jared Brandon,2013,2014,Cal State Fullerton,Big West,57,1247,125,269,116,226,9,43,51,78,84,96,180,69,39,4,61,119,310
10234,Michael Devoe,2019,2019,Georgia Tech,ACC,32,1031,101,250,59,143,42,107,66,93,13,93,106,81,44,16,71,57,310
10235,Charles Dewhurst,2008,2011,Charlotte,A-10,91,1582,86,229,81,213,5,16,133,173,130,229,359,126,60,27,123,136,310
10236,Jimmy Drew,2008,2011,Total,Total,66,1159,100,270,31,74,69,196,41,53,43,117,160,103,49,8,59,147,310
10237,Tiny Gallon,2010,2010,Oklahoma,Big 12,30,720,122,223,118,206,4,17,62,89,83,155,238,24,21,23,70,85,310
10238,Leon Gibson,2012,2013,Houston,CUSA,59,857,115,237,110,224,5,13,75,113,106,163,269,28,13,28,50,96,310
10239,Hector Hernandez,2008,2008,Fresno State,WAC,32,1029,112,291,72,161,40,130,46,58,61,171,232,36,29,17,44,59,310
10240,Jakari Johnson,2008,2009,Purdue-Fort Wayne,Summit,51,945,108,241,72,145,36,96,58,78,26,103,129,74,72,11,71,82,310
10241,David Joseph,2015,2016,Bowling Green State,MAC,67,1408,111,326,81,229,30,97,58,78,16,148,164,209,68,6,105,101,310
10242,Brett McDade,2008,2008,Tulsa,CUSA,39,1117,93,251,41,128,52,123,72,96,7,81,88,119,37,4,80,86,310
10243,Jonathan Mitchell,2018,2019,Delaware State,MEAC,40,838,103,277,81,193,22,84,82,127,76,105,181,48,37,8,68,70,310
10244,Malik Nichols,2015,2016,Hofstra,CAA,54,939,124,242,119,218,5,24,57,122,112,160,272,68,45,8,75,167,310
10245,Torey Noel,2017,2018,Lamar,Southland,65,1124,100,280,75,177,25,103,85,133,19,83,102,179,82,3,113,139,310
10246,Khalen Pinkett,2015,2018,Savannah State,MEAC,85,1479,112,299,102,255,10,44,76,146,35,103,138,99,88,5,174,156,310
10247,Forrest Robinson,2012,2015,Total,Total,70,1000,109,268,40,80,69,188,23,28,36,125,161,22,17,23,44,146,310
10248,K.K. Simmons,2012,2014,Total,Total,55,907,97,262,47,118,50,144,66,87,12,69,81,76,21,4,66,73,310
10249,Shawn Smith,2014,2015,Marshall,CUSA,38,839,108,246,79,151,29,95,65,99,49,94,143,24,21,13,43,87,310
10250,Cameron Williams,2019,2019,Southern Illinois-Edwardsville,OVC,31,842,113,270,73,144,40,126,44,66,28,76,104,42,36,5,51,73,310
10251,Damien Wilson,2013,2015,Total,Total,65,871,118,293,111,240,7,53,67,93,46,101,147,54,28,10,89,73,310
10252,Matt Wolff,2008,2009,Boston University,AEC,61,1898,108,287,87,213,21,74,73,113,99,188,287,161,74,9,144,164,310
10253,Anthony Byrd,2008,2009,Toledo,MAC,61,1623,102,263,47,92,55,171,50,59,49,94,143,71,59,22,73,77,309
10254,Steven Danridge,2011,2014,Grambling,SWAC,111,1746,126,255,126,254,0,1,57,126,138,157,295,30,24,57,111,296,309
10255,Thaddeus Handley,2015,2016,Arkansas-Pine Bluff,SWAC,53,891,124,266,102,198,22,68,39,73,54,107,161,29,40,7,74,95,309
10256,Scott Hitchon,2018,2019,Canisius,MAAC,53,863,112,228,84,162,28,66,57,82,29,78,107,50,12,32,64,111,309
10257,Michael Moss,2011,2011,Houston Baptist,GWC,31,955,108,265,80,186,28,79,65,88,34,129,163,126,87,5,125,76,309
10258,Brian Randle,2008,2008,Illinois,Big Ten,33,838,117,254,109,215,8,39,67,112,68,114,182,46,21,16,56,111,309
10259,James Ulrich,2008,2008,Wagner,NEC,31,880,117,234,117,229,0,5,75,138,76,131,207,46,15,8,59,87,309
10260,Romello Walker,2015,2016,Binghamton,AEC,39,1113,111,323,85,218,26,105,61,105,41,128,169,38,31,10,75,75,309
10261,Kenny Wormley,2016,2019,Total,Total,73,1218,106,272,81,210,25,62,72,107,30,106,136,107,38,3,87,140,309
10262,Jacob Young,2017,2018,Texas,Big 12,63,1044,114,322,59,119,55,203,26,36,10,71,81,50,28,2,50,80,309
10263,Kenny Aninye,2018,2019,Stetson,A-Sun,62,1148,115,275,84,177,31,98,47,72,23,88,111,139,46,1,66,90,308
10264,Deontaye Buskey,2018,2019,Charleston Southern,Big South,61,1151,104,284,57,150,47,134,53,83,28,88,116,108,64,14,79,100,308
10265,Wesley Clemmons,2008,2009,Southern Illinois,MVC,60,1373,109,290,72,177,37,113,53,75,40,118,158,75,32,4,79,111,308
10266,De'Jon Davis,2019,2019,California Baptist,WAC,30,883,106,216,95,177,11,39,85,105,85,189,274,14,14,12,47,80,308
10267,Jerome Desrosiers,2018,2019,Princeton,Ivy,55,989,103,264,40,93,63,171,39,50,46,175,221,45,14,6,43,66,308
10268,Ivan Elliott,2008,2008,UC-Santa Barbara,Big West,32,842,124,223,98,165,26,58,34,50,62,119,181,30,31,31,42,90,308
10269,Matt Fields,2008,2008,Georgia Southern,Southern,32,885,125,224,125,220,0,4,58,94,81,151,232,42,41,21,53,77,308
10270,Darius George,2018,2019,Marshall,CUSA,62,912,112,235,78,127,34,108,50,91,59,130,189,20,37,28,38,117,308
10271,Tre Harris,2015,2017,Total,Total,38,624,101,264,35,97,66,167,40,57,16,66,82,23,15,0,42,65,308
10272,Sam Miller,2016,2019,Total,Total,75,861,105,221,70,122,35,99,63,85,51,99,150,28,17,21,65,117,308
10273,Kevin Perkins,2008,2009,Texas A&M-Corpus Christi,Southland,33,833,111,276,79,173,32,103,54,82,23,53,76,63,33,5,100,93,308
10274,Adam Sledd,2017,2019,Western Carolina,Southern,92,1077,130,272,130,272,0,0,48,83,97,124,221,20,18,19,62,146,308
10275,Markee Teal,2012,2013,Florida A&M,MEAC,59,1099,120,253,119,243,1,10,67,104,84,149,233,24,31,18,86,181,308
10276,Kris Walden,2012,2013,Towson,CAA,63,1617,112,350,75,199,37,151,47,66,10,106,116,144,66,3,174,147,308
10277,Doug Williams,2008,2009,Army,Patriot,54,1172,116,222,116,222,0,0,76,105,78,174,252,10,24,14,47,146,308
10278,Ivan Aurrecoechea,2019,2019,New Mexico State,WAC,32,541,122,210,122,209,0,1,63,90,65,102,167,22,10,5,38,41,307
10279,Kentrall Brooks,2014,2017,Marist,MAAC,112,1327,112,244,112,236,0,8,83,114,94,211,305,69,21,62,118,255,307
10280,Stephawn Brown,2010,2013,Alabama State,SWAC,72,1520,125,301,98,208,27,93,30,65,101,161,262,63,36,26,89,123,307
10281,D'Andre Bullard,2012,2014,Florida A&M,MEAC,85,1539,117,362,89,271,28,91,45,69,42,160,202,138,67,8,127,124,307
10282,Dre Conner,2011,2013,Total,Total,58,1329,74,204,46,116,28,88,131,177,20,66,86,133,38,0,85,125,307
10283,Dhamir Cosby-Roundtree,2018,2019,Villanova,Big East,76,1193,123,176,123,176,0,0,61,86,128,176,304,32,37,47,45,165,307
10284,Darryl Felder,2009,2011,North Carolina-Wilmington,CAA,88,1223,104,285,62,161,42,124,57,87,33,115,148,75,43,14,65,112,307
10285,John Ford,2008,2008,McNeese State,Southland,29,890,97,242,51,134,46,108,67,82,10,67,77,90,36,1,93,63,307
10286,Marcus Freeman,2015,2016,Coastal Carolina,Big South,55,844,124,248,124,248,0,0,59,100,141,167,308,15,22,49,39,121,307
10287,Sarp Gobeloglu,2016,2017,Montana State,Big Sky,43,792,107,249,41,73,66,176,27,33,35,107,142,22,9,16,49,102,307
10288,Jamar Greene,2008,2009,Boise State,WAC,65,1307,116,321,68,150,48,171,27,50,34,79,113,97,37,7,107,128,307
10289,Humpty Hitchens,2009,2009,Akron,MAC,35,786,107,273,62,134,45,139,48,64,9,40,49,78,44,1,86,81,307
10290,D.J. Jackson,2013,2014,Oral Roberts,Southland,66,1649,83,245,38,115,45,130,96,116,21,99,120,186,52,0,100,95,307
10291,Tyler Kidd,2019,2019,Eastern Washington,Big Sky,31,789,100,250,59,153,41,97,66,83,6,47,53,96,34,2,71,68,307
10292,Devon Long,2011,2014,Cleveland State,Horizon,97,1098,134,232,134,232,0,0,39,77,91,91,182,22,22,22,55,173,307
10293,Isaiah Martin,2018,2019,Florida A&M,MEAC,35,925,130,204,130,204,0,0,47,85,90,144,234,13,16,81,38,73,307
10294,Dion Wade,2014,2017,Total,Total,87,1338,98,299,33,78,65,221,46,68,58,199,257,54,67,31,44,174,307
10295,John Adams,2009,2012,Lehigh,Patriot,98,1315,106,247,73,156,33,91,61,90,64,194,258,36,39,22,82,198,306
10296,Kyle Cieplicki,2008,2008,Vermont,AEC,29,958,111,256,57,114,54,142,30,36,19,81,100,65,12,0,51,76,306
10297,James Johnson,2011,2014,Total,Total,88,1186,123,206,123,206,0,0,60,98,86,116,202,10,16,25,47,189,306
10298,Bakary Konate,2015,2018,Minnesota,Big Ten,117,1617,113,223,113,221,0,2,80,128,132,266,398,30,35,82,85,258,306
10299,James Loe,2008,2009,Louisiana Tech,WAC,62,1402,97,268,69,179,28,89,84,111,26,79,105,128,43,3,118,138,306
10300,Sal Nuhu,2019,2019,Portland State,Big Sky,32,739,106,215,106,213,0,2,94,134,72,152,224,9,19,64,42,76,306
10301,Malcolm Porter,2018,2019,Portland,WCC,56,916,108,248,85,169,23,79,67,102,8,82,90,75,26,1,64,64,306
10302,Dontaveon Robinson,2014,2017,Jackson State,SWAC,127,1713,127,336,127,330,0,6,52,85,86,106,192,65,65,20,87,265,306
10303,Ray Rodriguez,2013,2016,Total,Total,84,1260,100,275,25,62,75,213,31,45,13,95,108,102,24,2,108,84,306
10304,Spencer Tollackson,2008,2008,Minnesota,Big Ten,33,736,121,238,118,226,3,12,61,119,53,70,123,39,28,13,49,76,306
10305,Damon Wilson,2016,2019,Total,Total,93,1182,104,246,72,158,32,88,66,104,12,144,156,97,39,8,66,121,306
10306,Sherrod Baldwin,2009,2013,Idaho State,Big Sky,101,1359,118,314,89,235,29,79,40,60,29,68,97,73,43,4,78,129,305
10307,Trevor Berkeley,2014,2015,Drake,MVC,62,1197,113,211,90,156,23,55,56,73,54,110,164,34,30,29,63,129,305
10308,Sam Burgess,2008,2008,Brigham Young,MWC,35,970,95,212,39,80,56,132,59,71,19,105,124,68,29,9,52,90,305
10309,Stokley Chaffee,2016,2019,Total,Total,65,1188,113,202,112,200,1,2,78,118,112,188,300,34,37,44,72,165,305
10310,Daquan Joyner,2008,2012,Total,Total,86,1211,119,230,119,229,0,1,67,119,80,170,250,37,31,48,68,116,305
10311,Eugene Kotorobai,2008,2008,Long Island University,NEC,29,874,91,273,20,55,71,218,52,67,57,149,206,19,27,28,34,85,305
10312,Darius Moore,2016,2017,Presbyterian,Big South,58,1167,106,303,42,139,64,164,29,47,19,108,127,132,38,5,106,117,305
10313,Saadiq Muhammad,2014,2015,Savannah State,MEAC,62,1130,118,247,118,245,0,2,69,136,72,138,210,14,29,33,71,158,305
10314,Matt Neufeld,2016,2019,Total,Total,83,880,121,230,121,225,0,5,63,108,42,101,143,14,21,27,72,139,305
10315,Chauncey Orr,2012,2015,Bowling Green State,MAC,67,1108,104,233,72,143,32,90,65,83,38,106,144,63,39,5,58,74,305
10316,Thomas Pfaff,2008,2009,Lipscomb,A-Sun,58,1001,129,253,129,252,0,1,47,94,93,127,220,33,13,15,85,127,305
10317,Tracy Robinson,2008,2008,Loyola (IL),Horizon,31,962,105,263,75,171,30,92,65,85,27,74,101,56,30,25,62,66,305
10318,Bryan White,2008,2008,Lehigh,Patriot,29,859,112,238,111,235,1,3,80,112,55,183,238,35,44,30,40,68,305
10319,Jeremiah Williams,2014,2015,Canisius,MAAC,50,917,102,261,54,130,48,131,53,64,17,61,78,76,40,7,71,88,305
10320,Matt Bauscher,2008,2008,Boise State,WAC,33,1028,112,228,58,104,54,124,26,52,28,85,113,105,39,5,36,67,304
10321,Jarriesse Blackmon,2016,2019,UC-Santa Barbara,Big West,96,1344,122,263,116,242,6,21,54,101,113,180,293,58,35,54,49,160,304
10322,Joe Bramanti,2013,2016,Total,Total,90,2028,91,243,66,163,25,80,97,158,41,208,249,178,55,4,133,206,304
10323,Paris Carter,2011,2012,Illinois-Chicago,Horizon,59,1154,112,244,112,243,0,1,80,164,101,133,234,29,17,13,92,139,304
10324,Jayson Cheesman,2013,2014,Southern Utah,Big Sky,59,1001,113,298,113,298,0,0,78,128,63,177,240,40,11,84,83,132,304
10325,Freddy Coleman,2009,2011,North Dakota State,Summit,59,943,109,277,81,199,28,78,58,100,35,153,188,88,47,10,94,91,304
10326,Michael Crowell,2008,2008,Idaho,WAC,28,964,104,236,42,101,62,135,34,43,40,108,148,42,17,6,54,74,304
10327,Mark Gary,2015,2015,Grambling,SWAC,29,783,91,217,74,174,17,43,105,139,53,118,171,20,13,9,84,69,304
10328,Nathan Geiser,2008,2008,Northern Arizona,Big Sky,32,789,96,239,23,57,73,182,39,48,9,63,72,31,17,0,35,68,304
10329,Kurt Hoffman,2008,2010,Saint Francis (PA),NEC,86,1704,114,212,114,210,0,2,76,120,119,169,288,64,43,36,103,206,304
10330,Wayne Hunter,2009,2010,Saint Mary's (CA),WCC,41,924,108,278,71,181,37,97,51,82,39,63,102,40,18,5,45,70,304
10331,Ryan Johnson,2017,2019,Total,Total,94,1097,96,227,60,120,36,107,76,109,51,161,212,54,28,10,49,112,304
10332,Lenjo Kilo,2016,2016,Savannah State,MEAC,32,828,117,251,109,223,8,28,62,120,74,102,176,14,18,25,65,95,304
10333,Jaylen McManus,2017,2019,College of Charleston,CAA,95,1307,106,279,54,117,52,162,40,66,63,181,244,30,12,20,42,120,304
10334,Antonio Robinson,2014,2015,East Carolina,Total,67,1538,111,292,95,242,16,50,66,97,36,196,232,213,92,12,102,121,304
10335,Nolan Taylor,2017,2018,Pepperdine,WCC,39,800,122,257,118,233,4,24,56,86,56,92,148,30,16,8,28,102,304
10336,J.T. Thomas,2011,2015,Total,Total,54,1366,95,280,56,156,39,124,75,122,8,87,95,112,32,6,75,86,304
10337,Tafari Whittingham,2015,2017,Total,Total,57,1022,114,274,111,263,3,11,73,149,80,143,223,13,23,42,88,155,304
10338,Vincent Williams,2010,2013,Georgia,SEC,115,1424,99,285,50,139,49,146,57,93,15,97,112,164,50,4,109,113,304
10339,Justin Wright,2012,2013,Troy,Sun Belt,33,715,98,249,53,115,45,134,63,82,33,80,113,36,9,1,47,72,304
10340,Xavier Adams,2015,2017,New Mexico,MWC,77,989,100,214,87,154,13,60,90,137,63,110,173,53,37,18,69,150,303
10341,Louis Brookins,2008,2009,Quinnipiac,NEC,48,1099,108,220,108,220,0,0,87,114,115,135,250,14,13,15,66,119,303
10342,Jesse Bunting,2016,2019,Fordham,A-10,86,1149,122,215,119,206,3,9,56,81,108,130,238,26,41,37,40,144,303
10343,Julius Carter,2008,2009,South Carolina State,MEAC,49,743,110,206,109,202,1,4,82,121,86,126,212,22,15,31,42,110,303
10344,Cedric Essola,2008,2010,Florida International,Sun Belt,80,1145,109,256,109,250,0,6,85,130,89,119,208,35,25,23,78,172,303
10345,Austin Ewing,2008,2008,North Carolina A&T,MEAC,30,789,84,218,20,40,64,178,71,87,8,53,61,66,20,0,58,46,303
10346,Jamal Hunter,2014,2015,Jacksonville State,OVC,61,1317,124,223,124,223,0,0,55,86,123,174,297,39,31,108,64,204,303
10347,Dominique Kirk,2008,2008,Texas A&M,Big 12,36,1131,97,229,51,116,46,113,63,82,22,106,128,128,24,16,53,66,303
10348,Jordan Nichols,2008,2009,American,Patriot,65,1447,124,191,124,190,0,1,55,81,115,166,281,38,39,64,67,180,303
10349,Ben Perez,2016,2019,Total,Total,54,1049,102,249,36,62,66,187,33,43,27,95,122,36,38,9,33,62,303
10350,Mike Redell,2008,2009,Western Michigan,MAC,63,1723,84,223,29,62,55,161,80,120,14,102,116,216,32,0,145,166,303
10351,Alex Reese,2018,2019,Alabama,SEC,60,742,102,256,51,110,51,146,48,63,47,113,160,22,25,19,46,64,303
10352,Tyler Streeter,2016,2019,Morgan State,MEAC,85,671,116,241,80,149,36,92,35,47,56,51,107,17,16,4,29,55,303
10353,Edin Suljic,2009,2010,Eastern Illinois,OVC,61,1050,124,269,124,269,0,0,55,73,65,92,157,51,17,14,72,87,303
10354,Jack Williams,2019,2019,Rice,CUSA,32,892,115,299,88,206,27,93,46,74,64,184,248,29,10,16,52,72,303
10355,Lenny Young,2009,2010,Coppin State,MEAC,47,891,109,292,72,191,37,101,48,82,36,66,102,64,37,0,82,98,303
10356,Robert Boyd,2011,2012,Lipscomb,A-Sun,42,975,108,282,65,150,43,132,43,65,35,71,106,80,69,13,74,97,302
10357,Kasim Chandler,2014,2015,Quinnipiac,MAAC,49,910,84,248,78,206,6,42,128,171,34,78,112,136,24,3,97,63,302
10358,Joey Getz,2012,2014,Maryland-Baltimore County,AEC,61,1210,111,282,89,218,22,64,58,81,28,97,125,96,57,1,90,80,302
10359,Marcus Green,2008,2009,Purdue,Big Ten,71,1139,104,268,76,174,28,94,66,110,80,149,229,57,47,27,60,139,302
10360,Jaylon Hall,2018,2019,Wright State,Horizon,34,790,100,269,67,164,33,105,69,103,17,69,86,49,18,2,60,57,302
10361,Mitch Henke,2008,2008,Santa Clara,WCC,31,976,106,226,66,120,40,106,50,71,37,103,140,69,24,5,83,85,302
10362,Booker Hucks,2010,2013,Long Island University,NEC,106,781,113,218,73,109,40,109,36,52,66,96,162,9,14,27,50,110,302
10363,Rosel Hurley,2017,2019,Total,Total,36,730,123,246,115,216,8,30,48,79,54,83,137,46,24,5,54,78,302
10364,Robbie Jackson,2008,2010,Total,Total,53,773,102,209,102,208,0,1,98,139,71,116,187,20,20,42,71,125,302
10365,Eric Johnson,2015,2018,Boston University,Patriot,91,1461,94,258,36,106,58,152,56,82,17,101,118,163,59,5,91,101,302
10366,Jason Johnson,2013,2013,Utah Valley,GWC,31,889,111,251,77,156,34,95,46,78,15,70,85,63,28,3,47,62,302
10367,Keshawn Justice,2019,2019,Santa Clara,WCC,31,816,101,250,44,103,57,147,43,59,12,77,89,51,25,9,33,43,302
10368,Matt LaBove,2010,2013,Dartmouth,Ivy,107,1277,115,294,115,294,0,0,72,113,88,185,273,34,13,30,76,172,302
10369,Darryl Marshall,2013,2014,Mississippi Valley State,SWAC,53,1075,89,262,44,118,45,144,79,115,19,53,72,113,37,0,86,66,302
10370,Brandon Parks,2008,2010,Kent State,MAC,77,1048,131,244,131,243,0,1,40,88,89,160,249,20,19,28,52,168,302
10371,Zach Radz,2017,2019,Sacred Heart,NEC,64,996,105,263,67,139,38,124,54,71,20,127,147,46,15,4,58,63,302
10372,Andrew Reed,2008,2008,East Tennessee State,A-Sun,32,838,129,251,118,217,11,34,33,48,67,133,200,19,25,30,49,109,302
10373,Ronnie Rousseau III,2017,2018,Missouri State,MVC,41,961,109,266,74,160,35,106,49,71,10,56,66,82,21,1,54,67,302
10374,Tim Smallwood,2015,2016,Omaha,Summit,57,901,104,279,42,91,62,188,32,55,20,96,116,43,39,6,48,102,302
10375,Julian Walters,2017,2019,Total,Total,65,1186,101,254,57,118,44,136,56,72,27,163,190,175,48,1,79,89,302
10376,Quincy Williams,2008,2008,North Texas,Sun Belt,31,828,120,245,120,244,0,1,62,93,85,152,237,39,21,30,58,90,302
10377,Armond Battle,2011,2012,Wright State,Horizon,59,1052,89,227,59,133,30,94,93,151,43,115,158,32,44,16,73,127,301
10378,Bobby Catchings,2008,2008,Eastern Illinois,OVC,28,800,101,238,76,179,25,59,74,91,37,91,128,40,15,10,52,85,301
10379,Chris Conner,2009,2012,Total,Total,78,1002,87,258,40,98,47,160,80,108,39,97,136,37,24,2,64,86,301
10380,Quentin Grimes,2019,2019,Kansas,Big 12,36,987,106,276,52,117,54,159,35,58,17,72,89,72,23,6,69,85,301
10381,Eric Hall,2008,2009,Radford,Big South,62,1069,118,248,117,245,1,3,64,97,110,187,297,23,25,88,72,106,301
10382,Ed Jones,2016,2019,Total,Total,69,987,122,311,104,234,18,77,39,54,54,78,132,11,18,44,45,134,301
10383,Brandan Kearney,2012,2015,Total,Total,99,1354,109,268,72,158,37,110,46,70,42,92,134,99,43,11,81,129,301
10384,Jim Ledsome,2008,2009,Delaware,CAA,56,1423,120,181,120,181,0,0,61,122,106,198,304,38,38,84,56,173,301
10385,Cory Pflieger,2008,2009,Rice,CUSA,37,1038,100,262,35,85,65,177,36,50,21,109,130,74,24,2,61,64,301
10386,Kirill Pishchalnikov,2008,2010,Virginia Commonwealth,CAA,98,1297,112,236,112,236,0,0,77,125,140,179,319,44,36,42,85,208,301
10387,Kaimarr Price,2011,2011,Western Illinois,Summit,28,830,117,258,117,255,0,3,67,107,53,134,187,44,17,22,71,90,301
10388,Chandler Rowe,2014,2017,Tennessee-Martin,OVC,129,1767,101,203,89,176,12,27,87,147,148,212,360,87,74,57,85,297,301
10389,Jairus Simms,2010,2013,High Point,Big South,117,1754,116,302,85,213,31,89,38,62,44,92,136,260,57,2,139,138,301
10390,Marvin Singleton,2012,2015,Northern Iowa,MVC,95,1378,119,230,113,197,6,33,57,87,117,166,283,40,21,8,63,115,301
10391,Boubacar Toure,2016,2019,Total,Total,39,878,121,194,121,192,0,2,59,124,102,171,273,12,16,46,72,103,301
10392,Giacomo Zilli,2014,2017,North Carolina-Asheville,Big South,83,801,111,210,111,210,0,0,79,114,81,110,191,39,19,38,65,131,301
10393,Jamal Breaux,2008,2009,Grambling,SWAC,41,1084,119,227,119,226,0,1,62,126,110,165,275,55,19,7,86,129,300
10394,Greg Calixte,2018,2019,George Mason,A-10,63,1047,130,213,130,213,0,0,40,97,71,175,246,19,14,28,48,125,300
10395,Timmy Falls,2018,2019,Montana,Big Sky,66,1225,100,251,52,122,48,129,52,70,13,72,85,124,52,8,100,167,300
10396,Josh Figini,2010,2013,Cornell,Ivy,89,886,109,278,73,177,36,101,46,62,53,96,149,21,33,24,35,110,300
10397,Nate Jones,2016,2019,Bucknell,Patriot,116,1440,98,256,33,65,65,191,39,66,38,136,174,79,34,6,52,112,300
10398,Justin Jordan,2010,2012,Total,Total,53,1035,93,245,42,97,51,148,63,89,5,92,97,95,32,1,84,60,300
10399,Devin Kirby,2017,2019,Montana State,Big Sky,64,1003,108,194,108,194,0,0,84,131,87,121,208,27,14,24,64,123,300
10400,Chier Maker,2017,2019,Total,Total,49,1098,104,259,59,120,45,139,47,66,77,175,252,35,19,14,47,78,300
10401,De'Anthony Melton,2017,2017,Southern California,Pac-12,36,972,101,231,80,157,21,74,77,109,50,120,170,125,69,37,64,81,300
10402,Afam Nweke,2008,2009,Louisiana-Monroe,Sun Belt,61,1328,104,217,104,216,0,1,92,125,114,214,328,16,26,14,72,146,300
10403,Radar Onguetou,2008,2010,New Hampshire,AEC,62,1546,100,273,75,174,25,99,75,117,136,202,338,36,14,6,54,177,300
10404,Jeff Parmer,2008,2008,Florida Atlantic,Sun Belt,33,800,98,199,68,126,30,73,74,102,57,107,164,68,29,11,59,106,300
10405,Lukas Poderis,2010,2014,East Tennessee State,A-Sun,121,1492,112,240,111,234,1,6,75,139,145,171,316,21,31,74,51,235,300
10406,Maurice Sutton,2010,2013,Villanova,Big East,109,1189,106,212,106,211,0,1,88,144,109,176,285,30,28,100,81,176,300
10407,Evann Baker,2008,2010,Quinnipiac,NEC,37,831,96,217,80,184,16,33,91,111,28,73,101,74,25,7,68,71,299
10408,Brian Carlwell,2008,2011,Total,Total,74,917,118,209,114,198,4,11,59,101,83,111,194,23,14,42,56,110,299
10409,Derek Culver,2019,2019,West Virginia,Big 12,26,702,103,226,103,225,0,1,93,159,92,166,258,43,14,17,64,67,299
10410,K.J. Davis,2018,2019,East Carolina,AAC,55,1065,108,337,51,131,57,206,26,47,35,143,178,38,35,38,46,105,299
10411,Djordje Dimitrijevic,2019,2019,Mercer,Southern,31,708,102,236,75,137,27,99,68,86,11,69,80,60,29,4,56,56,299
10412,Asauhn Dixon-Tatum,2013,2014,Auburn,SEC,62,1123,115,220,115,220,0,0,69,104,135,151,286,17,21,108,64,167,299
10413,Markus Duran,2012,2013,Pacific,Big West,57,1070,92,239,13,23,79,216,36,44,12,56,68,48,18,2,38,64,299
10414,Adrian Edwards,2015,2017,Alabama A&M,SWAC,75,1175,119,278,119,271,0,7,61,103,97,134,231,34,22,24,64,156,299
10415,Jaryd Eustace,2014,2015,Miami (OH),MAC,59,898,96,273,36,79,60,194,47,70,16,114,130,28,25,3,51,52,299
10416,Kenny Franklin,2010,2011,Nicholls State,Southland,58,1456,103,269,37,86,66,183,27,32,15,70,85,140,59,4,78,118,299
10417,Mickell Gladness,2008,2008,Alabama A&M,SWAC,29,888,99,219,99,217,0,2,101,144,63,192,255,24,24,131,59,72,299
10418,August Haas,2017,2018,Milwaukee,Horizon,67,1612,110,287,78,176,32,111,47,88,14,148,162,223,48,4,125,151,299
10419,Josh LeBlanc,2019,2019,Georgetown,Big East,33,805,114,181,109,174,5,7,66,95,84,158,242,32,30,37,36,74,299
10420,Ray Lester,2011,2014,Total,Total,82,1216,109,245,109,243,0,2,81,185,93,140,233,32,36,13,103,199,299
10421,Arnold Mayorga,2009,2012,Long Island University,NEC,115,1301,96,267,46,96,50,171,57,80,76,125,201,37,25,22,51,119,299
10422,Dejuan McGaughy,2013,2014,High Point,Big South,49,1105,115,285,84,207,31,78,38,55,12,69,81,117,29,10,77,82,299
10423,Liam Potter,2008,2010,Sacred Heart,NEC,45,930,112,228,112,228,0,0,75,144,106,164,270,27,10,64,83,119,299
10424,Sloan Seymour,2019,2019,Siena,MAAC,33,879,101,271,7,19,94,252,3,3,4,19,23,7,7,3,14,24,299
10425,Takayo Siddle,2008,2009,Gardner-Webb,Total,59,953,94,274,37,90,57,184,54,72,10,69,79,104,28,2,68,61,299
10426,Kendall Small,2016,2019,Total,Total,85,1324,110,279,106,260,4,19,75,135,17,85,102,114,72,3,85,155,299
10427,Miklos Szabo,2009,2010,Hofstra,CAA,53,952,130,269,124,246,6,23,33,63,97,158,255,20,17,12,68,146,299
10428,Trey Thompson,2015,2018,Arkansas,SEC,114,1669,122,219,122,218,0,1,55,91,100,284,384,146,59,86,92,246,299
10429,Robert Upshaw,2013,2015,Total,Total,41,834,123,243,123,242,0,1,53,120,70,169,239,15,13,124,46,93,299
10430,Alex Vander Baan,2008,2009,Holy Cross,Patriot,45,1075,96,243,62,151,34,92,73,99,72,122,194,55,39,18,49,115,299
10431,Casey Wells,2016,2017,Savannah State,MEAC,49,718,91,278,7,24,84,254,33,44,18,34,52,25,20,3,31,44,299
10432,Greg Whittington,2012,2013,Georgetown,Big East,46,1120,109,257,72,146,37,111,44,71,52,134,186,55,37,29,63,98,299
10433,Kenny Williams,2008,2008,Mississippi,SEC,35,922,128,240,128,240,0,0,43,87,77,155,232,34,32,31,46,92,299
10434,Amar Alibegovic,2015,2018,St. John's (NY),Big East,109,1291,106,290,59,114,47,176,39,70,49,141,190,45,31,33,85,214,298
10435,Casaan Breeden,2008,2010,Total,Total,42,923,113,267,68,134,45,133,27,35,30,157,187,43,34,46,65,121,298
10436,Zach Copeland,2019,2019,Illinois State,MVC,32,918,100,291,47,124,53,167,45,53,11,79,90,96,29,5,71,82,298
10437,Duje Dukan,2011,2015,Wisconsin,Big Ten,97,970,106,248,62,114,44,134,42,64,50,117,167,37,14,4,36,83,298
10438,Chase Dunn,2010,2012,Tennessee Tech,OVC,63,718,86,234,37,83,49,151,77,95,4,30,34,46,29,0,56,67,298
10439,Daniel Giddens,2016,2019,Total,Total,81,1165,119,237,119,235,0,2,60,123,90,141,231,23,31,92,79,225,298
10440,Leonard Harper-Baker,2019,2019,Southern Mississippi,CUSA,31,864,115,204,107,181,8,23,60,100,68,179,247,44,24,41,54,73,298
10441,Rodney Henderson,2019,2019,Cal State Northridge,Big West,28,722,102,264,49,104,53,160,41,52,32,64,96,22,21,6,20,54,298
10442,Jared Josten,2008,2008,Northern Iowa,MVC,32,1073,96,254,59,151,37,103,69,81,5,62,67,65,14,4,63,48,298
10443,Kevion Nolan,2018,2019,Samford,Southern,59,929,100,235,38,82,62,153,36,46,9,73,82,68,40,7,34,83,298
10444,Trevor Ottley,2010,2011,Middle Tennessee,Sun Belt,64,1131,93,228,93,228,0,0,112,168,105,194,299,36,63,79,99,193,298
10445,Tyrae Robinson,2011,2012,Ball State,MAC,51,1080,96,234,81,188,15,46,91,139,14,69,83,150,36,0,113,109,298
10446,Eric Truog,2013,2016,Marist,MAAC,98,1643,127,283,116,244,11,39,33,75,125,252,377,114,41,48,88,233,298
10447,Chase Audige,2019,2019,William & Mary,CAA,31,906,108,230,69,125,39,105,42,62,34,92,126,75,44,17,57,92,297
10448,Joey Brunk,2017,2019,Butler,Big East,60,772,113,188,112,183,1,5,70,109,60,100,160,36,6,9,42,67,297
10449,Tareq Coburn,2017,2019,Total,Total,46,865,96,217,44,93,52,124,53,68,42,102,144,30,20,7,29,68,297
10450,Marko Deric,2008,2009,Loyola Marymount,WCC,62,1263,120,338,98,254,22,84,35,54,68,112,180,27,20,14,73,164,297
10451,Charles Falden,2018,2019,Winthrop,Big South,55,785,109,239,52,121,57,118,22,28,51,95,146,39,29,4,64,60,297
10452,Chris Golden,2015,2015,Weber State,Big Sky,30,797,95,262,32,80,63,182,44,58,7,52,59,38,28,3,42,66,297
10453,Max Groebe,2008,2012,Total,Total,87,829,102,265,23,63,79,202,14,20,8,66,74,29,13,3,21,45,297
10454,Ashton Hall,2008,2010,Lamar,Southland,52,915,99,229,78,160,21,69,78,107,59,80,139,55,24,17,47,92,297
10455,Pavol Losonsky,2010,2011,UC-Irvine,Big West,54,905,121,274,105,225,16,49,39,56,57,114,171,30,10,4,62,132,297
10456,Connor MacDougall,2015,2019,Total,Total,54,610,105,173,105,173,0,0,87,116,50,63,113,21,6,17,43,118,297
10457,Vince Martin,2014,2014,Jacksonville,A-Sun,30,976,88,229,48,121,40,108,81,107,24,93,117,141,55,6,54,49,297
10458,Rayshawn Neal,2018,2019,South Carolina State,MEAC,56,944,114,255,110,228,4,27,65,88,34,92,126,120,26,3,123,89,297
10459,Dimitri Spasojevic,2018,2019,East Carolina,AAC,61,1258,134,275,134,274,0,1,29,65,59,122,181,42,18,30,75,129,297
10460,Jordan Springer,2010,2013,Army,Patriot,107,1475,110,225,110,225,0,0,77,119,127,229,356,55,37,24,95,285,297
10461,James Suber,2015,2019,Total,Total,87,1309,106,196,106,194,0,2,85,151,187,239,426,24,23,37,73,176,297
10462,Arturas Valeika,2008,2008,Weber State,Big Sky,30,894,96,197,73,135,23,62,82,117,84,221,305,35,23,35,63,87,297
10463,Ahmad Wagner,2016,2018,Iowa,Big Ten,96,1141,116,212,114,203,2,9,63,137,120,131,251,70,43,29,59,161,297
10464,Brandon White,2008,2011,Southern,SWAC,90,1508,110,314,99,259,11,55,66,115,59,150,209,140,47,4,166,113,297
10465,A.J. Astroth,2013,2018,Total,Total,71,1071,107,240,94,182,13,58,69,111,94,181,275,33,33,11,50,109,296
10466,Wil Bathurst,2015,2019,Total,Total,70,1000,106,256,86,173,20,83,64,106,28,154,182,78,32,20,64,78,296
10467,Saddiq Bey,2019,2019,Villanova,Big East,36,1064,109,238,60,107,49,131,29,45,74,109,183,46,31,12,28,78,296
10468,Blake Gallagher,2008,2011,Western Carolina,Southern,102,1219,108,214,108,214,0,0,80,130,137,187,324,49,32,13,74,182,296
10469,Eliel Gonzalez,2015,2017,Total,Total,46,789,101,234,73,159,28,75,66,96,32,70,102,82,20,3,84,73,296
10470,Erique Gumbs,2010,2012,Towson,CAA,67,1121,117,268,116,255,1,13,61,131,91,155,246,29,35,28,90,146,296
10471,TeShaun Hightower,2018,2019,Georgia,SEC,58,826,98,249,63,128,35,121,65,110,11,86,97,82,23,3,81,55,296
10472,Jrue Holiday,2009,2009,UCLA,Pac-10,35,950,112,249,85,161,27,88,45,62,44,88,132,129,55,18,75,75,296
10473,Don McAvoy,2012,2013,Western Illinois,Summit,64,1046,111,272,84,197,27,75,47,83,27,97,124,54,30,13,61,85,296
10474,J.P. Moorman,2018,2019,Temple,AAC,60,1087,105,239,58,117,47,122,39,54,57,171,228,75,40,13,37,128,296
10475,Taylor Perry,2013,2016,Western Michigan,MAC,131,1944,100,270,69,176,31,94,65,101,79,237,316,119,62,21,113,164,296
10476,Ladan Ricketts,2019,2019,Montana State,Big Sky,30,712,96,205,27,54,69,151,35,39,23,34,57,20,8,3,31,67,296
10477,A.J. Riley,2016,2016,Eastern Illinois,OVC,30,629,93,224,73,160,20,64,90,128,39,62,101,60,23,4,64,68,296
10478,Brandon Watkins,2014,2017,West Virginia,Big 12,114,1069,127,254,127,254,0,0,42,91,107,139,246,26,30,66,58,198,296
10479,Sherrard Watson,2008,2008,Portland,WCC,31,783,92,216,71,154,21,62,91,117,34,58,92,42,26,3,72,75,296
10480,Brandon Williams,2019,2019,Arizona,Pac-12,26,732,87,231,51,117,36,114,86,105,5,67,72,86,20,5,46,52,296
10481,Yannick Atanga,2012,2015,Santa Clara,WCC,103,1748,112,230,112,229,0,1,71,140,226,344,570,18,35,94,63,293,295
10482,Djim Bandoumel,2011,2012,Idaho,WAC,40,879,117,227,117,227,0,0,61,95,58,122,180,38,5,55,48,75,295
10483,Ben Bell,2008,2008,North Texas,Sun Belt,31,971,110,250,89,186,21,64,54,83,27,96,123,105,34,2,72,65,295
10484,Julius Brooks,2010,2013,Loyola (MD),MAAC,107,1312,129,243,129,242,0,1,37,92,112,184,296,17,19,62,80,180,295
10485,Dexter Dennis,2019,2019,Wichita State,AAC,35,908,101,253,47,118,54,135,39,59,51,135,186,30,12,19,40,83,295
10486,Marshall Guilmette,2013,2015,East Carolina,Total,58,935,111,244,100,207,11,37,62,93,64,104,168,49,13,18,67,128,295
10487,James Hawthorne,2018,2019,Middle Tennessee,CUSA,64,1004,110,262,93,200,17,62,58,79,74,138,212,42,16,30,87,127,295
10488,Max Hoetzel,2015,2017,Total,Total,60,796,92,243,30,64,62,179,49,63,41,111,152,22,21,10,38,82,295
10489,Josh Odem,2010,2011,Chattanooga,Southern,41,889,96,235,49,104,47,131,56,69,26,61,87,68,39,8,65,58,295
10490,Rio Pitt,2008,2011,Total,Total,90,1304,120,254,120,254,0,0,55,84,128,187,315,35,41,45,88,200,295
10491,Courtney Ramey,2019,2019,Texas,Big 12,36,914,105,268,50,128,55,140,30,51,29,89,118,112,33,5,69,69,295
10492,Leon Spencer,2009,2010,Drexel,CAA,45,799,110,218,110,218,0,0,75,119,91,135,226,23,12,71,56,116,295
10493,Cole Stefan,2011,2014,Total,Total,75,1026,96,277,28,80,68,197,35,46,13,70,83,70,26,7,47,104,295
10494,Marcus Watts,2008,2008,Chattanooga,Southern,30,781,94,213,79,166,15,47,92,131,53,110,163,77,21,3,89,66,295
10495,Armani Williams,2010,2011,Texas-Arlington,Southland,51,710,93,279,21,64,72,215,37,54,5,43,48,36,16,2,42,76,295
10496,Scottie Wilson,2008,2008,Wright State,Horizon,30,888,109,205,83,150,26,55,51,79,60,155,215,20,16,13,55,83,295
10497,Justin Edler-Davis,2019,2019,Cal State Bakersfield,WAC,34,831,97,251,62,139,35,112,65,86,56,89,145,35,30,8,47,87,294
10498,Shea Feehan,2019,2019,Evansville,MVC,30,730,84,219,30,71,54,148,72,82,10,63,73,32,17,5,28,62,294
10499,Brett Frantz,2016,2017,Youngstown State,Horizon,65,1323,97,293,38,89,59,204,41,50,24,94,118,80,32,5,54,107,294
10500,Romani Hansen,2019,2019,Savannah State,MEAC,31,713,102,230,79,143,23,87,67,100,51,118,169,31,18,27,55,91,294
10501,Daven Harmeling,2008,2009,Washington State,Pac-10,62,1275,99,261,37,76,62,185,34,43,14,103,117,56,11,9,30,93,294
10502,Lemmie Howard,2018,2019,Jackson State,SWAC,59,967,119,279,85,176,34,103,22,37,58,106,164,31,20,26,40,109,294
10503,Jimmy Hudson,2008,2008,Bethune-Cookman,MEAC,26,836,92,244,50,130,42,114,68,88,12,73,85,37,27,8,67,59,294
10504,Troy Joseph,2011,2014,Long Island University,NEC,59,1127,97,254,48,105,49,149,51,70,63,122,185,26,26,19,48,84,294
10505,William Kossangue,2009,2010,Campbell,A-Sun,59,939,107,255,75,170,32,85,48,81,52,85,137,47,47,3,44,89,294
10506,Jordan Lathon,2019,2019,Texas-El Paso,CUSA,27,888,102,255,60,135,42,120,48,80,13,124,137,74,20,23,76,91,294
10507,Mike Marra,2010,2012,Louisville,Big East,60,928,95,301,29,54,66,247,38,50,25,75,100,79,39,16,51,68,294
10508,Hakim McCullar,2008,2012,Total,Total,94,1223,115,294,115,291,0,3,64,103,72,124,196,25,11,24,63,191,294
10509,Patrick Muldoon,2016,2019,Total,Total,65,1077,124,263,124,260,0,3,46,77,76,143,219,44,27,17,65,200,294
10510,Jaleni Neely,2015,2017,Northern Arizona,Big Sky,33,950,80,259,30,107,50,152,84,103,17,72,89,96,32,2,69,72,294
10511,Lyvann Obame Obame,2010,2011,Maryland-Eastern Shore,MEAC,60,1032,111,220,111,220,0,0,72,125,85,146,231,17,24,11,71,146,294
10512,John Pena,2009,2009,Northern Colorado,Big Sky,32,894,106,243,68,144,38,99,44,58,9,66,75,75,48,5,83,84,294
10513,Kamron Reaves,2018,2019,Florida A&M,MEAC,43,1002,103,299,70,165,33,134,55,83,17,70,87,87,33,6,129,99,294
10514,Adrian Rich,2016,2017,Virginia Military Institute,Southern,60,1386,113,283,81,171,32,112,36,49,11,61,72,104,54,6,96,111,294
10515,Andrew Rogers,2009,2012,Maine,AEC,116,1915,106,283,63,138,43,145,39,61,34,125,159,274,65,1,128,138,294
10516,DJ Sylvester,2016,2018,UC-Riverside,Big West,53,923,90,252,49,126,41,126,73,108,23,86,109,48,20,4,51,86,294
10517,Jashawn Talton,2019,2019,Texas A&M-Corpus Christi,Southland,32,889,101,224,69,132,32,92,60,80,50,113,163,38,17,15,44,98,294
10518,Conner Teahan,2008,2012,Kansas,Big 12,100,1036,95,258,27,60,68,198,36,43,41,85,126,56,36,3,51,88,294
10519,Charles Tucker Jr.,2017,2018,Sacred Heart,NEC,62,1521,94,241,75,166,19,75,87,131,11,102,113,225,39,2,150,128,294
10520,Jesse Bunkley,2008,2008,Eastern Michigan,MAC,30,852,100,254,33,69,67,185,26,33,9,77,86,57,26,3,47,75,293
10521,C.J. Clark,2008,2009,Northwestern State,Southland,49,880,110,237,97,198,13,39,60,85,39,95,134,40,27,29,85,135,293
10522,Gary Correia,2008,2011,Massachusetts,A-10,124,2060,89,305,24,85,65,220,50,80,27,131,158,234,46,7,120,146,293
10523,D.J. Davis,2016,2016,South Dakota,Summit,32,944,114,207,96,159,18,48,47,61,26,88,114,83,41,10,66,86,293
10524,Riley Grafft,2009,2012,American,Patriot,73,1110,116,224,110,203,6,21,55,84,82,150,232,38,18,25,65,132,293
10525,Dylan Hale,2010,2012,Total,Total,60,1093,97,292,34,93,63,199,36,58,30,58,88,88,57,10,82,166,293
10526,Stefhon Hannah,2008,2008,Missouri,Big 12,20,562,99,230,54,113,45,117,50,66,16,43,59,105,38,2,58,56,293
10527,Dominique Hawkins,2014,2017,Kentucky,SEC,121,1426,92,251,55,121,37,130,72,101,46,77,123,103,47,5,35,159,293
10528,P.J. Hubert,2011,2014,IUPUI,Summit,70,919,97,259,23,59,74,200,25,31,3,61,64,49,20,6,41,72,293
10529,Joel James,2013,2016,North Carolina,ACC,135,1188,123,272,123,272,0,0,47,75,116,192,308,18,14,30,73,169,293
10530,Jeremy Johnson,2017,2018,Milwaukee,Horizon,52,1014,103,271,63,136,40,135,47,58,24,101,125,51,19,9,41,104,293
10531,Corey Manigault,2017,2019,Total,Total,49,598,101,217,100,207,1,10,90,121,54,105,159,23,18,10,51,85,293
10532,Adam May,2008,2010,Holy Cross,Patriot,71,1019,78,232,47,126,31,106,106,140,54,95,149,65,34,15,61,148,293
10533,Brandon Morris,2013,2014,Houston,Total,65,1055,98,234,46,108,52,126,45,53,31,99,130,81,41,11,50,97,293
10534,Fausto Pichardo,2018,2019,Alabama State,SWAC,58,978,112,205,110,198,2,7,67,117,78,139,217,28,32,48,84,165,293
10535,Kevin Seymour,2015,2017,Central Connecticut State,NEC,80,1614,120,323,96,244,24,79,29,44,17,121,138,183,34,6,110,59,293
10536,Grant Surprenant,2008,2009,Saint Francis (PA),NEC,56,796,105,234,32,67,73,167,10,11,15,49,64,32,16,4,32,53,293
10537,Jaylon Tate,2014,2017,Illinois,Big Ten,121,1986,84,248,78,191,6,57,119,161,15,127,142,304,64,11,131,159,293
10538,Jason Todd,2015,2016,Portland,WCC,60,1321,108,237,66,130,42,107,35,52,48,129,177,78,37,10,50,59,293
10539,Darius Williams,2019,2019,Prairie View,SWAC,34,612,97,254,53,116,44,138,55,70,21,55,76,22,36,2,35,83,293
10540,Warren Williams,2019,2019,Manhattan,MAAC,32,607,116,203,116,202,0,1,61,123,52,72,124,17,13,22,65,98,293
10541,Russell Woods,2016,2017,Missouri,SEC,61,1098,106,214,106,214,0,0,81,150,98,117,215,21,15,12,47,181,293
10542,Ryan Appleby,2008,2008,Washington,Pac-10,26,732,96,245,19,45,77,200,23,27,2,29,31,36,9,3,31,40,292
10543,Eric Ayala,2019,2019,Maryland,Big Ten,34,986,96,223,44,95,52,128,48,62,9,90,99,72,10,10,55,47,292
10544,Evan Battey,2019,2019,Colorado,Pac-12,36,768,105,218,102,202,3,16,79,112,68,89,157,44,17,12,37,108,292
10545,Onzie Branch,2013,2014,Gardner-Webb,Big South,67,1013,111,233,111,221,0,12,70,104,89,149,238,51,40,20,64,121,292
10546,Deniz Celen,2017,2019,Total,Total,56,884,131,260,115,185,16,75,14,30,71,155,226,57,20,35,54,123,292
10547,Myles Cherry,2017,2019,Lafayette,Patriot,80,1223,122,217,118,200,4,17,44,78,88,222,310,49,35,23,76,131,292
10548,Tyreese Davis,2019,2019,Jacksonville,A-Sun,29,807,109,226,82,146,27,80,47,64,34,89,123,77,41,19,46,58,292
10549,Juhwan Harris-Dyson,2018,2019,University of California,Pac-12,60,1061,111,248,111,225,0,23,70,120,67,96,163,61,60,15,89,151,292
10550,Merrill Holden,2015,2017,Total,Total,75,997,99,186,97,176,2,10,92,147,89,110,199,4,17,49,51,162,292
10551,Amadi Ikpeze,2017,2019,St. Bonaventure,A-10,90,1057,117,247,117,247,0,0,58,91,66,163,229,9,19,34,50,197,292
10552,John Jones,2018,2019,Total,Total,45,763,95,255,34,79,61,176,41,48,18,38,56,58,17,1,58,47,292
10553,Coty Jude,2019,2019,North Carolina-Asheville,Big South,31,838,91,223,23,62,68,161,42,57,26,75,101,24,25,13,43,78,292
10554,Ami Lakoju,2015,2019,UC-Santa Barbara,Big West,91,849,127,219,127,219,0,0,38,79,112,127,239,11,9,41,60,164,292
10555,Isaiah Maurice,2017,2019,Total,Total,66,746,118,234,105,192,13,42,43,66,39,131,170,20,7,45,63,145,292
10556,Tavario Miller,2014,2017,Texas A&M,SEC,123,1298,110,226,110,224,0,2,72,148,132,234,366,29,22,34,81,223,292
10557,Aanen Moody,2019,2019,North Dakota,Summit,30,691,100,246,19,48,81,198,11,12,6,54,60,26,23,4,32,53,292
10558,Byron Mullens,2009,2009,Ohio State,Big Ten,33,671,120,188,120,187,0,1,52,93,55,99,154,9,16,37,51,68,292
10559,Luke Piotrowski,2013,2016,Total,Total,89,1027,115,238,115,235,0,3,62,89,65,105,170,30,12,70,60,103,292
10560,Randy Reed,2015,2016,Omaha,Summit,58,829,106,198,101,182,5,16,75,101,41,108,149,27,26,17,49,95,292
10561,Tavares Sledge,2012,2014,Wright State,Horizon,86,1222,119,283,118,273,1,10,53,96,97,202,299,24,33,23,79,196,292
10562,Jamaal Smith,2008,2008,New Mexico,MWC,33,654,81,166,43,88,38,78,92,117,6,64,70,61,13,2,45,88,292
10563,Brandon Stewart,2012,2015,Bethune-Cookman,MEAC,35,709,80,240,54,140,26,100,106,141,47,68,115,28,22,3,60,67,292
10564,Isaiah Tisdale,2019,2019,East Tennessee State,Southern,33,812,106,206,77,126,29,80,51,79,32,63,95,98,36,7,34,77,292
10565,Daniel Turner,2011,2013,Green Bay,Horizon,59,1199,95,232,84,182,11,50,91,135,113,154,267,49,32,18,89,160,292
10566,Brandon Williams,2008,2010,Stetson,A-Sun,91,1481,97,340,30,88,67,252,31,55,22,92,114,139,50,2,109,90,292
10567,Moses Wright,2018,2019,Georgia Tech,ACC,55,969,122,300,115,245,7,55,41,80,48,150,198,40,29,32,63,79,292
10568,Nathan Bain,2016,2019,Stephen F. Austin,Southland,81,1174,106,219,89,166,17,53,62,101,63,129,192,60,59,26,69,142,291
10569,Niels Bunschoten,2016,2017,Indiana State,MVC,63,940,102,261,54,107,48,154,39,48,20,74,94,28,12,36,44,145,291
10570,Mark Coury,2008,2011,Total,Total,93,1188,124,252,124,251,0,1,43,72,87,157,244,65,44,34,50,153,291
10571,John Daniels,2010,2013,Columbia,Ivy,98,1733,113,246,113,241,0,5,65,113,142,311,453,70,60,13,131,221,291
10572,Jared Dillinger,2008,2008,Hawaii,WAC,30,918,99,230,48,97,51,133,42,67,30,61,91,61,34,3,60,91,291
10573,Branden Doughty,2010,2011,Coppin State,MEAC,58,1194,122,260,118,249,4,11,43,64,68,179,247,31,27,45,63,160,291
10574,DeLovell Earls,2012,2015,Air Force,MWC,92,1207,108,262,91,198,17,64,58,111,75,146,221,121,41,11,100,161,291
10575,Mike Edwards,2016,2019,Georgia,SEC,111,1498,113,244,113,241,0,3,65,127,99,199,298,26,20,29,86,190,291
10576,Brandon Garrett,2011,2013,Murray State,OVC,74,1199,118,207,118,207,0,0,55,104,78,159,237,31,33,41,75,158,291
10577,Louis Green,2010,2013,Total,Total,79,979,123,226,123,225,0,1,45,69,72,158,230,13,11,46,71,140,291
10578,Ty Groce,2018,2019,Eastern Michigan,MAC,66,1190,103,250,73,143,30,107,55,80,48,139,187,54,57,38,77,123,291
10579,Philipp Hartwich,2015,2018,Portland,WCC,117,1808,117,197,117,197,0,0,57,160,152,360,512,57,31,160,113,307,291
10580,Matt Heramb,2008,2011,Total,Total,82,1313,103,250,71,160,32,90,53,70,60,141,201,89,28,63,100,134,291
10581,Justin Minaya,2018,2019,South Carolina,SEC,37,988,105,264,64,142,41,122,40,58,62,100,162,55,23,10,44,82,291
10582,Paul Nelson,2008,2010,Yale,Ivy,79,1112,109,215,109,215,0,0,73,117,90,153,243,22,6,44,54,140,291
10583,Arjun Ohri,2011,2012,NJIT,GWC,53,795,100,240,30,65,70,175,21,23,2,52,54,51,19,5,33,78,291
10584,Russell Robinson,2008,2008,Kansas,Big 12,40,1100,84,198,49,88,35,110,88,113,20,93,113,162,79,16,83,75,291
10585,Aaron Scales,2013,2017,Total,Total,102,1195,111,213,111,213,0,0,69,128,131,134,265,18,16,34,83,206,291
10586,Parker Stewart,2018,2018,Pittsburgh,ACC,32,839,90,235,19,51,71,184,40,50,16,89,105,29,14,5,19,51,291
10587,Erik Swoope,2011,2014,Miami (FL),ACC,110,1190,107,206,105,196,2,10,75,130,78,108,186,31,37,25,31,137,291
10588,Arsenio Williams,2009,2010,South Carolina State,MEAC,40,717,109,208,109,205,0,3,73,122,80,112,192,20,25,13,46,71,291
10589,Andre Almeida,2011,2013,Nebraska,Total,59,869,123,234,123,234,0,0,44,78,74,123,197,37,13,71,71,141,290
10590,Cody Anderson,2009,2011,Montana State,Big Sky,85,1068,114,231,90,162,24,69,38,56,73,105,178,22,15,20,39,114,290
10591,Mitchell Beauford,2008,2008,Stony Brook,AEC,30,792,113,276,97,228,16,48,48,79,23,55,78,60,34,0,39,56,290
10592,Ja'Donta Blakley,2016,2017,Prairie View,SWAC,61,1335,113,262,106,239,7,23,57,100,45,148,193,168,106,25,105,159,290
10593,Jason Boswell,2014,2016,Florida International,CUSA,92,1703,99,264,68,158,31,106,61,81,22,106,128,129,37,12,114,187,290
10594,Micah Bradford,2017,2019,Valparaiso,Total,65,970,101,310,51,134,50,176,38,74,9,83,92,94,33,2,77,108,290
10595,Aaron (Gordo) Castillo,2011,2011,New Mexico State,WAC,32,854,91,211,25,46,66,165,42,49,21,65,86,30,21,3,31,54,290
10596,Jeremy Dean,2011,2012,Florida A&M,MEAC,62,1323,108,249,105,226,3,23,71,154,111,151,262,60,43,29,97,132,290
10597,Daniel Deane,2009,2011,Oregon State,Pac-10,77,1158,94,235,69,146,25,89,77,134,83,169,252,41,26,17,108,140,290
10598,Michael Green,2011,2014,Tennessee State,OVC,90,1343,108,254,101,214,7,40,67,89,87,147,234,23,19,95,68,135,290
10599,Jacolby Hardiman,2009,2009,Central Michigan,MAC,30,960,115,238,115,237,0,1,60,141,67,79,146,40,45,3,77,76,290
10600,Matt Hart,2016,2017,George Washington,A-10,73,822,99,235,44,105,55,130,37,42,18,69,87,43,20,2,34,72,290
10601,Jerel Hastings,2008,2009,Albany (NY),AEC,61,1137,99,225,92,197,7,28,85,113,84,99,183,57,32,5,53,88,290
10602,Derek Hawthorne,2019,2019,Tennessee-Martin,OVC,30,839,102,246,67,151,35,95,51,68,49,95,144,46,38,8,35,57,290
10603,Keyontae Johnson,2019,2019,Florida,SEC,36,855,111,236,88,173,23,63,45,70,68,161,229,45,38,12,48,84,290
10604,Alan Jones,2012,2012,Troy,Sun Belt,28,613,103,268,40,93,63,175,21,29,20,33,53,18,28,3,26,40,290
10605,Gary Lee,2008,2009,Maryland-Eastern Shore,MEAC,48,1023,97,323,72,206,25,117,71,103,73,78,151,21,16,4,63,84,290
10606,Maxwell Lenox,2012,2016,Army,Patriot,82,1180,102,218,92,175,10,43,76,123,36,141,177,175,58,7,126,163,290
10607,Luc Richard Mbah a Moute,2008,2008,UCLA,Pac-10,33,958,117,245,112,220,5,25,51,74,73,125,198,51,34,15,62,55,290
10608,David Padgett,2008,2008,Louisville,Big East,26,611,112,168,112,168,0,0,66,100,47,77,124,52,11,29,40,71,290
10609,Christian Sanders,2013,2017,Stanford,Pac-12,119,1643,86,256,61,169,25,87,93,126,18,137,155,218,43,3,125,144,290
10610,Brandon Smalls,2009,2010,South Carolina State,MEAC,40,800,102,287,60,145,42,142,44,60,50,91,141,36,21,4,39,55,290
10611,Kai Toews,2019,2019,North Carolina-Wilmington,CAA,33,1014,107,264,90,194,17,70,59,78,9,76,85,253,18,0,112,45,290
10612,Devon Atkinson,2012,2013,Morehead State,OVC,59,1167,101,241,69,159,32,82,55,69,15,52,67,191,51,0,114,109,289
10613,Austin Awad,2018,2019,Winthrop,Big South,57,652,98,261,16,30,82,231,11,13,31,109,140,9,8,7,27,64,289
10614,Lamar Barrett,2008,2008,Longwood,Ind,31,894,107,285,82,221,25,64,50,74,71,90,161,82,48,13,50,81,289
10615,Kenny Brown,2008,2009,Stanford,Pac-10,60,717,100,228,47,92,53,136,36,48,16,71,87,51,25,0,39,51,289
10616,Nikola Bundalo,2011,2011,Southern Illinois-Edwardsville,Ind,29,692,123,210,123,210,0,0,43,60,51,123,174,7,11,30,63,89,289
10617,Jahmal Burroughs,2009,2012,Total,Total,81,1298,107,229,103,203,4,26,71,155,111,171,282,41,29,7,66,167,289
10618,Donald Carey,2018,2018,Mount St. Mary's,NEC,32,1006,98,240,59,133,39,107,54,66,11,74,85,109,32,3,86,60,289
10619,Michael Celestine,2011,2012,Southern,SWAC,39,847,100,266,38,88,62,178,27,41,13,61,74,54,27,4,54,78,289
10620,Wade Collie,2012,2013,Southern Utah,Total,53,1017,106,249,77,165,29,84,48,72,34,135,169,73,38,5,76,98,289
10621,Bill Edwards,2010,2014,Total,Total,50,921,104,279,70,172,34,107,47,55,40,140,180,59,19,19,84,98,289
10622,Aleem Ford,2018,2019,Wisconsin,Big Ten,64,1233,95,253,27,63,68,190,31,37,31,119,150,41,19,10,41,108,289
10623,Adrian Gailliard,2009,2010,Western Carolina,Southern,65,954,107,215,106,214,1,1,74,121,77,95,172,18,22,27,75,192,289
10624,Dee Goens,2010,2013,Holy Cross,Patriot,110,1295,93,246,71,173,22,73,81,111,18,101,119,148,44,6,121,143,289
10625,Vaughn Gray,2012,2015,George Mason,Total,95,1074,100,288,51,140,49,148,40,77,42,64,106,23,35,6,42,106,289
10626,Xavier Habersham,2016,2017,Middle Tennessee,CUSA,70,1082,102,234,41,84,61,150,24,38,33,82,115,70,16,8,45,109,289
10627,Deonte Hearns,2016,2017,Grambling,SWAC,30,797,103,224,103,217,0,7,83,140,67,111,178,22,25,7,72,98,289
10628,Jared Klein,2013,2016,Western Michigan,MAC,105,1201,96,237,51,113,45,124,52,67,5,111,116,67,38,0,76,73,289
10629,Andrew Nembhard,2019,2019,Florida,SEC,36,1184,106,256,71,155,35,101,42,55,6,97,103,194,44,2,75,62,289
10630,Gabe Snider,2013,2016,Illinois-Chicago,Horizon,80,890,102,271,24,71,78,200,7,13,25,66,91,38,22,10,32,87,289
10631,Marcus Wallace,2016,2019,Arkansas-Pine Bluff,SWAC,87,1224,95,245,52,118,43,127,56,75,39,63,102,52,45,1,95,87,289
10632,Yahosh Bonner,2009,2010,Northern Colorado,Big Sky,65,1487,69,200,26,70,43,130,107,149,14,104,118,125,64,2,77,179,288
10633,Anthony Brock,2009,2010,Alabama,SEC,50,1146,93,259,30,95,63,164,39,55,15,67,82,101,80,3,69,91,288
10634,Calvin Chitwood,2008,2008,Cal State Northridge,Big West,27,637,106,198,81,140,25,58,51,65,44,83,127,15,25,29,24,87,288
10635,Keith Davis,2011,2015,Total,Total,101,1472,115,237,115,237,0,0,58,109,106,188,294,23,26,62,101,210,288
10636,Nick Davis,2014,2018,Total,Total,84,1312,109,245,80,138,29,107,41,76,73,244,317,42,42,53,73,176,288
10637,T.J. DiLeo,2009,2013,Temple,A-10,126,1768,101,242,71,131,30,111,56,92,44,141,185,122,80,10,62,115,288
10638,Doug Elwell,2008,2010,Wagner,NEC,90,1353,99,283,27,72,72,211,18,27,53,144,197,118,32,52,72,65,288
10639,Brandon Gordon,2008,2008,Alabama State,SWAC,31,772,107,228,83,167,24,61,50,88,44,121,165,30,22,17,40,78,288
10640,Edward Hayden,2008,2010,Coppin State,MEAC,84,768,129,291,125,273,4,18,26,39,54,95,210,18,15,11,57,109,288
10641,Taylor Jones,2011,2013,Eastern Illinois,OVC,81,1410,94,247,27,54,67,193,33,38,12,114,126,79,37,3,67,124,288
10642,Gal Mekel,2008,2008,Wichita State,MVC,31,952,91,257,56,135,35,122,71,81,15,83,98,115,12,2,85,64,288
10643,Tavaris Nance,2008,2008,Southeastern Louisiana,Southland,30,869,108,210,106,194,2,16,70,118,38,83,121,64,58,17,76,83,288
10644,LaVanne Pennington,2010,2013,Total,Total,57,782,103,306,70,179,33,127,49,75,34,84,118,23,22,3,58,61,288
10645,Xavier Perkins,2008,2009,Florida Atlantic,Sun Belt,41,841,74,168,65,141,9,27,131,186,39,86,125,60,18,3,97,110,288
10646,Jalen Rhea,2014,2017,American,Patriot,85,970,92,234,22,45,70,189,34,48,43,35,78,18,22,4,24,85,288
10647,Shamiel Stevenson,2018,2019,Pittsburgh,ACC,36,793,102,200,86,159,16,41,68,113,27,121,148,34,19,9,75,53,288
10648,Jeremy Verhagen,2015,2016,Northern Colorado,Big Sky,61,1045,111,203,106,178,5,25,61,97,77,101,178,19,16,30,67,138,288
10649,Steven Werner,2012,2012,Sam Houston State,Southland,27,588,119,189,119,189,0,0,50,89,51,113,164,12,15,12,59,71,288
10650,Christian Williams,2016,2019,Total,Total,77,1243,101,283,86,235,15,48,71,97,42,154,196,123,65,7,77,72,288
10651,Brent Wilson,2008,2008,Albany (NY),AEC,30,904,101,251,39,76,62,175,24,32,42,131,173,48,19,9,38,79,288
10652,Benson Akpan,2008,2009,Stephen F. Austin,Southland,64,697,123,219,123,219,0,0,41,78,76,121,197,11,13,65,54,97,287
10653,Denzel Barnes,2010,2011,Stephen F. Austin,Southland,47,932,95,262,54,136,41,126,56,83,15,54,69,134,58,1,97,91,287
10654,Brad Birton,2010,2011,Illinois-Chicago,Horizon,54,1325,125,267,124,258,1,9,36,57,113,130,243,59,42,19,90,156,287
10655,Josh Bonney,2009,2010,Texas-San Antonio,Southland,59,1177,114,202,114,202,0,0,59,92,107,120,227,14,27,13,46,157,287
10656,Lawrence Bridges,2009,2012,Total,Total,95,1458,119,224,119,222,0,2,49,114,131,135,266,48,39,5,99,220,287
10657,Keyshawn Bryant,2019,2019,South Carolina,SEC,32,779,119,262,113,233,6,29,43,75,36,86,122,46,22,17,64,75,287
10658,Michael Lance,2008,2010,Arkansas State,Sun Belt,63,911,104,241,58,122,46,119,33,41,49,66,115,45,28,4,52,81,287
10659,Chad Lang,2012,2015,Total,Total,92,626,121,220,121,220,0,0,45,94,60,107,167,1,9,37,61,151,287
10660,Demontez Loman,2015,2016,Tennessee State,OVC,62,1529,117,238,117,237,0,1,53,102,112,236,348,33,57,70,68,195,287
10661,Jason Miller,2008,2009,Columbia,Ivy,50,865,111,214,111,214,0,0,65,115,81,119,200,36,24,23,62,95,287
10662,David Pendergraft,2008,2008,Gonzaga,WCC,33,806,102,204,61,111,41,93,42,58,53,91,144,28,29,7,28,82,287
10663,Laterrance Reed,2019,2019,Northwestern State,Southland,31,728,86,251,37,107,49,144,66,87,24,41,65,43,17,1,62,41,287
10664,Noah Savage,2008,2008,Princeton,Ivy,29,781,93,221,48,101,45,120,56,72,33,58,91,30,14,1,51,102,287
10665,Reggie Theus,2014,2018,Total,Total,84,1131,118,292,111,270,7,22,44,87,50,59,109,35,24,11,53,115,287
10666,Jarrell Thomas,2009,2010,Bethune-Cookman,MEAC,58,994,98,252,49,100,49,152,42,62,32,69,101,50,34,3,64,73,287
10667,Quinton Thomas,2015,2019,Total,Southland,89,984,88,226,53,94,35,132,76,121,26,106,132,46,45,12,60,91,287
10668,Devonte Bandoo,2019,2019,Baylor,Big 12,34,717,98,218,47,89,51,129,39,43,16,59,75,46,19,2,40,38,286
10669,Clevon Brown,2017,2019,Vanderbilt,SEC,98,1331,115,254,94,167,21,87,35,73,105,134,239,27,17,97,66,168,286
10670,Davon Clare,2017,2019,Cal State Fullerton,Big West,95,1444,117,279,103,201,14,78,38,62,82,223,305,98,35,44,90,118,286
10671,Jc Clark,2008,2008,Louisiana Tech,WAC,30,945,95,248,57,136,38,112,58,67,10,70,80,48,32,0,38,43,286
10672,Grant Fiorentinos,2012,2016,Total,Total,85,938,107,227,106,224,1,3,71,109,62,113,175,23,22,9,56,138,286
10673,John Freeman,2010,2011,Southern Illinois,MVC,60,1212,96,210,84,171,12,39,82,111,57,102,159,96,62,22,56,92,286
10674,Bo Holston,2009,2012,Citadel,Southern,72,1267,103,241,91,197,12,44,68,104,54,148,202,60,34,5,101,154,286
10675,Brae Ivey,2019,2019,San Jose State,MWC,31,808,81,215,43,93,38,122,86,109,10,62,72,102,35,2,83,97,286
10676,Justin McKie,2014,2017,South Carolina,SEC,104,1193,101,280,61,145,40,135,44,65,45,118,163,81,35,8,45,100,286
10677,Scotty McRae,2009,2010,Albany (NY),AEC,53,960,89,256,80,212,9,44,99,136,81,136,217,26,28,41,79,106,286
10678,Matt Miller,2015,2015,New Hampshire,AEC,29,662,100,211,37,80,63,131,23,31,13,74,87,34,11,1,21,44,286
10679,Brandon Monroe,2008,2009,Norfolk State,MEAC,58,1488,129,213,129,212,0,1,28,88,163,209,372,29,34,47,57,187,286
10680,Troy Simmons,2018,2018,New Mexico,MWC,29,676,96,242,43,96,53,146,41,52,33,56,89,42,52,5,32,67,286
10681,Bryce Simon,2008,2009,American,Patriot,55,1062,87,232,30,75,57,157,55,73,29,122,151,81,18,4,71,79,286
10682,Collin Spickerman,2015,2016,Portland State,Big Sky,56,1110,128,260,126,252,2,8,28,41,93,131,224,46,37,117,53,136,286
10683,Luke Avdalovic,2019,2019,Northern Arizona,Big Sky,30,797,91,188,18,40,73,148,30,35,4,60,64,28,19,0,14,34,285
10684,Dishawn Bradshaw,2011,2011,Maryland-Eastern Shore,MEAC,31,776,94,246,54,107,40,139,57,75,20,49,69,42,18,0,39,58,285
10685,Rickey Brice Jr.,2016,2017,North Texas,CUSA,56,738,106,240,106,239,0,1,73,123,48,169,217,4,13,60,58,127,285
10686,George Brozos,2008,2008,Furman,Southern,30,636,88,200,58,126,30,74,79,98,37,89,126,30,22,8,40,50,285
10687,Andy Buechert,2008,2010,Winthrop,Big South,65,1240,112,261,112,259,0,2,61,135,137,187,324,25,27,55,81,157,285
10688,Malcolm Canada,2014,2015,Auburn,SEC,65,1130,85,233,75,179,10,54,105,145,25,118,143,98,58,16,73,143,285
10689,Ashton Hagans,2019,2019,Kentucky,SEC,37,1054,100,214,86,163,14,51,71,94,22,74,96,158,59,4,94,73,285
10690,Reggie Jackson,2008,2008,Duquesne,A-10,29,620,94,208,62,135,32,73,65,83,9,43,52,98,33,1,69,51,285
10691,Rodney Jones,2008,2011,Total,Total,50,867,104,233,72,147,32,86,45,61,34,81,115,58,29,11,59,70,285
10692,Mogga Lado,2017,2018,Campbell,Big South,71,1153,108,186,108,186,0,0,69,114,88,174,262,62,28,38,70,129,285
10693,Rodney McCauley,2009,2012,Total,Total,99,1686,99,241,78,175,21,66,66,117,86,153,239,83,58,10,81,239,285
10694,Jawann McClellan,2008,2008,Arizona,Pac-10,34,1193,96,225,64,142,32,83,61,81,23,101,124,92,22,22,62,71,285
10695,Kameron Mitchell,2014,2017,Stony Brook,AEC,110,1666,94,256,41,106,53,150,44,69,23,91,114,84,48,10,72,202,285
10696,Danny Mundweiler,2010,2011,Wagner,NEC,59,1105,90,242,22,59,68,183,37,55,8,45,53,44,19,2,61,104,285
10697,Bernell Murray,2008,2008,Fairleigh Dickinson,NEC,27,914,101,276,59,141,42,135,41,48,15,83,98,70,37,2,71,73,285
10698,Laquarious Paige,2015,2019,Total,Total,78,1142,108,263,73,144,35,119,34,44,11,97,108,71,45,19,106,136,285
10699,Lance Stokes,2012,2015,Chattanooga,Southern,106,1609,93,193,93,191,0,2,99,171,88,148,236,50,59,18,86,186,285
10700,Mike Williams,2009,2009,Cincinnati,Big East,29,813,105,205,104,204,1,1,74,97,72,93,165,48,10,13,45,77,285
10701,Ryan Winters,2012,2015,Elon,Total,86,1230,106,216,106,216,0,0,73,104,83,136,219,47,22,7,59,154,285
10702,Patrick Bouli,2008,2010,Manhattan,MAAC,80,1921,94,262,41,94,53,168,43,60,28,228,256,140,95,7,99,145,284
10703,Malcolm Brent,2015,2017,Maryland-Baltimore County,AEC,64,1130,92,282,31,95,61,187,39,52,20,90,110,43,29,3,66,75,284
10704,Shaheed Davis,2015,2016,Central Florida,AAC,54,914,101,276,71,170,30,106,52,100,59,144,203,28,15,20,80,62,284
10705,Kevin Estes,2008,2011,Hartford,AEC,96,1013,122,233,121,230,1,3,39,56,43,90,133,40,31,16,74,166,284
10706,Seth Evans,2010,2011,Green Bay,Horizon,66,1188,88,238,31,80,57,158,51,63,24,67,91,73,40,0,66,123,284
10707,Leon Freeman-Daniels,2019,2019,Alabama State,SWAC,30,749,87,221,42,104,45,117,65,91,33,80,113,28,29,7,34,56,284
10708,Jake Giesler,2012,2016,Total,Total,104,1164,117,268,104,209,13,59,37,76,95,156,251,40,19,35,52,163,284
10709,Paul Guede,2009,2011,Portland State,Big Sky,64,1220,88,241,57,129,31,112,77,110,79,120,199,44,56,15,69,179,284
10710,Trent Harris,2019,2019,Northern Colorado,Big Sky,32,688,100,245,27,49,73,196,11,18,11,52,63,18,28,2,30,27,284
10711,Brent Heemskerk,2008,2009,Drake,MVC,66,1244,121,211,117,184,4,27,38,73,102,152,254,39,50,53,36,161,284
10712,Andres Irarrazabal,2010,2011,Tennessee-Martin,OVC,62,1247,112,211,112,211,0,0,60,88,100,127,227,33,36,37,51,129,284
10713,D'Andre Johnson,2014,2015,Florida Atlantic,CUSA,53,1010,94,245,56,126,38,119,58,80,13,82,95,89,31,0,79,93,284
10714,A.J. Jones,2013,2013,Southeast Missouri State,OVC,33,666,105,229,75,159,30,70,44,72,36,74,110,53,19,9,68,82,284
10715,Torren Jones,2014,2016,Total,Total,51,796,113,216,113,216,0,0,58,84,99,135,234,19,28,15,53,103,284
10716,Sasha Kaun,2008,2008,Kansas,Big 12,40,707,109,176,109,176,0,0,66,122,64,90,154,12,17,49,32,97,284
10717,Jake Killingsworth,2017,2019,Columbia,Ivy,54,1092,102,258,38,90,64,168,16,27,39,112,151,79,27,4,31,76,284
10718,Lawrence Miller,2012,2013,Citadel,Southern,46,788,94,250,26,71,68,179,28,46,5,32,37,62,21,3,53,56,284
10719,Sebastian Much,2018,2019,Princeton,Ivy,53,891,104,253,50,100,54,153,22,40,36,81,117,57,16,10,74,82,284
10720,Tavon Sledge,2012,2014,Total,Total,70,1150,111,221,102,193,9,28,53,84,34,89,123,143,46,7,70,79,284
10721,Jamaree Bouyea,2018,2019,San Francisco,WCC,67,1194,103,251,75,150,28,101,49,74,19,142,161,73,52,25,57,89,283
10722,Darius Brown II,2019,2019,Cal State Northridge,Big West,34,1060,101,221,74,133,27,88,54,70,28,95,123,176,47,5,59,75,283
10723,Clif Colbert,2008,2009,Navy,Patriot,49,880,102,202,94,162,8,40,71,98,84,126,210,30,58,4,50,97,283
10724,LaKory Daniels,2008,2008,Lipscomb,A-Sun,31,920,92,243,30,69,62,174,37,47,9,40,49,59,18,1,38,50,283
10725,Antonio Daye Jr,2019,2019,Florida International,CUSA,34,872,101,255,88,192,13,63,68,112,18,82,100,90,53,1,92,90,283
10726,Adam Emmenecker,2008,2008,Drake,MVC,33,1093,79,172,79,170,0,2,125,150,71,82,153,213,53,4,103,69,283
10727,Jonathan Graham,2011,2015,Total,Total,119,1551,116,258,116,258,0,0,51,101,140,200,340,22,17,66,72,229,283
10728,Marques Johnson,2008,2011,Total,Total,84,1616,114,278,102,233,12,45,43,65,21,152,173,172,44,10,115,153,283
10729,Elijah Joiner,2018,2019,Tulsa,AAC,63,1255,80,239,33,102,47,137,76,116,13,149,162,129,32,2,78,120,283
10730,Eddy Kayouloud,2019,2019,Central Arkansas,Southland,31,776,102,245,61,131,41,114,38,51,36,119,155,47,10,4,51,54,283
10731,James Loupos,2011,2014,Navy,Patriot,117,1529,96,254,84,214,12,40,79,132,62,118,180,40,43,16,78,222,283
10732,Keith Matthews,2018,2019,Stetson,A-Sun,59,837,115,269,94,195,21,74,32,55,43,109,152,47,38,8,50,80,283
10733,Markese McGuire,2014,2016,Illinois-Chicago,Horizon,88,1145,88,284,52,177,36,107,71,110,30,99,129,48,30,10,62,69,283
10734,Dallas Morgan,2019,2019,Central Michigan,MAC,35,605,94,242,30,68,64,174,31,42,13,64,77,25,22,1,31,58,283
10735,Jonathan Mulmore,2017,2018,Georgetown,Big East,62,1329,75,182,50,121,25,61,108,142,18,89,107,162,46,9,93,152,283
10736,Prince Oduro,2018,2018,Siena,MAAC,31,795,121,250,121,250,0,0,41,123,48,109,157,23,7,21,66,100,283
10737,Aaryn Rai,2018,2019,Dartmouth,Ivy,53,1027,98,240,65,152,33,88,54,68,62,142,204,42,34,17,63,89,283
10738,Willie Readus,2012,2013,Jackson State,SWAC,45,869,98,254,98,253,0,1,87,127,67,143,210,27,32,10,68,134,283
10739,Thomas Rivera,2016,2017,Maryland-Eastern Shore,MEAC,62,1216,95,282,58,153,37,129,56,82,29,84,113,190,53,3,121,134,283
10740,Derrick Roberts,2008,2008,Southern Methodist,CUSA,28,898,99,233,62,123,37,110,48,64,22,65,87,54,23,5,54,40,283
10741,Brandon Shingles,2009,2010,Morehead State,OVC,58,1598,102,223,95,198,7,25,72,106,46,92,138,255,70,5,145,140,283
10742,Coye Simmons,2015,2018,Georgia Southern,Sun Belt,113,1411,110,233,110,232,0,1,63,107,184,283,467,17,24,18,62,220,283
10743,Aerris Smith,2011,2014,Wofford,Southern,107,1632,121,225,121,225,0,0,41,74,112,148,260,11,28,10,62,148,283
10744,Austin Steed,2008,2012,Total,Total,82,1070,106,219,106,219,0,0,71,111,117,159,276,22,36,49,65,143,283
10745,Alonzo Traylor,2013,2014,North Dakota,Big Sky,39,647,119,202,119,202,0,0,45,79,66,91,157,4,10,22,35,106,283
10746,Brandon Walters,2008,2012,Total,Total,91,908,112,253,112,252,0,1,59,103,112,159,271,17,13,53,53,144,283
10747,Marcel Williams,2009,2011,Austin Peay,OVC,98,1463,111,213,111,213,0,0,61,124,113,195,308,60,34,75,86,223,283
10748,New Williams,2016,2019,Total,Total,57,967,93,254,35,71,58,183,39,61,17,103,120,37,32,10,38,98,283
10749,Tristan Worrell,2008,2009,Lamar,Southland,55,1046,103,234,103,233,0,1,77,103,72,113,185,69,23,9,65,114,283
10750,Luke Bonner,2008,2009,Massachusetts,A-10,58,897,99,234,47,95,52,139,32,55,81,132,213,38,15,44,35,141,282
10751,Chad DeCasas,2008,2009,UC-Irvine,Big West,64,1160,105,267,57,133,48,134,24,32,22,82,104,58,14,3,56,91,282
10752,L.C. Doss,2011,2012,Eastern Illinois,OVC,48,1056,99,261,45,108,54,153,30,42,12,64,76,53,32,1,46,62,282
10753,Anthony Eaves,2016,2017,Chicago State,WAC,55,809,107,288,58,143,49,145,19,23,23,78,101,63,27,7,64,56,282
10754,Ishmael El-Amin,2018,2019,Ball State,MAC,50,998,99,240,56,117,43,123,41,60,9,85,94,67,30,6,61,64,282
10755,Gerald Fonzie,2008,2008,Stephen F. Austin,Southland,32,921,101,237,33,73,68,164,12,22,4,65,69,64,27,2,38,48,282
10756,Michael Forrest,2019,2019,Florida Atlantic,CUSA,33,938,94,251,50,122,44,129,50,66,16,77,93,96,38,1,87,66,282
10757,Marquis Horne,2013,2014,Cal State Fullerton,Big West,36,779,107,255,81,177,26,78,42,61,51,105,156,31,22,13,50,98,282
10758,Kari Jonsson,2017,2017,Drexel,CAA,28,797,94,201,29,52,65,149,29,35,11,53,64,55,28,3,39,58,282
10759,Jerome Meyinsse,2008,2010,Virginia,ACC,74,1027,100,172,100,172,0,0,82,121,76,127,203,14,14,33,32,134,282
10760,Teyvon Myers,2016,2017,West Virginia,Big 12,66,729,100,239,79,180,21,59,61,85,21,52,73,68,29,1,55,61,282
10761,Ross Neltner,2008,2008,Vanderbilt,SEC,34,918,105,232,94,200,11,32,61,77,55,135,190,69,35,17,68,82,282
10762,Dalton Nixon,2015,2019,Brigham Young,WCC,74,971,98,206,89,151,9,55,77,99,61,119,180,69,28,15,49,122,282
10763,Jeremy Olsen,2013,2015,Utah,Pac-12,79,803,123,228,123,228,0,0,36,60,55,122,177,15,12,30,59,112,282
10764,Tucker Richardson,2019,2019,Colgate,Patriot,35,1152,100,231,47,87,53,144,29,40,29,119,148,132,44,9,73,82,282
10765,Kenyona Swader,2008,2008,East Tennessee State,A-Sun,32,710,97,205,63,114,34,91,54,70,36,147,183,34,20,12,40,72,282
10766,Isaiah Swann,2008,2008,Florida State,ACC,24,745,93,215,39,76,54,139,42,50,12,63,75,69,25,5,55,56,282
10767,Gary Tucker,2008,2008,Duquesne,A-10,30,746,98,218,66,115,32,103,54,79,18,62,80,55,31,6,40,38,282
10768,Aaron Wiggins,2019,2019,Maryland,Big Ten,34,798,97,252,35,102,62,150,26,30,33,79,112,27,26,6,27,58,282
10769,Bryan Beasley,2008,2011,Rice,CUSA,115,1901,93,275,59,172,34,103,61,120,27,132,159,153,73,12,151,160,281
10770,Kamyron Brown,2008,2011,Total,Total,66,1118,87,218,66,151,21,67,86,127,11,95,106,168,57,6,131,101,281
10771,Kareem Brown,2010,2010,Coppin State,MEAC,28,767,96,281,39,104,57,177,32,42,11,52,63,37,20,0,55,55,281
10772,De'Angelo Bruster,2016,2018,Western Illinois,Summit,75,1166,101,246,70,157,31,89,48,63,21,98,119,128,42,0,88,108,281
10773,Larry Cox,2008,2008,Mississippi Valley State,SWAC,23,621,108,219,108,218,0,1,65,109,68,116,184,4,12,51,52,70,281
10774,Elias Desport,2013,2016,Saint Peter's,MAAC,120,1638,98,250,96,242,2,8,83,128,109,162,271,46,32,39,99,257,281
10775,Danny Dixon,2016,2019,Total,Total,63,845,100,225,93,210,7,15,74,105,50,103,153,20,12,13,48,103,281
10776,Ben Eaves,2009,2011,Rhode Island,A-10,87,848,93,253,48,115,45,138,50,67,52,125,177,24,13,19,34,88,281
10777,Kordario Fleming,2013,2014,Jacksonville,A-Sun,39,1068,109,239,109,236,0,3,63,121,74,138,212,65,33,29,85,85,281
10778,Austin Johnson,2008,2010,Charleston Southern,Big South,79,1022,98,265,54,136,44,129,41,65,39,71,110,56,24,2,68,97,281
10779,Alex Malone,2008,2009,Southern Methodist,CUSA,50,762,102,269,72,172,30,97,47,78,33,87,120,32,18,14,61,68,281
10780,Juwan McCloud,2017,2018,Northern Iowa,MVC,56,1281,106,324,79,205,27,119,42,80,10,74,84,107,65,4,79,76,281
10781,Cam Miller,2014,2017,Lipscomb,A-Sun,76,1235,103,205,82,148,21,57,54,81,39,90,129,100,57,12,49,96,281
10782,Everett Osborne,2015,2016,Texas-Rio Grande Valley,WAC,60,977,96,278,69,172,27,106,62,83,23,95,118,47,26,10,67,66,281
10783,Ioannis Papapetrou,2013,2013,Texas,Big 12,34,826,96,222,63,130,33,92,56,96,48,100,148,41,20,24,59,95,281
10784,Tidell Pierre,2016,2017,Central Connecticut State,NEC,51,974,100,247,97,240,3,7,78,138,117,138,255,26,16,5,55,119,281
10785,Joe Quintana,2018,2019,Loyola Marymount,WCC,53,1017,89,255,32,92,57,163,46,55,21,70,91,69,56,9,46,78,281
10786,Joe Retic,2014,2015,Liberty,Big South,51,1150,85,223,70,175,15,48,96,126,19,101,120,180,67,6,139,120,281
10787,Marvin Smith,2015,2016,South Carolina Upstate,A-Sun,66,1083,110,218,106,202,4,16,57,93,78,150,228,43,15,14,66,97,281
10788,Justin Sofman,2008,2010,Total,Total,45,781,93,233,20,40,73,193,22,26,25,46,71,27,22,2,34,54,281
10789,James Sylvester,2016,2016,Coppin State,MEAC,28,610,81,215,53,150,28,65,91,133,51,50,101,45,25,5,40,55,281
10790,Nick Walsh,2008,2011,Manhattan,MAAC,103,919,94,281,29,87,65,194,28,34,13,42,55,55,37,2,67,47,281
10791,Isaiah White,2019,2019,Utah Valley,WAC,33,824,92,218,60,136,32,82,65,100,38,106,144,30,25,18,49,70,281
10792,DavRon Williams,2013,2015,Total,Total,52,886,112,194,112,193,0,1,57,99,84,154,238,25,25,24,55,122,281
10793,Geary Claxton,2008,2008,Penn State,Big Ten,16,490,104,210,83,152,21,58,51,92,49,85,134,38,14,12,42,47,280
10794,Lance Crawford,2015,2015,Massachusetts-Lowell,AEC,29,830,83,205,56,126,27,79,87,113,16,67,83,66,18,1,58,64,280
10795,Austin Etherington,2012,2016,Total,Total,115,1200,88,205,48,85,40,120,64,86,48,147,195,50,41,12,66,195,280
10796,James Granstra,2008,2010,Western Illinois,Summit,82,1502,100,210,100,210,0,0,80,147,84,203,287,35,20,99,65,146,280
10797,DeVon Hardin,2008,2008,University of California,Pac-10,30,714,98,177,98,177,0,0,84,132,54,167,221,20,17,37,43,74,280
10798,Todd Hughes,2015,2016,Delaware State,MEAC,53,843,112,283,98,227,14,56,42,64,36,80,116,29,25,23,60,56,280
10799,Chris Jones,2010,2013,San Jose State,WAC,106,1181,109,271,106,252,3,19,59,87,99,123,222,54,29,8,54,124,280
10800,Deivydas Kuzavas,2017,2019,Saint Francis (PA),NEC,80,1041,119,206,119,204,0,2,42,78,93,131,224,25,6,32,42,155,280
10801,McKay LaSalle,2014,2015,Long Beach State,Big West,63,1065,93,248,14,27,79,221,15,19,7,66,73,33,22,0,27,101,280
10802,L.J. Livingston,2015,2016,Miami (OH),MAC,62,922,111,173,111,173,0,0,58,93,92,105,197,4,7,58,29,90,280
10803,Greg Louis,2013,2015,Pennsylvania,Ivy,66,1051,110,222,101,195,9,27,51,89,82,150,232,24,35,30,70,161,280
10804,Tamron Manning,2013,2015,Marshall,CUSA,90,1539,88,270,59,156,29,114,75,111,27,137,164,125,70,9,93,140,280
10805,Anthony Masinton-Bonner,2019,2019,Colorado State,MWC,25,658,97,189,56,89,41,100,45,52,7,55,62,34,20,2,35,44,280
10806,Chris Matagrano,2010,2013,New Hampshire,AEC,94,1151,117,244,112,210,5,34,41,60,80,119,199,29,20,19,68,162,280
10807,Dan McGeary,2008,2010,Harvard,Ivy,52,895,91,272,23,49,68,223,30,38,7,46,53,43,24,1,50,65,280
10808,Chris McHenry,2009,2011,Total,Total,43,816,96,253,38,94,58,159,30,42,16,58,74,64,21,2,63,59,280
10809,Keaton Moffitt,2015,2016,South Dakota State,Summit,62,1225,104,215,98,196,6,19,66,102,64,156,220,106,48,9,64,117,280
10810,Malik Osborne,2018,2018,Rice,CUSA,31,840,92,222,70,139,22,83,74,115,71,131,202,26,19,24,57,69,280
10811,Eric Parrish,2018,2018,Akron,MAC,32,864,108,209,85,138,23,71,41,66,51,100,151,44,39,7,45,73,280
10812,Jonathan Pease,2008,2008,Towson,CAA,31,804,94,216,44,81,50,135,42,55,33,114,147,48,46,12,38,80,280
10813,Jeff Pollard,2017,2019,Washington State,Pac-12,80,1040,112,201,109,187,3,14,53,75,50,113,163,32,20,7,44,87,280
10814,Arkim Robertson,2017,2018,Cal State Fullerton,Big West,61,915,106,169,106,169,0,0,68,115,97,168,265,13,28,53,66,166,280
10815,Keith Searcy,2010,2011,Alcorn State,SWAC,55,1012,104,301,101,279,3,22,69,108,16,93,109,65,45,2,135,153,280
10816,Cameron Stanley,2008,2009,Total,Total,53,840,101,257,77,165,24,92,54,74,61,97,158,16,18,3,52,71,280
10817,Malcolm White,2008,2009,Mississippi,SEC,57,940,116,235,116,233,0,2,48,65,79,132,211,3,14,51,50,131,280
10818,Kevin Bridgewaters,2008,2008,Chattanooga,Southern,30,768,78,182,49,89,29,93,94,121,6,83,89,93,25,1,83,67,279
10819,Casey Durham,2008,2008,Montana State,Big Sky,30,883,87,203,23,48,64,155,41,51,14,71,85,84,37,2,55,61,279
10820,Eden Ewing,2018,2019,Total,Total,35,696,110,209,105,195,5,14,54,103,51,154,205,36,22,23,74,98,279
10821,Anthony Hitchens,2010,2010,Akron,MAC,33,836,100,279,57,137,43,142,36,55,12,47,59,91,28,0,56,64,279
10822,Mike La Tulip,2013,2017,Total,Total,76,963,78,200,19,45,59,155,64,75,6,102,108,50,34,2,28,72,279
10823,Isaac Likekele,2019,2019,Oklahoma State,Big 12,32,925,103,221,97,196,6,25,67,102,17,135,152,126,42,10,75,69,279
10824,Ryan McCoy,2009,2010,Louisiana,Sun Belt,44,886,102,228,80,168,22,60,53,78,33,56,89,91,47,1,70,84,279
10825,Ted McCree,2019,2019,Northern Arizona,Big Sky,26,617,97,236,46,100,51,136,34,39,5,49,54,26,17,2,31,27,279
10826,Darius McGhee,2019,2019,Liberty,A-Sun,36,768,99,257,38,67,61,190,20,22,11,87,98,38,33,8,19,41,279
10827,Willie Morse,2008,2009,Colgate,Patriot,62,1117,91,251,40,106,51,145,46,60,21,86,107,70,23,5,82,69,279
10828,Alex O'Connell,2018,2019,Duke,ACC,72,878,97,211,45,86,52,125,33,44,33,84,117,40,31,4,45,35,279
10829,Jerryck Owens-Murrey,2008,2008,Western Illinois,Summit,30,693,95,220,95,220,0,0,89,139,62,102,164,34,17,12,76,99,279
10830,Tyler Rambo,2013,2015,Murray State,OVC,78,985,95,176,95,176,0,0,89,152,51,63,114,43,26,8,53,65,279
10831,Daniel Richard,2009,2012,McNeese State,Southland,101,1450,106,246,106,246,0,0,67,112,102,161,263,36,26,58,83,236,279
10832,Andre Ricks,2008,2009,Western Michigan,MAC,57,1022,98,303,39,123,59,180,24,38,25,46,71,31,24,1,43,68,279
10833,Westley Telfare,2008,2011,South Carolina State,MEAC,74,1076,95,293,45,115,50,178,39,52,32,118,150,58,29,24,89,96,279
10834,Stephan Van Treese,2010,2014,Louisville,Total,126,1719,119,181,118,179,1,2,40,80,225,235,460,48,78,49,62,191,279
10835,Josiah Whitehead,2009,2010,Robert Morris,NEC,68,987,97,183,97,181,0,2,85,120,60,96,156,32,21,7,68,83,279
10836,Roderick Williams,2019,2019,Boise State,MWC,30,533,107,184,107,173,0,11,65,104,34,93,127,25,34,6,63,60,279
10837,Freddie Wilson,2012,2015,Total,Total,89,1147,98,281,50,113,48,168,35,56,14,80,94,90,34,4,74,96,279
10838,T.J. Bell,2014,2017,Indiana State,MVC,72,878,112,211,112,211,0,0,54,80,63,115,178,24,18,42,66,168,278
10839,Marcus Cohen,2018,2019,Mercer,Southern,63,1103,115,255,114,246,1,9,47,110,14,79,93,190,40,4,123,94,278
10840,Armani Collins,2016,2019,Total,Total,65,852,92,279,28,53,64,226,30,45,26,98,124,39,18,16,35,71,278
10841,Ben Crenca,2010,2013,Vermont,AEC,100,895,105,207,105,207,0,0,68,113,71,133,204,11,5,30,57,122,278
10842,Connell Crossland,2012,2013,Texas Christian,Total,64,1109,108,220,101,201,7,19,55,105,98,178,276,44,20,20,63,106,278
10843,Dondre Duffus,2017,2019,Total,Total,38,817,88,193,72,149,16,44,86,131,8,63,71,80,48,5,73,76,278
10844,DeAndre Jordan,2008,2008,Texas A&M,Big 12,35,703,113,183,113,183,0,0,52,119,66,144,210,15,7,44,57,67,278
10845,Jake Krafka,2017,2019,Denver,Summit,59,1103,95,230,66,138,29,92,59,90,50,195,245,82,12,17,53,135,278
10846,Eddie Ludwig,2010,2013,Louisiana State,SEC,100,1282,85,220,78,186,7,34,101,136,88,167,255,56,44,13,78,160,278
10847,Jason Marks,2010,2011,Southeastern Louisiana,Southland,58,1280,111,197,110,191,1,6,55,74,70,201,271,102,47,29,80,180,278
10848,Tyrone Nared,2011,2012,Oregon,Total,67,1224,100,226,81,166,19,60,59,83,89,148,237,39,42,47,63,128,278
10849,Markquis Nowell,2019,2019,Little Rock,Sun Belt,25,761,95,249,49,120,46,129,42,53,10,69,79,105,36,0,83,54,278
10850,Kahlil Owens,2012,2013,Morehead State,OVC,54,774,117,196,117,196,0,0,44,97,103,157,260,17,34,19,58,128,278
10851,Tim Steed,2011,2011,Fresno State,WAC,26,642,104,205,88,170,16,35,54,97,49,66,115,49,19,14,57,38,278
10852,Phillip Thomasson,2008,2008,Wichita State,MVC,30,801,90,197,88,181,2,16,96,133,55,74,129,41,10,16,52,84,278
10853,Jordy Tshimanga,2017,2018,Nebraska,Big Ten,62,812,108,239,108,239,0,0,62,103,114,152,266,23,22,29,83,140,278
10854,Alex Vouyoukas,2009,2012,Total,Total,88,1119,118,269,115,260,3,9,39,57,75,126,201,54,21,64,75,170,278
10855,Stephon Weaver,2010,2011,Florida International,Sun Belt,49,1047,96,275,57,160,39,115,47,55,31,68,99,56,29,1,36,73,278
10856,Drake Wilks,2017,2019,Grambling,SWAC,65,963,101,244,56,111,45,133,31,51,43,93,136,41,26,12,54,85,278
10857,Jaron Withers,2015,2018,Presbyterian,Big South,124,1872,95,286,78,206,17,80,71,126,39,167,206,113,60,9,116,194,278
10858,Tyrik Armstrong,2019,2019,Texas Southern,SWAC,36,753,97,234,67,152,30,82,53,65,21,50,71,111,52,3,52,50,277
10859,Jordan Ashton,2016,2017,Total,Total,54,1181,91,227,37,95,54,132,41,53,18,104,122,41,32,7,38,64,277
10860,Spongy Benjamin,2008,2008,Marist,MAAC,31,850,112,197,112,197,0,0,53,83,84,131,215,23,26,24,49,74,277
10861,Kyle Caudill,2012,2016,Total,Total,92,858,99,200,98,190,1,10,78,111,48,85,133,45,5,15,81,162,277
10862,Danny Cavic,2008,2008,San Francisco,WCC,31,969,90,208,32,76,58,132,39,48,63,86,149,32,25,8,43,73,277
10863,Maishe Dailey,2017,2019,Iowa,Big Ten,80,1071,99,246,57,114,42,132,37,59,16,118,134,87,25,3,55,58,277
10864,Javin DeLaurier,2017,2019,Duke,ACC,83,1123,113,160,112,150,1,10,50,92,128,192,320,34,58,73,63,196,277
10865,Tyrell Harper,2019,2019,Savannah State,MEAC,30,807,95,244,57,109,38,135,49,72,38,153,191,85,40,11,93,79,277
10866,Brandon Hosley,2011,2012,Florida A&M,MEAC,46,778,85,237,34,89,51,148,56,77,23,55,78,45,51,1,62,60,277
10867,Iman Johnson,2014,2016,Total,Total,69,1316,108,240,100,209,8,31,53,93,88,176,264,74,70,20,82,165,277
10868,Alex Legion,2008,2011,Total,Total,49,739,103,276,57,134,46,142,25,38,24,80,104,37,30,7,46,55,277
10869,Adam Lulka,2019,2019,Albany (NY),AEC,32,966,117,211,106,173,11,38,32,47,76,128,204,37,15,16,57,84,277
10870,Daniel Meyer,2015,2018,Omaha,Summit,112,1058,116,249,116,246,0,3,45,109,106,130,236,25,11,30,52,133,277
10871,Isaiah Nichols,2017,2019,San Jose State,MWC,80,1201,94,266,62,159,32,107,57,106,37,168,205,116,43,5,108,140,277
10872,Alex Rivera,2019,2019,Massachusetts-Lowell,AEC,30,748,94,231,39,66,55,165,34,50,24,79,103,47,24,5,39,70,277
10873,DaRohn Scott,2015,2017,Central Michigan,MAC,97,1106,111,173,111,173,0,0,55,115,114,199,313,5,20,98,57,235,277
10874,Alex Smith,2012,2013,Bethune-Cookman,MEAC,62,929,121,196,121,195,0,1,35,68,92,145,237,28,32,78,52,107,277
10875,Tyrese Williams,2019,2019,Quinnipiac,MAAC,31,933,96,252,48,119,48,133,37,54,19,112,131,74,28,3,69,94,277
10876,Dauson Womack,2013,2014,Houston Baptist,Total,59,1167,96,230,94,221,2,9,83,135,104,193,297,46,53,25,86,143,277
10877,Emanuel Bidias a Moute,2009,2010,Texas State,Southland,47,805,107,221,107,221,0,0,62,108,97,150,247,51,41,36,77,104,276
10878,Marcus Crenshaw,2008,2008,Cal State Fullerton,Big West,32,630,102,249,34,84,68,165,4,7,9,36,45,68,18,1,31,25,276
10879,Ivan Cruz Uceda,2015,2016,Miami (FL),ACC,52,782,96,219,36,70,60,149,24,27,34,120,154,10,14,12,32,74,276
10880,Trey Drechsel,2019,2019,Grand Canyon,WAC,34,878,101,235,75,146,26,89,48,70,27,170,197,82,30,7,57,79,276
10881,Grady Eifert,2016,2019,Purdue,Big Ten,99,1293,95,173,58,86,37,87,49,77,99,163,262,78,39,4,29,104,276
10882,Westley Hinton,2013,2014,Troy,Sun Belt,55,819,98,246,59,124,39,122,41,59,49,119,168,18,28,29,45,81,276
10883,Braden Norris,2019,2019,Oakland,Horizon,33,1178,76,168,9,30,67,138,57,77,2,89,91,174,47,2,63,76,276
10884,Luka Pajkovic,2012,2014,Total,Total,65,788,84,240,47,102,37,138,71,114,15,73,88,45,41,3,96,74,276
10885,Jodan Price,2013,2017,Total,Total,86,1043,93,321,28,84,65,237,25,39,17,98,115,24,35,31,40,81,276
10886,Timothy Price,2008,2012,Total,Total,118,1024,112,258,111,255,1,3,51,100,95,113,255,22,43,80,83,174,276
10887,Adonis Rwabigwi,2014,2018,Total,Total,108,1306,98,202,98,201,0,1,80,138,85,166,251,20,28,50,88,249,276
10888,Hunter Seacat,2016,2019,Total,Total,73,995,114,201,114,201,0,0,48,77,68,124,192,59,17,36,61,123,276
10889,Jeremy Sheppard,2017,2017,East Carolina,AAC,30,797,93,255,43,107,50,148,40,61,12,52,64,104,32,1,79,59,276
10890,Adam Sterrenberg,2010,2012,Arkansas State,Sun Belt,79,952,83,219,48,111,35,108,75,112,22,64,86,48,30,3,44,64,276
10891,Anthony Tucker,2009,2010,Iowa,Big Ten,25,646,94,236,26,51,68,185,20,32,13,67,80,40,12,0,45,34,276
10892,C.J. Turman,2015,2016,Florida Atlantic,CUSA,40,842,107,194,107,193,0,1,62,98,42,130,172,16,12,29,65,120,276
10893,Jonathan Baehre,2017,2018,North Carolina-Asheville,Big South,45,823,112,210,86,140,26,70,25,35,63,111,174,38,25,64,44,101,275
10894,Chance Comanche,2016,2017,Arizona,Pac-12,60,810,105,189,105,189,0,0,65,90,52,117,169,18,6,21,46,97,275
10895,Eni Cuka,2008,2010,Total,Total,35,697,86,246,32,88,54,158,49,63,9,49,58,35,13,0,68,72,275
10896,Andres Feliz,2019,2019,Illinois,Big Ten,33,737,97,215,87,178,10,37,71,94,20,75,95,74,33,1,51,82,275
10897,Dwayne Foreman,2008,2008,Georgia Southern,Southern,32,1031,95,281,45,131,50,150,35,58,19,68,87,193,30,4,84,86,275
10898,Marquise Gray,2008,2009,Michigan State,Big Ten,74,831,110,185,110,185,0,0,55,83,80,160,240,24,14,21,80,124,275
10899,Jon Iati,2008,2008,Albany (NY),AEC,30,726,79,215,23,62,56,153,61,72,15,46,61,60,13,0,43,34,275
10900,Preston Mattingly,2014,2016,Lamar,Southland,72,1213,94,205,87,176,7,29,80,131,70,137,207,67,38,8,39,114,275
10901,Kendle Moore,2019,2019,Colorado State,MWC,32,913,98,205,64,99,34,106,45,57,5,74,79,86,42,3,53,87,275
10902,Nedeljko Prijovic,2017,2018,Texas State,Sun Belt,66,1114,106,241,90,166,16,75,47,71,61,174,235,61,26,34,44,104,275
10903,K.J. Santos,2017,2019,Total,Total,55,1104,98,259,59,149,39,110,40,67,50,133,183,47,16,9,81,127,275
10904,Adam Thistlewood,2019,2019,Colorado State,MWC,32,943,90,202,37,65,53,137,42,53,25,67,92,31,18,9,29,74,275
10905,Basil Thompson,2015,2016,Saint Francis (PA),NEC,51,732,92,236,87,194,5,42,86,116,55,110,165,18,15,20,66,92,275
10906,Robert Thurman,2011,2013,University of California,Total,73,921,127,211,127,211,0,0,21,49,82,101,183,15,13,18,43,75,275
10907,Corey Tillery,2018,2019,Tennessee Tech,OVC,48,981,93,293,22,72,71,221,18,21,10,74,84,34,26,4,39,66,275
10908,Kevin Worsley,2008,2009,Norfolk State,MEAC,62,1074,116,252,106,212,10,40,33,52,88,126,214,59,82,15,77,116,275
10909,Spencer Foley,2017,2018,Canisius,MAAC,58,649,94,212,31,53,63,159,23,28,41,29,70,33,13,3,25,53,274
10910,Malik Garner,2013,2015,Maryland-Baltimore County,AEC,67,1244,105,243,85,171,20,72,44,78,64,107,171,57,32,15,60,128,274
10911,Gerrale Gates,2019,2019,New Orleans,Southland,33,841,98,210,97,207,1,3,77,114,49,113,162,53,24,16,52,59,274
10912,Trey Gross,2008,2009,Eastern Washington,Big Sky,42,1020,90,251,49,137,41,114,53,69,20,62,82,57,23,6,87,97,274
10913,Jordon King,2017,2018,Purdue-Fort Wayne,Summit,56,579,99,214,56,96,43,118,33,57,16,70,86,26,23,6,39,71,274
10914,Mohamed Koita,2010,2013,Manhattan,MAAC,87,1250,90,261,43,113,47,148,47,60,31,117,148,50,39,11,69,129,274
10915,Joel Lamb,2009,2011,Charleston Southern,Big South,69,1056,113,287,90,216,23,71,25,44,66,131,197,40,29,43,59,111,274
10916,Darraja Parnell,2017,2018,Central Arkansas,Southland,63,746,94,199,81,162,13,37,73,97,31,92,123,80,35,6,78,94,274
10917,LaMont Russell,2009,2010,Southeast Missouri State,OVC,60,1466,104,188,104,187,0,1,66,107,116,271,387,77,44,19,86,141,274
10918,Kevin Samuel,2019,2019,Texas Christian,Big 12,37,908,121,182,121,181,0,1,32,73,102,156,258,21,21,77,52,103,274
10919,Christian Soto,2008,2009,UC-Riverside,Big West,60,1501,97,205,96,202,1,3,79,134,107,162,269,70,49,32,70,165,274
10920,Jordan Usher,2018,2019,Southern California,Pac-12,48,798,98,219,63,125,35,94,43,59,31,84,115,54,22,7,45,101,274
10921,Caleb Bennett,2018,2019,Lehigh,Patriot,53,964,96,224,72,156,24,68,57,74,19,95,114,55,27,9,72,96,273
10922,Max Curran,2017,2019,Maryland-Baltimore County,AEC,62,747,99,214,76,116,23,98,52,82,47,141,188,15,15,24,48,119,273
10923,Dameane Douglas,2019,2019,Loyola Marymount,WCC,33,815,101,183,86,157,15,26,56,89,40,120,160,42,26,8,48,84,273
10924,Wesley Dunning,2011,2013,Hampton,MEAC,91,1301,103,237,88,185,15,52,52,80,109,181,290,23,29,35,71,150,273
10925,Adonis Gray,2008,2008,Nicholls State,Southland,29,702,96,189,91,178,5,11,76,111,55,67,122,38,21,6,60,60,273
10926,Noah Gurley,2019,2019,Furman,Southern,31,758,103,225,69,117,34,108,33,51,37,76,113,29,17,24,57,89,273
10927,C.J. Jones,2017,2018,Arkansas,SEC,56,646,97,225,42,85,55,140,24,31,4,59,63,20,9,10,17,41,273
10928,Chance McSpadden,2016,2019,Central Florida,AAC,55,838,94,225,71,142,23,83,62,82,26,90,116,59,30,5,83,52,273
10929,Sean Mobley,2018,2019,Virginia Commonwealth,A-10,63,1154,96,239,50,110,46,129,35,51,34,141,175,94,28,13,74,128,273
10930,Jourdan Morris,2009,2010,High Point,Big South,39,689,118,228,114,217,4,11,33,52,43,90,133,20,16,1,55,73,273
10931,A.J. Walker,2019,2019,Air Force,MWC,32,841,96,233,60,143,36,90,45,64,4,58,62,80,25,4,48,76,273
10932,Bryce White,2015,2016,Portland State,Big Sky,26,681,86,222,60,142,26,80,75,98,9,79,88,48,26,9,35,51,273
10933,Alex Wolf,2008,2011,Western Michigan,MAC,77,932,74,164,17,35,57,129,68,86,19,53,72,85,24,1,43,62,273
10934,Randy Adams,2008,2009,Sacramento State,Big Sky,42,980,96,218,94,214,2,4,78,128,70,116,186,25,16,7,74,110,272
10935,Garet Beal,2014,2016,Maine,AEC,52,959,85,239,50,108,35,131,67,90,32,104,136,62,30,10,77,122,272
10936,Ronnye Beamon,2014,2017,Total,Total,80,1171,93,203,74,155,19,48,67,116,62,110,172,44,46,11,61,161,272
10937,Travis Busch,2008,2010,Total,Total,75,895,97,233,86,199,11,34,67,95,42,75,117,34,33,6,51,74,272
10938,Josh Coleman,2016,2019,Coastal Carolina,Total,98,1086,117,223,117,221,0,2,38,87,142,141,283,6,9,42,46,189,272
10939,Randy Dezouvre,2011,2012,Iona,MAAC,64,802,109,216,106,202,3,14,51,83,43,88,131,49,33,9,41,93,272
10940,Joseph Flegler,2008,2008,Savannah State,Ind,31,665,89,228,57,136,32,92,62,77,15,48,63,70,25,2,75,60,272
10941,Marcus Hall,2013,2014,Portland State,Big Sky,40,1044,89,212,34,69,55,143,39,58,34,90,124,54,28,9,39,130,272
10942,Devin Hill,2009,2011,DePaul,Big East,67,1169,110,310,89,215,21,95,31,83,64,139,203,31,19,68,50,101,272
10943,Michael Littlejohn,2019,2019,Tennessee State,OVC,30,652,88,245,29,70,59,175,37,44,16,32,48,41,19,1,42,65,272
10944,Adam Malik,2009,2012,UC-Davis,Big West,83,1035,98,235,40,74,58,161,18,27,29,86,115,59,23,14,57,123,272
10945,Branimir Mikulic,2012,2013,High Point,Big South,61,1213,90,220,28,57,62,163,30,37,42,170,212,41,18,19,53,117,272
10946,Isiah Osborne,2018,2018,Texas-El Paso,CUSA,29,781,92,244,51,119,41,125,47,75,15,91,106,30,19,3,25,39,272
10947,Max Paulhus Gosselin,2008,2009,Davidson,Southern,68,1689,99,255,80,154,19,101,55,79,85,174,259,113,103,22,56,149,272
10948,Jamar Sandfer,2018,2018,Southern,SWAC,33,739,95,229,65,150,30,79,52,65,43,79,122,46,25,17,46,94,272
10949,Shareef Smith,2019,2019,Eastern Illinois,OVC,32,920,91,208,65,131,26,77,64,91,22,92,114,123,38,1,80,73,272
10950,Tramique Sutherland,2015,2015,Bradley,MVC,24,864,93,260,79,215,14,45,72,96,36,57,93,73,25,0,57,48,272
10951,Conor Turley,2008,2011,Pennsylvania,Ivy,80,1044,87,189,80,164,7,25,91,128,53,110,163,53,14,18,77,153,272
10952,Kenny Ware,2008,2009,Troy,Sun Belt,61,990,102,286,62,149,40,137,28,49,69,137,206,34,37,4,52,75,272
10953,Isaac White,2018,2019,Stanford,Pac-12,63,807,85,220,25,52,60,168,42,58,6,64,70,33,11,0,44,44,272
10954,Logan Wiens,2012,2012,Coppin State,MEAC,27,627,91,201,46,90,45,111,45,49,28,64,92,42,11,17,23,60,272
10955,Larry Wilkins,2011,2013,Texas-San Antonio,Total,66,1356,106,196,106,196,0,0,60,125,105,136,241,45,43,12,66,169,272
10956,Stephen Zimmerman Jr.,2016,2016,Nevada-Las Vegas,MWC,26,680,102,214,97,197,5,17,63,101,56,171,227,22,14,51,54,79,272
10957,Taylor Abt,2012,2015,Holy Cross,Patriot,113,1359,111,231,92,166,19,65,30,70,111,154,265,13,20,50,66,250,271
10958,Kent Auslander,2016,2019,Total,Total,57,1073,83,235,32,71,51,164,54,76,8,131,139,32,15,8,80,69,271
10959,Alwayne Bigby,2010,2013,Total,Total,99,1755,98,238,87,184,11,54,64,120,88,156,244,82,81,17,114,218,271
10960,DeShawndre Black,2017,2018,Detroit Mercy,Horizon,63,1087,92,259,53,148,39,111,48,68,25,76,101,126,40,2,76,132,271
10961,Trenity Burdine,2011,2013,Siena,MAAC,54,1022,92,212,71,148,21,64,66,88,41,78,119,32,27,12,51,98,271
10962,Jeremy Clayton,2008,2008,Appalachian State,Southern,31,908,108,189,108,184,0,5,55,94,72,180,252,64,31,75,76,87,271
10963,John Crosby,2016,2018,Dayton,A-10,90,1098,96,272,70,196,26,76,53,87,17,126,143,118,22,2,90,100,271
10964,Tay Fisher,2008,2008,Siena,MAAC,34,597,81,183,10,23,71,160,38,45,9,31,40,24,28,0,20,36,271
10965,Lonnie Grayson,2018,2019,Army,Patriot,50,685,92,258,39,91,53,167,34,44,7,89,96,30,31,4,39,70,271
10966,Tyler Hadden,2015,2018,Belmont,OVC,109,679,100,208,81,135,19,73,52,79,38,99,137,20,7,18,51,120,271
10967,Shane Hanson,2008,2008,UC-Davis,Big West,27,760,92,210,39,76,53,134,34,40,17,88,105,64,15,8,47,53,271
10968,Chase Harler,2017,2019,West Virginia,Big 12,85,1226,97,269,43,101,54,168,23,33,15,54,69,76,30,13,38,100,271
10969,Mario Little,2009,2011,Kansas,Big 12,55,727,106,215,92,177,14,38,45,68,56,111,167,47,25,14,37,88,271
10970,Ivan Lukic,2014,2017,James Madison,CAA,90,1078,100,216,89,165,11,51,60,90,57,113,170,31,15,26,48,141,271
10971,Trayce Macon,2008,2010,Troy,Sun Belt,45,768,86,225,43,99,43,126,56,96,44,105,149,33,13,12,62,66,271
10972,Chris Smith,2010,2013,Mercer,A-Sun,128,1125,83,233,58,151,25,82,80,127,48,133,181,40,48,18,78,161,271
10973,Chris Toler,2009,2012,Furman,Southern,119,1528,109,268,109,268,0,0,53,92,97,150,247,31,25,40,97,195,271
10974,Alonzo Walker,2017,2019,Total,Total,58,883,108,208,102,193,6,15,49,80,93,114,207,29,29,21,52,122,271
10975,Carson Warren-Newsome,2018,2019,Milwaukee,Horizon,39,724,90,237,57,119,33,118,58,71,15,81,96,46,29,4,39,62,271
10976,Jamar Wertz,2011,2013,Maryland-Baltimore County,AEC,80,1039,96,258,60,158,36,100,43,66,54,92,146,35,13,6,43,111,271
10977,C.C. Williams,2008,2008,Towson,CAA,31,961,91,221,74,153,17,68,72,111,21,47,68,147,43,9,66,87,271
10978,Brian Andre,2008,2008,Maine,AEC,28,696,104,189,103,188,1,1,61,101,76,77,153,25,12,21,74,76,270
10979,DeShaw Andrews,2019,2019,Alcorn State,SWAC,31,576,92,226,60,128,32,98,54,83,32,106,138,28,42,3,47,72,270
10980,Devin Berry,2015,2017,Arkansas-Pine Bluff,SWAC,88,1212,99,229,99,229,0,0,72,126,127,132,259,32,25,52,85,230,270
10981,Aaron Bruce,2008,2008,Baylor,Big 12,32,691,87,217,44,97,43,120,53,67,13,42,55,61,28,2,47,65,270
10982,Charles Clark,2009,2011,Northwestern State,Southland,67,839,102,238,83,180,19,58,47,117,74,98,172,38,33,10,64,81,270
10983,Rodrick Epps,2008,2008,Texas-Arlington,Southland,33,982,80,212,39,86,41,126,69,83,19,110,129,85,34,3,72,64,270
10984,Byron Faison,2008,2009,Winthrop,Big South,64,753,99,230,53,109,46,121,26,38,12,49,61,38,16,11,32,70,270
10985,Richard Freeman,2014,2015,Grambling,SWAC,56,1036,90,269,80,219,10,50,80,141,44,154,198,33,22,18,87,85,270
10986,Mac Hoffman,2014,2017,Army,Patriot,88,1199,100,209,93,182,7,27,63,96,101,210,311,46,18,19,65,194,270
10987,Marsell Holden,2012,2012,Morehead State,OVC,32,690,83,230,10,37,73,193,31,34,9,37,46,24,27,3,41,36,270
10988,Fred Iruafemi,2015,2018,Virginia Military Institute,Southern,116,1497,110,218,110,217,0,1,50,78,112,194,306,64,63,115,69,280,270
10989,Quan Jones,2015,2016,Lamar,Southland,59,923,74,204,45,124,29,80,93,128,17,61,78,77,37,3,84,91,270
10990,Mark Laros,2018,2019,Southeast Missouri State,OVC,58,869,121,201,115,179,6,22,22,41,72,112,184,18,15,19,58,83,270
10991,Xavian Rimmer,2012,2012,Alcorn State,SWAC,31,872,83,203,58,131,25,72,79,96,24,57,81,45,20,0,71,72,270
10992,Jajuan Starks,2018,2018,Eastern Illinois,OVC,31,665,102,244,88,194,14,50,52,85,53,72,125,26,16,14,52,46,270
10993,Jon Taylor,2011,2012,Saint Francis (PA),NEC,55,944,108,238,107,234,1,4,53,91,61,117,178,30,25,17,49,122,270
10994,TJ Washington,2019,2019,Utah Valley,WAC,35,818,88,203,65,145,23,58,71,101,5,71,76,137,36,1,105,88,270
10995,Ladarious Weaver,2008,2008,Tennessee State,OVC,32,652,89,207,17,46,72,161,20,22,14,50,64,34,16,1,28,52,270
10996,Damian Young,2016,2016,Mississippi Valley State,SWAC,34,680,93,259,59,154,34,105,50,63,23,65,88,32,54,10,54,63,270
10997,Seth Adelsperger,2017,2019,Belmont,OVC,90,805,100,164,100,164,0,0,69,115,67,106,173,13,6,24,28,110,269
10998,David Azore,2019,2019,Texas-Arlington,Sun Belt,32,743,75,233,66,186,9,47,110,135,21,113,134,51,19,2,83,60,269
10999,Darius Bolstad,2016,2018,Radford,Big South,74,763,115,181,115,181,0,0,39,61,79,131,210,25,12,67,49,138,269
11000,Tony Bradley,2017,2017,North Carolina,ACC,38,553,102,178,102,178,0,0,65,105,98,97,195,23,10,22,25,69,269
11001,San Antonio Brinson,2018,2019,NJIT,A-Sun,58,859,100,227,88,167,12,60,57,89,46,144,190,31,27,25,60,101,269
11002,Jalonni Diggs,2008,2010,UC-Riverside,Big West,68,1431,100,279,53,129,47,150,22,31,11,77,88,125,28,3,84,103,269
11003,Michael Ellis,2008,2009,Mercer,A-Sun,50,863,97,221,96,215,1,6,74,87,57,81,138,53,25,9,48,81,269
11004,Zach Gunn,2018,2019,Ball State,MAC,52,746,84,220,27,53,57,167,44,55,22,125,147,29,9,11,33,103,269
11005,Ira Lee,2018,2019,Arizona,Pac-12,58,828,106,185,105,181,1,4,56,89,66,127,193,24,10,35,49,121,269
11006,Kevin Lott,2008,2010,Georgia State,CAA,89,1270,90,251,51,125,39,126,50,79,54,102,156,43,29,2,53,96,269
11007,DeAndre Love,2018,2019,Northwestern State,Southland,38,755,102,247,74,165,28,82,37,53,27,74,101,25,22,14,56,45,269
11008,Trey Murphy III,2019,2019,Rice,CUSA,32,660,84,190,20,38,64,152,37,51,18,64,82,22,15,16,22,44,269
11009,Phillip Nolan,2013,2016,Connecticut,Total,129,1670,108,215,108,215,0,0,53,82,101,155,256,24,20,51,66,287,269
11010,Ryan Pippins,2017,2019,Little Rock,Sun Belt,52,953,93,237,45,115,48,122,35,58,6,90,96,47,22,0,54,84,269
11011,Jason Richardson,2016,2019,Total,Total,45,810,98,242,84,197,14,45,59,92,19,50,69,100,33,1,70,96,269
11012,Pierre Sneed,2009,2012,Ball State,MAC,102,1633,97,278,92,251,5,27,70,104,58,126,184,78,32,7,102,125,269
11013,Trevone Williams,2013,2014,Cal State Northridge,Big West,65,918,110,273,86,181,24,92,25,34,44,107,151,54,25,12,50,93,269
11014,Matthew Atewe,2014,2018,Total,Total,71,1072,105,204,105,204,0,0,58,113,108,184,292,18,19,65,69,179,268
11015,Derrick Brooks,2015,2018,Wofford,Southern,116,1448,86,216,66,159,20,57,76,114,27,190,217,117,46,12,115,136,268
11016,Ethan Esposito,2019,2019,Sacramento State,Big Sky,31,513,94,195,91,183,3,12,77,102,53,76,129,13,10,10,45,76,268
11017,David Godbold,2008,2008,Oklahoma,Big 12,35,1007,89,251,43,110,46,141,44,57,40,99,139,64,39,16,39,75,268
11018,Nate Hinton,2019,2019,Houston,AAC,37,712,90,218,62,135,28,83,60,70,40,122,162,40,38,3,34,57,268
11019,Hank Hollingsworth,2016,2019,Cal Poly,Big West,90,1513,114,193,114,193,0,0,40,100,114,189,303,12,16,114,76,179,268
11020,Prentiss Hubb,2019,2019,Notre Dame,ACC,33,1109,95,293,52,129,43,164,35,52,27,74,101,131,32,12,64,68,268
11021,Rashad Jackson,2016,2018,Portland,WCC,66,898,82,254,56,162,26,92,78,106,18,90,108,33,40,8,50,84,268
11022,Paris Maragkos,2013,2016,Total,Total,76,611,111,231,101,205,10,26,36,54,31,67,98,31,13,5,68,95,268
11023,Ja'cor Nelson,2018,2019,Campbell,Big South,60,1023,107,234,100,193,7,41,47,98,47,101,148,85,60,12,78,103,268
11024,Jarvis Nichols,2008,2008,Northern Illinois,MAC,27,691,84,225,52,122,32,103,68,80,23,52,75,48,18,4,74,60,268
11025,Vince Rosario,2010,2011,Central Connecticut State,NEC,55,890,87,260,23,42,64,218,30,44,13,53,66,35,29,2,42,40,268
11026,Zach Scott,2019,2019,Florida Gulf Coast,A-Sun,32,717,94,227,48,116,46,111,34,48,19,81,100,26,27,6,40,39,268
11027,Jacoie Shivers,2008,2009,Prairie View,SWAC,55,712,110,197,110,197,0,0,48,80,66,119,185,10,10,19,46,129,268
11028,Jarel Spellman,2019,2019,Sacred Heart,NEC,32,820,115,223,109,201,6,22,32,61,71,164,235,11,13,94,38,88,268
11029,Terrence Watson,2008,2010,Total,Total,47,892,94,209,94,209,0,0,80,135,86,111,197,36,20,50,71,64,268
11030,Phil Anderson,2008,2009,Lehigh,Patriot,56,1086,92,245,54,136,38,109,45,69,89,145,234,31,21,40,60,151,267
11031,Felix Balamou,2013,2016,St. John's (NY),Big East,80,1085,107,263,106,256,1,7,52,81,57,90,147,80,30,17,70,135,267
11032,Jordan Cintron,2018,2019,Longwood,Big South,62,1035,90,192,75,143,15,49,72,124,63,140,203,36,48,12,77,108,267
11033,Aaron Clarke,2019,2019,Sacred Heart,NEC,32,689,90,225,57,117,33,108,54,63,4,46,50,59,8,0,38,58,267
11034,Brandon Dawson,2011,2013,Kennesaw State,A-Sun,80,1064,94,221,90,193,4,28,75,113,39,97,136,8,16,17,49,143,267
11035,Pat Doherty,2008,2009,Holy Cross,Patriot,43,1084,70,224,45,127,25,97,102,126,18,96,114,175,62,1,107,88,267
11036,James Gollon,2016,2019,Ohio,MAC,58,853,83,185,38,70,45,115,56,67,19,112,131,50,36,6,60,68,267
11037,Mansa Habeeb,2012,2013,Idaho,WAC,58,934,83,186,76,148,7,38,94,136,27,71,98,65,34,7,92,102,267
11038,Tyler Koch,2010,2014,Total,Total,81,1211,94,240,42,85,52,155,27,58,69,119,188,69,22,9,70,143,267
11039,Malick Kone,2012,2015,Rutgers,Total,99,1212,105,255,95,210,10,45,47,78,68,140,208,49,51,18,62,138,267
11040,Imoh Silas,2013,2016,Siena,MAAC,88,1243,118,225,118,225,0,0,31,69,124,165,289,38,30,105,102,221,267
11041,Ramar Smith,2008,2008,Tennessee,SEC,36,768,92,211,87,189,5,22,78,133,29,55,84,116,40,1,77,91,267
11042,Currye Todd,2008,2008,Lamar,Southland,30,488,87,205,33,82,54,123,39,51,8,37,45,32,23,2,36,40,267
11043,Markese Tucker,2012,2014,Saint Peter's,MAAC,59,732,116,229,116,229,0,0,35,57,47,77,124,12,12,11,32,97,267
11044,Ben Vander Plas,2019,2019,Ohio,MAC,31,718,94,231,44,69,50,162,29,41,40,122,162,48,28,15,33,55,267
11045,Blake Wallace,2009,2010,San Francisco,WCC,43,885,88,216,43,96,45,120,46,64,31,102,133,40,16,13,34,39,267
11046,Jake Wohlfeil,2008,2008,Campbell,A-Sun,27,789,80,223,11,43,69,180,38,44,7,65,72,58,18,2,38,39,267
11047,Shore Adenekan,2014,2015,Seattle,WAC,56,965,102,182,102,182,0,0,62,112,69,134,203,17,16,37,53,121,266
11048,Glenn Feidanga,2014,2017,Long Island University,NEC,90,1054,88,213,88,210,0,3,90,131,103,131,234,12,12,13,34,204,266
11049,Elvar Fridriksson,2015,2015,Long Island University,NEC,30,888,79,218,40,98,39,120,69,97,11,67,78,114,34,0,77,60,266
11050,Jasonn Hannibal,2008,2011,Portland,WCC,120,985,110,237,110,237,0,0,46,91,71,108,179,15,9,18,96,165,266
11051,Ryan Harp,2008,2011,Southern Methodist,CUSA,108,1880,95,248,70,145,25,103,51,72,63,185,248,108,47,20,102,100,266
11052,Kabangu Tshinga Kasamba,2009,2010,Chicago State,Total,59,1019,96,264,67,153,29,111,45,59,52,104,156,38,51,9,71,90,266
11053,Patrick Mansell,2008,2011,Rider,MAAC,109,1053,78,232,6,28,72,204,38,44,5,85,90,53,21,2,43,87,266
11054,Tyrese Martin,2019,2019,Rhode Island,A-10,33,892,99,237,66,131,33,106,35,54,62,110,172,33,27,9,46,68,266
11055,Nate Maxey,2012,2015,Total,Total,82,1078,116,178,116,178,0,0,34,77,61,151,212,8,18,147,58,190,266
11056,Emerson Murray,2011,2015,Total,Total,106,1597,86,250,47,109,39,141,55,98,40,171,211,155,66,5,109,138,266
11057,Torian Oglesby,2011,2012,Bowling Green State,MAC,59,969,119,181,119,181,0,0,28,70,100,135,235,10,29,38,43,138,266
11058,Larry Posey,2008,2008,Texas-Arlington,Southland,32,753,96,188,96,183,0,5,74,121,66,131,197,32,21,1,57,97,266
11059,Robert Sanders,2010,2011,Alabama State,SWAC,66,993,95,230,83,194,12,36,64,132,86,118,204,36,22,10,86,145,266
11060,Phyllip Taylor,2009,2011,Idaho State,Big Sky,56,753,82,220,71,172,11,48,91,133,20,59,79,49,27,9,45,71,266
11061,Lance Whitaker,2014,2017,Illinois-Chicago,Horizon,71,1545,86,250,59,158,27,92,67,121,37,148,185,140,42,18,68,176,266
11062,Buchi Awaji,2009,2010,Total,Total,56,808,94,215,51,105,43,110,34,46,39,87,126,43,29,5,35,49,265
11063,Salif Boudie,2017,2019,Arkansas State,Sun Belt,76,1050,97,151,96,150,1,1,70,108,96,174,270,14,24,51,67,179,265
11064,Drew Edwards,2016,2019,Providence,Big East,104,1094,81,237,49,126,32,111,71,96,40,103,143,55,49,11,40,122,265
11065,Oliver Ellison,2012,2016,Howard,MEAC,103,1861,104,184,104,184,0,0,57,116,126,235,361,23,34,102,75,274,265
11066,Jahmari Etienne,2019,2019,South Carolina State,MEAC,31,708,93,245,37,103,56,142,23,29,14,41,55,33,12,4,41,58,265
11067,Georgi Funtarov,2014,2017,UC-Davis,Big West,54,820,101,244,66,122,35,122,28,55,46,126,172,26,14,10,46,76,265
11068,Fred Gulley,2010,2014,Total,Total,103,1816,90,270,60,160,30,110,55,99,51,152,203,140,78,10,81,211,265
11069,Jamarcus Hairston,2017,2018,Cleveland State,Horizon,65,978,102,232,71,126,31,106,30,50,60,118,178,34,31,23,33,80,265
11070,P.J. Hardwick,2013,2016,Total,Sun Belt,66,1676,87,240,84,225,3,15,88,115,37,157,194,230,55,0,137,145,265
11071,Ayron Hutton,2015,2016,Quinnipiac,MAAC,55,1060,86,283,25,113,61,170,32,56,33,113,146,118,25,1,92,93,265
11072,Malik Jefferson,2019,2019,Mount St. Mary's,NEC,31,647,116,196,116,196,0,0,33,67,81,108,189,11,9,22,37,100,265
11073,Peter Pappageorge,2012,2013,Long Beach State,Big West,52,997,81,214,22,54,59,160,44,52,5,70,75,55,30,1,31,81,265
11074,Deng Riak,2016,2019,Total,Total,71,1463,104,255,93,213,11,42,46,75,97,254,351,31,18,46,96,169,265
11075,Lane Severyn,2015,2018,South Dakota State,Summit,111,1373,89,218,34,57,55,161,32,54,80,149,229,64,43,15,51,169,265
11076,Ryan Stilphen,2008,2008,Marist,MAAC,31,758,105,197,96,176,9,21,46,89,55,103,158,41,14,9,55,77,265
11077,Ayo Akinwole,2018,2019,Omaha,Summit,63,1101,94,208,59,125,35,83,41,56,22,97,119,97,52,2,44,69,264
11078,Stevie Clark,2014,2017,Total,Total,43,751,76,204,37,84,39,120,73,93,11,69,80,151,47,2,81,85,264
11079,Myles Dread,2019,2019,Penn State,Big Ten,32,926,90,238,23,50,67,188,17,29,19,72,91,40,20,6,25,68,264
11080,Jabril Durham,2015,2016,Arkansas,SEC,68,1250,79,234,45,125,34,109,72,91,23,115,138,256,63,2,85,109,264
11081,Chase Flint,2013,2015,Loyola Marymount,WCC,73,1730,97,264,55,119,42,145,28,42,42,159,201,227,83,4,91,144,264
11082,Alhaji Fullah,2013,2014,Charleston Southern,Big South,63,931,115,184,115,182,0,2,34,62,88,144,232,15,24,66,35,118,264
11083,Blake Hinson,2019,2019,Mississippi,SEC,32,766,88,217,42,85,46,132,42,57,23,71,94,36,15,9,28,91,264
11084,Tray Hollowell,2018,2019,Wofford,Southern,64,697,96,235,33,75,63,160,9,13,12,70,82,59,26,0,53,39,264
11085,Mike Kirkland,2015,2016,Fairfield,MAAC,42,846,92,233,82,195,10,38,70,94,38,94,132,35,20,5,55,89,264
11086,Craig LeCesne,2017,2019,Total,Total,53,879,99,251,86,200,13,51,53,66,57,133,190,76,16,6,81,95,264
11087,Shy McClelland,2016,2016,South Dakota,Summit,23,663,100,203,88,171,12,32,52,102,17,75,92,82,34,3,42,81,264
11088,Cody McDavis,2013,2015,Northern Colorado,Big Sky,57,873,110,215,109,212,1,3,43,61,40,97,137,12,13,3,39,115,264
11089,Philip McKenzie,2018,2019,Houston Baptist,Southland,61,1113,99,216,91,174,8,42,58,97,125,102,227,35,23,9,56,113,264
11090,Thomas Smallwood,2016,2019,Total,Total,68,697,96,211,58,123,38,88,34,45,47,118,165,36,6,23,39,95,264
11091,Kenyatta Smith,2012,2015,Harvard,Ivy,61,719,107,188,107,188,0,0,50,75,30,153,183,12,14,88,65,105,264
11092,Lowell Ulmer,2012,2015,St. Francis (NY),NEC,100,1137,97,239,83,181,14,58,56,109,86,107,193,50,46,23,65,187,264
11093,Everett Winchester,2018,2018,Wright State,Horizon,33,699,91,195,91,189,0,6,82,117,44,80,124,37,13,9,55,70,264
11094,Ahsan Asadullah,2019,2019,Lipscomb,A-Sun,36,510,108,193,108,193,0,0,47,69,68,101,169,27,22,24,47,65,263
11095,Kervin Bristol,2011,2012,Fordham,A-10,57,1385,116,231,116,231,0,0,31,70,158,266,424,24,20,122,51,197,263
11096,Kyle Clark,2016,2019,Saint Mary's (CA),WCC,77,1031,83,189,38,60,45,129,52,70,41,98,139,27,17,10,44,108,263
11097,Radshad Davis,2019,2019,Texas-Arlington,Sun Belt,33,765,95,186,75,124,20,62,53,68,49,132,181,44,22,9,56,80,263
11098,Derrell Edwards,2013,2014,High Point,Big South,62,1432,91,266,64,160,27,106,54,75,26,96,122,108,53,7,72,122,263
11099,Andrew Fleming,2016,2019,Total,Total,77,681,84,208,56,119,28,89,67,95,31,76,107,63,13,5,72,74,263
11100,Brevin Galloway,2018,2019,College of Charleston,CAA,40,863,100,231,48,80,52,151,11,20,22,63,85,32,40,2,23,51,263
11101,Mike Howlett,2009,2012,Pennsylvania,Ivy,69,923,101,198,98,180,3,18,58,90,82,130,212,13,13,9,61,104,263
11102,Antione Lundy,2011,2012,South Alabama,Sun Belt,37,668,99,220,94,201,5,19,60,89,68,129,197,10,18,7,46,55,263
11103,Hunter Maldonado,2018,2019,Wyoming,MWC,37,875,92,229,64,140,28,89,51,73,24,93,117,59,37,9,45,78,263
11104,Sterling Manley,2018,2019,North Carolina,ACC,55,518,99,174,99,174,0,0,65,98,63,123,186,15,6,32,44,69,263
11105,Sam Martin,2010,2013,Yale,Ivy,101,906,83,232,23,62,60,170,37,57,7,55,62,52,15,2,36,80,263
11106,Montez Mathis,2019,2019,Rutgers,Big Ten,31,710,96,255,80,188,16,67,55,99,21,69,90,34,22,6,40,56,263
11107,Tyler McCullough,2014,2017,Missouri State,MVC,107,1178,105,226,105,226,0,0,53,82,99,129,228,24,17,73,59,190,263
11108,Lamar Roberson,2008,2010,Total,Total,52,883,99,242,88,187,11,55,54,82,47,107,154,68,45,36,75,96,263
11109,Tonko Vuko,2016,2017,Pacific,WCC,54,1047,95,194,82,145,13,49,60,82,77,124,201,36,14,6,41,142,263
11110,Luka Vulikic,2017,2019,Eastern Washington,Big Sky,62,1185,107,254,98,212,9,42,40,81,38,143,181,89,27,13,83,89,263
11111,Bert Whittington,2008,2008,Ohio,MAC,33,716,91,262,42,113,49,149,32,50,12,51,63,45,34,1,51,50,263
11112,Adam Wire,2008,2011,Cornell,Ivy,103,1417,92,179,84,158,8,21,71,107,134,204,338,102,102,7,85,218,263
11113,DeVontae Wright,2011,2012,Citadel,Southern,56,988,85,246,61,170,24,76,69,99,24,93,117,94,27,6,75,72,263
11114,Taylor Adway,2016,2018,Toledo,MAC,81,839,98,191,98,190,0,1,66,115,54,146,200,21,13,29,63,136,262
11115,Trey Anderson,2010,2013,Total,Total,66,1164,88,258,71,197,17,61,69,101,30,98,128,119,26,7,130,118,262
11116,Tucker Blackwell,2018,2019,Army,Patriot,56,754,86,218,34,84,52,134,38,56,11,53,64,45,30,2,33,69,262
11117,Cliff Dixon,2010,2011,Western Kentucky,Sun Belt,55,843,103,244,99,225,4,19,52,103,71,160,231,36,29,12,68,85,262
11118,Dexter Ellington,2012,2013,Texas Southern,SWAC,55,1066,87,248,54,130,33,118,55,73,14,74,88,87,39,1,87,62,262
11119,Dayvon Ellis,2009,2010,Eastern Kentucky,OVC,56,971,97,216,59,109,38,107,30,35,27,50,77,117,47,4,63,81,262
11120,Ben Farmer,2008,2008,Marist,MAAC,32,895,77,203,16,56,61,147,47,62,13,92,105,44,17,16,30,75,262
11121,Chris Gabriel,2009,2011,Total,Total,57,676,105,217,105,217,0,0,52,80,54,113,167,14,12,15,56,134,262
11122,Mark Gordon,2019,2019,Bethune-Cookman,MEAC,27,591,98,240,55,120,43,120,23,37,9,63,72,36,19,8,69,68,262
11123,Ferrakohn Hall,2010,2013,Total,Total,96,1093,108,221,107,210,1,11,45,87,69,134,203,31,21,27,59,163,262
11124,Reggie Huffman,2008,2008,Alabama-Birmingham,CUSA,34,660,117,203,117,203,0,0,28,57,77,138,215,11,30,16,34,55,262
11125,Eric Hutchison,2011,2014,Montana,Big Sky,101,1155,96,183,96,183,0,0,70,101,65,117,182,10,13,28,55,159,262
11126,Adam Lonon,2008,2010,Virginia Military Institute,Big South,71,1387,93,187,86,154,7,33,69,106,42,65,107,202,102,2,138,124,262
11127,Carlton Lowe,2015,2017,Grambling,SWAC,86,631,83,196,50,92,33,104,63,94,40,50,90,17,6,2,34,103,262
11128,Terrance McBride,2018,2019,Cornell,Ivy,57,1366,96,212,79,145,17,67,53,72,19,109,128,122,33,3,50,75,262
11129,Jordan Mincy,2008,2009,Kent State,MAC,69,1762,98,221,67,135,31,86,35,75,28,70,98,184,83,2,108,167,262
11130,Rarlensee Nelson,2013,2013,New Orleans,Ind,26,790,90,213,87,191,3,22,79,116,16,65,81,172,34,0,104,69,262
11131,Lavar Neufville,2009,2010,Pacific,Big West,68,1132,88,234,68,162,20,72,66,108,23,87,110,137,54,8,91,99,262
11132,Barry Ogalue,2017,2018,Long Beach State,Big West,45,600,108,196,104,173,4,23,42,62,36,54,90,29,16,6,34,35,262
11133,Davis Rozitis,2010,2014,Total,Total,99,905,105,178,105,178,0,0,52,84,80,167,247,21,19,61,44,167,262
11134,Wayne Runnels,2010,2011,Creighton,MVC,73,892,97,191,94,183,3,8,65,96,84,127,211,48,20,17,60,130,262
11135,Thomas Sander,2008,2008,Davidson,Southern,35,820,111,191,104,164,7,27,33,65,63,105,168,51,27,12,47,97,262
11136,Maurice Taylor,2014,2015,Bethune-Cookman,MEAC,45,773,75,193,62,160,13,33,99,135,38,104,142,19,14,9,51,77,262
11137,Elliott Welmer,2017,2019,Saint Louis,A-10,36,813,90,203,57,114,33,89,49,78,42,116,158,25,15,32,39,91,262
11138,Marcus Williams,2008,2008,St. Francis (NY),NEC,28,855,100,192,91,164,9,28,53,89,54,100,154,74,50,6,72,75,262
11139,Derrick Woods,2016,2019,Total,Total,61,802,99,173,97,164,2,9,62,92,51,127,178,10,9,33,72,146,262
11140,Ricardo Andreotti,2011,2012,South Dakota,Total,58,1276,111,213,111,209,0,4,39,73,133,244,377,49,40,70,78,167,261
11141,John Carter Jr.,2019,2019,Navy,Patriot,31,774,84,229,43,111,41,118,52,69,34,128,162,41,21,6,56,39,261
11142,Deyonta Davis,2016,2016,Michigan State,Big Ten,35,650,119,199,119,199,0,0,23,38,72,119,191,26,9,64,30,80,261
11143,Joey Dorsey,2008,2008,Memphis,CUSA,38,958,108,167,108,167,0,0,45,119,134,228,362,20,41,74,41,107,261
11144,Tom Koopman,2014,2017,Citadel,Southern,116,1071,112,234,108,217,4,17,33,50,78,126,204,30,23,29,57,204,261
11145,Aleks Perka,2008,2009,Rice,CUSA,51,934,113,249,110,224,3,25,32,56,58,108,166,24,7,20,55,74,261
11146,John Sinis,2012,2013,San Diego,WCC,64,970,93,221,51,94,42,127,33,51,38,136,174,26,18,23,58,113,261
11147,Mitch Wilmer,2011,2013,North Dakota,Total,72,989,84,210,83,209,1,1,92,125,84,150,234,8,24,62,88,182,261
11148,Quentin Bastian,2013,2015,Total,Total,45,837,107,247,107,245,0,2,46,70,68,110,178,15,12,22,51,105,260
11149,Luis Colon,2008,2010,Kansas State,Big 12,90,1183,110,248,110,248,0,0,40,95,123,174,297,38,25,40,56,201,260
11150,Darryl Gaynor,2015,2015,San Jose State,MWC,29,705,88,280,56,167,32,113,52,67,14,27,41,58,19,2,82,63,260
11151,Caleb Holmes,2008,2008,Yale,Ivy,27,708,84,202,42,93,42,109,50,59,13,57,70,53,17,2,47,77,260
11152,Keith McGee,2019,2019,New Mexico,MWC,29,588,92,208,51,106,41,102,35,44,9,31,40,52,23,3,51,53,260
11153,Luke Meyer,2008,2008,Saint Louis,A-10,31,971,92,204,74,150,18,54,58,70,42,125,167,51,19,13,45,69,260
11154,Malik Miller,2016,2018,Fairleigh Dickinson,NEC,76,790,101,207,89,142,12,65,46,80,56,137,193,9,19,48,40,128,260
11155,Alvin Mitchell,2008,2009,Cincinnati,Big East,53,798,88,266,34,96,54,170,30,49,46,73,119,38,24,7,54,55,260
11156,Zach Pirog,2016,2019,Total,Total,77,843,103,178,103,174,0,4,54,92,92,149,241,9,11,89,42,197,260
11157,Nick Severado,2016,2018,Florida A&M,MEAC,79,1553,99,255,98,248,1,7,61,105,103,187,290,32,43,59,83,171,260
11158,Dwight Smith,2011,2015,Total,Total,76,1026,85,186,70,131,15,55,75,114,40,93,133,62,25,21,55,169,260
11159,Matt Vogrich,2010,2013,Michigan,Big Ten,124,1152,94,236,38,74,56,162,16,25,33,108,141,41,33,4,35,85,260
11160,Jawad Adekoya,2015,2016,Chicago State,WAC,41,640,79,235,31,89,48,146,53,72,16,66,82,20,25,3,36,61,259
11161,Aurimas Adomaitis,2008,2009,Long Island University,NEC,59,823,90,186,90,186,0,0,79,141,96,81,177,17,12,24,53,124,259
11162,Kyle Ahrens,2016,2019,Michigan State,Big Ten,90,927,93,214,54,88,39,126,34,44,32,98,130,45,22,5,38,93,259
11163,Charles Anderson,2008,2010,Cal Poly,Big West,85,1293,91,257,39,104,52,153,25,41,69,120,189,30,34,16,37,89,259
11164,Mrdjan Gasevic,2014,2017,Delaware State,MEAC,105,988,101,224,101,223,0,1,57,101,84,139,223,39,18,16,69,123,259
11165,JaMarkus Horace,2013,2015,Nicholls State,Southland,66,927,111,238,111,238,0,0,37,92,83,93,176,26,16,37,85,126,259
11166,Chadrack Lufile,2013,2014,Wichita State,MVC,66,836,100,180,100,180,0,0,59,106,81,152,233,17,15,37,53,73,259
11167,Boo Milligan,2015,2016,Central Arkansas,Southland,53,848,88,239,60,137,28,102,55,83,33,87,120,57,48,6,67,107,259
11168,Jo'Vontae Millner,2017,2018,Presbyterian,Big South,25,649,100,208,77,136,23,72,36,60,46,88,134,23,11,3,65,50,259
11169,J.C. Otero,2009,2010,Florida International,Sun Belt,33,684,104,212,84,133,20,79,31,53,61,137,198,26,21,16,26,45,259
11170,Blake Ralling,2012,2014,Mississippi Valley State,SWAC,81,1079,85,246,49,130,36,116,53,76,66,106,172,39,31,8,59,191,259
11171,Demarius Smith,2014,2015,Austin Peay,OVC,41,1060,90,206,77,155,13,51,66,117,29,83,112,180,46,9,147,98,259
11172,Marques Sumner,2019,2019,Stetson,A-Sun,31,716,89,256,37,114,52,142,29,36,22,67,89,65,19,2,45,54,259
11173,Sai Tummala,2014,2016,Total,Total,63,724,91,214,40,76,51,138,26,41,43,75,118,33,13,8,35,117,259
11174,Jeremiah Usiosefe,2017,2019,Western Illinois,Summit,65,1188,84,214,46,91,38,123,53,68,26,158,184,52,18,9,44,87,259
11175,Grant White,2012,2016,Total,Total,78,965,85,226,60,134,25,92,64,105,14,63,77,65,21,1,90,77,259
11176,Joniah White,2015,2018,Louisiana Tech,CUSA,83,1181,99,178,99,178,0,0,61,114,123,168,291,39,23,124,55,138,259
11177,Matt Zignorski,2016,2019,Holy Cross,Patriot,109,1300,90,253,47,113,43,140,36,50,10,74,84,63,39,4,44,81,259
11178,Rahshon Clark,2008,2008,Iowa State,Big 12,31,964,93,198,71,129,22,69,50,66,67,126,193,33,23,36,38,57,258
11179,David Collins,2008,2009,Bradley,MVC,62,852,102,197,102,197,0,0,54,81,74,132,206,19,12,63,84,132,258
11180,James Doran,2008,2009,Pacific,Big West,57,694,92,216,35,71,57,145,17,25,12,56,68,44,18,1,22,42,258
11181,Elijah Foster,2015,2018,Nevada,MWC,96,1152,96,195,96,193,0,2,66,90,74,195,269,44,23,15,53,155,258
11182,Geri Guillory,2008,2009,Southern,SWAC,53,1222,79,243,54,151,25,92,75,112,30,107,137,93,53,8,107,101,258
11183,Mike Hall,2008,2008,Idaho,WAC,27,604,80,206,16,49,64,157,34,37,9,23,32,19,23,0,22,26,258
11184,Matt Killian,2013,2016,Northwestern State,Southland,98,1285,93,244,65,156,28,88,44,68,64,116,180,34,55,22,63,107,258
11185,Tommy McCarthy,2016,2019,Harvard,Ivy,53,814,79,248,35,113,44,135,56,68,7,49,56,111,27,1,93,104,258
11186,Luther Muhammad,2019,2019,Ohio State,Big Ten,34,906,83,222,47,126,36,96,56,74,16,76,92,59,32,2,49,67,258
11187,Jared Printy,2017,2019,Western Michigan,MAC,76,1060,84,218,23,47,61,171,29,38,11,66,77,44,12,12,32,65,258
11188,Rashad Provitt,2008,2009,Alabama State,SWAC,50,1008,83,224,54,121,29,103,63,120,45,157,202,48,18,25,78,109,258
11189,Marlon Sanders,2008,2010,Dartmouth,Ivy,60,1125,100,255,94,220,6,35,52,93,34,63,97,94,44,8,82,72,258
11190,Uriel Segura,2010,2011,Texas State,Southland,57,959,71,218,23,76,48,142,68,84,24,70,94,94,26,0,71,92,258
11191,Jamal Smith,2016,2019,Cal State Fullerton,Big West,85,1482,78,184,52,114,26,70,76,116,18,167,185,116,42,11,108,214,258
11192,Lance Storrs,2008,2011,Georgia Tech,ACC,95,1275,88,275,30,94,58,181,24,35,30,105,135,83,35,4,74,150,258
11193,Gabriel Aguirre,2014,2015,Pacific,WCC,52,847,90,168,90,167,0,1,77,129,47,96,143,26,10,7,45,96,257
11194,David Bliss,2008,2008,Georgia,SEC,34,817,95,177,95,177,0,0,67,95,67,123,190,23,13,34,44,96,257
11195,Mohamed Conde,2014,2015,Western Illinois,Summit,51,1220,100,218,100,217,0,1,57,96,95,137,232,24,44,17,52,124,257
11196,Casey Crawford,2009,2010,Colorado,Big 12,51,714,91,214,46,96,45,118,30,40,32,64,96,27,23,10,30,105,257
11197,Mike Davis,2010,2014,Total,Total,75,849,98,226,88,181,10,45,51,90,41,58,99,55,39,1,42,76,257
11198,Will Emery,2017,2019,Dartmouth,Ivy,59,926,88,201,85,176,3,25,78,138,69,119,188,38,7,29,62,63,257
11199,Dylan Fritsch,2013,2013,Jacksonville,A-Sun,26,569,85,226,26,55,59,171,28,35,12,47,59,12,4,7,20,35,257
11200,Brent Holcombe,2018,2019,Loyola (MD),Patriot,38,656,100,216,74,133,26,83,31,54,48,124,172,29,12,29,44,86,257
11201,Evan Kuhlman,2018,2019,Evansville,MVC,57,1000,93,231,49,101,44,130,27,31,16,105,121,45,22,14,40,116,257
11202,Delrico Lane,2009,2010,Tennessee-Martin,OVC,41,1191,78,177,47,88,31,89,70,106,58,129,187,187,96,3,108,104,257
11203,Paolo Mancasola,2012,2013,UC-Davis,Big West,61,1506,83,202,68,155,15,47,76,111,17,88,105,185,27,1,116,150,257
11204,Frank Okeke,2013,2015,New Hampshire,AEC,73,1161,81,249,27,74,54,175,41,63,25,108,133,42,13,22,49,89,257
11205,Clyde Trapp,2018,2019,Clemson,ACC,63,1042,85,214,52,108,33,106,54,81,16,117,133,71,31,10,73,98,257
11206,Earl Watson,2015,2016,Rhode Island,A-10,63,922,98,165,98,165,0,0,61,106,89,158,247,13,13,58,41,147,257
11207,Josh Webster,2018,2019,Total,Total,57,1171,89,227,77,175,12,52,67,90,24,97,121,183,40,23,61,67,257
11208,Chris Clark,2008,2008,Temple,A-10,34,755,79,180,22,43,57,137,41,48,7,41,48,59,24,3,27,51,256
11209,Willie Cruz,2010,2011,Eastern Kentucky,OVC,61,934,96,193,94,184,2,9,62,93,69,110,179,80,34,9,52,106,256
11210,Chris Darnell,2008,2009,William & Mary,CAA,60,1315,90,234,70,142,20,92,56,71,71,154,225,79,20,21,90,110,256
11211,Daryl Edwards,2018,2019,Louisiana State,SEC,41,859,86,191,41,66,45,125,39,50,11,58,69,53,26,4,41,67,256
11212,Christian Farmer,2013,2014,Winthrop,Big South,53,624,82,239,24,54,58,185,34,46,11,26,37,21,9,3,27,47,256
11213,Alex Foster,2014,2018,Total,Total,99,906,104,194,104,193,0,1,48,99,81,147,228,13,14,46,66,135,256
11214,Danny Garrick,2019,2019,Nicholls State,Southland,31,686,89,217,17,28,72,189,6,9,17,62,79,10,10,7,19,36,256
11215,Brad Greene,2017,2018,UC-Irvine,Big West,70,735,102,198,102,198,0,0,52,75,88,156,244,20,10,44,52,151,256
11216,Brandon Hollinger,2008,2009,Alabama,SEC,58,1100,85,229,28,63,57,166,29,45,18,50,68,121,24,2,77,54,256
11217,Joseph Jackson,2008,2008,Denver,Sun Belt,30,795,86,195,47,82,39,113,45,58,18,62,80,31,17,7,46,39,256
11218,Undra Mitchem,2014,2015,Jacksonville State,OVC,46,865,86,247,33,101,53,146,31,46,20,55,75,57,41,7,51,88,256
11219,Osun Osunniyi,2019,2019,St. Bonaventure,A-10,34,925,105,184,105,184,0,0,46,69,100,158,258,26,18,92,30,97,256
11220,Tyler Ponticelli,2011,2013,Brown,Ivy,82,1634,95,177,95,176,0,1,66,104,96,145,241,122,42,10,114,185,256
11221,Stephen Rogers,2011,2012,Brigham Young,Total,54,613,84,193,47,86,37,107,51,63,20,88,108,35,19,14,36,45,256
11222,Devon Scott,2013,2015,Dayton,A-10,71,930,91,159,91,159,0,0,74,124,58,150,208,27,16,19,66,138,256
11223,Tron Smith,2008,2008,Saint Mary's (CA),WCC,32,663,86,192,69,144,17,48,67,102,20,50,70,51,21,8,68,63,256
11224,Bernard Sullivan,2012,2016,Total,Total,79,890,100,239,98,228,2,11,54,90,53,104,157,24,14,19,52,82,256
11225,Patrick Szpir,2017,2019,Chicago State,WAC,86,1413,93,216,93,213,0,3,70,102,69,165,234,49,23,27,97,177,256
11226,Chris Talkington,2011,2012,Nicholls State,Southland,46,660,80,210,31,66,49,144,47,64,16,66,82,24,11,2,32,76,256
11227,Alex Welhouse,2013,2013,Omaha,Summit,31,836,87,198,38,82,49,116,33,44,33,112,145,22,18,4,43,51,256
11228,C.J. Wiggins,2016,2018,North Carolina Central,MEAC,72,860,86,231,66,170,20,61,64,95,12,49,61,127,26,0,60,39,256
11229,T.J. Bannister,2008,2008,Liberty,Big South,31,918,66,167,46,114,20,53,103,125,14,59,73,224,31,2,116,99,255
11230,Daouda Berete,2013,2014,Central Arkansas,Southland,57,1050,85,230,71,188,14,42,71,95,43,129,172,92,59,10,75,155,255
11231,Justin Carpenter,2018,2018,Southeast Missouri State,OVC,30,641,99,189,93,167,6,22,51,76,58,83,141,21,13,13,35,80,255
11232,Jerome Clyburn,2009,2013,Total,Total,51,998,75,199,59,150,16,49,89,116,19,70,89,113,34,7,84,65,255
11233,Lazarius Coleman,2008,2008,Savannah State,Ind,31,726,100,206,96,195,4,11,51,91,72,112,184,19,26,23,54,101,255
11234,Robbie Cowgill,2008,2008,Washington State,Pac-10,35,983,105,194,105,193,0,1,45,66,62,116,178,23,23,29,26,89,255
11235,Kendall Cutler,2011,2011,South Dakota,GWC,31,776,73,167,73,166,0,1,109,159,30,69,99,138,39,0,75,76,255
11236,Ede Egharevba,2014,2016,Total,Total,50,656,98,232,71,143,27,89,32,52,38,94,132,26,32,9,47,92,255
11237,Chancellor Ellis,2017,2019,Total,Total,53,566,82,231,11,35,71,196,20,25,18,21,39,13,2,3,16,54,255
11238,Alex Ennis,2017,2019,Total,Total,86,1224,107,199,107,198,0,1,41,71,102,175,277,12,25,28,65,166,255
11239,Anthony Evans,2013,2014,Alcorn State,SWAC,61,1125,94,288,61,157,33,131,34,50,30,79,109,93,52,0,62,67,255
11240,Michael Gholston,2010,2012,Missouri-Kansas City,Summit,89,1162,85,242,36,106,49,136,36,49,22,60,82,69,33,1,63,92,255
11241,Scott Grote,2009,2010,Wright State,Horizon,62,1005,87,186,75,151,12,35,69,105,50,120,170,81,30,3,82,111,255
11242,Eric Hazard,2008,2008,Fairleigh Dickinson,NEC,28,922,87,238,37,78,50,160,31,44,29,107,136,34,13,9,58,54,255
11243,Knox Hellums,2017,2018,Pepperdine,WCC,57,882,83,213,22,64,61,149,28,36,10,64,74,25,15,6,30,69,255
11244,Brandon Johnson,2008,2008,Old Dominion,CAA,34,925,94,233,74,156,20,77,47,66,50,90,140,157,91,9,99,79,255
11245,Shaun Logan,2008,2008,Northern Illinois,MAC,28,770,98,196,69,123,29,73,30,57,45,105,150,55,33,22,64,101,255
11246,Tyrell Mara,2008,2009,Portland State,Big Sky,62,1083,84,202,34,71,50,131,37,58,69,116,185,73,31,4,58,70,255
11247,J.T. Miller,2018,2018,Missouri State,MVC,32,658,106,224,95,187,11,37,32,49,23,87,110,40,16,7,52,60,255
11248,Shadell Millinghaus,2015,2017,Total,Total,49,703,84,184,62,117,22,67,65,101,37,72,109,42,36,5,46,65,255
11249,Aaron Morgan,2013,2015,Maryland-Baltimore County,AEC,60,1274,73,251,31,100,42,151,67,97,22,77,99,110,41,3,125,150,255
11250,Jon Pastorek,2008,2011,Total,Total,86,1207,96,195,81,154,15,41,48,66,80,144,224,73,32,23,87,117,255
11251,Shaq Preston,2015,2018,Total,Total,65,884,95,230,83,183,12,47,53,88,39,87,126,42,34,17,62,126,255
11252,Ben Pyle,2019,2019,Western Illinois,Summit,30,832,84,214,37,86,47,128,40,50,15,100,115,52,27,1,36,37,255
11253,Sean Rhea,2018,2018,Texas A&M-Corpus Christi,Southland,27,713,94,188,91,180,3,8,64,112,49,101,150,14,21,22,59,91,255
11254,Kyle Rowley,2009,2013,Total,Total,114,958,102,209,102,209,0,0,51,104,75,133,208,34,12,24,92,169,255
11255,Sean Taibi,2008,2008,Northern Colorado,Big Sky,23,506,92,202,45,85,47,117,24,32,21,47,68,17,10,0,30,53,255
11256,Ashley Williams,2015,2018,Western Carolina,Southern,77,712,77,215,46,116,31,99,70,95,40,40,80,28,21,11,38,70,255
11257,Jawaan Wright,2009,2010,Loyola (MD),MAAC,60,947,87,168,87,167,0,1,81,139,102,121,223,31,31,56,51,200,255
11258,Devan Bawinkel,2009,2010,Iowa,Big Ten,64,1182,84,228,1,5,83,223,3,6,5,75,80,32,11,0,20,43,254
11259,Lonnie Boga,2010,2011,Milwaukee,Horizon,59,868,88,205,56,115,32,90,46,87,56,102,158,36,28,5,46,98,254
11260,Tommy Burton,2019,2019,Coastal Carolina,Sun Belt,34,619,87,178,87,172,0,6,80,116,66,73,139,23,30,16,51,105,254
11261,Marvin Cannon,2019,2019,Washington State,Pac-12,32,689,72,165,54,111,18,54,92,109,35,73,108,19,17,23,39,51,254
11262,Kevin Cantinol,2009,2012,Total,Total,75,1042,109,237,109,237,0,0,36,80,100,121,221,23,19,38,60,155,254
11263,Deontae Cole,2014,2016,Northern Kentucky,Total,78,1027,86,246,14,32,72,214,10,13,20,59,79,40,10,11,13,66,254
11264,R.J. Curington,2014,2017,DePaul,Big East,80,649,89,214,56,107,33,107,43,55,51,45,96,26,16,8,47,83,254
11265,Shaquille Doorson,2015,2019,Rutgers,Big Ten,121,1482,109,188,109,188,0,0,36,103,161,175,336,30,18,77,58,181,254
11266,Ephraim Ekanem,2012,2013,Northern Arizona,Big Sky,59,815,106,218,106,218,0,0,42,97,72,105,177,9,24,24,41,122,254
11267,Scott Friske,2008,2009,Brown,Ivy,51,1173,94,218,84,187,10,31,56,89,48,159,207,130,44,16,95,111,254
11268,Darin Granger,2008,2009,Evansville,MVC,44,801,88,229,40,104,48,125,30,37,11,60,71,31,11,0,23,25,254
11269,Parrish Hewitt,2018,2019,Tennessee-Martin,OVC,47,813,91,215,57,104,34,111,38,46,25,93,118,43,22,11,34,49,254
11270,Greg Lee,2018,2019,Cal State Bakersfield,WAC,62,757,107,241,81,161,26,80,14,20,50,111,161,39,10,6,66,131,254
11271,Jaylin McCoy,2018,2019,Southern Illinois-Edwardsville,OVC,52,802,84,259,29,90,55,169,31,41,9,40,49,52,20,0,43,46,254
11272,Jake Ohmer,2018,2019,Western Kentucky,CUSA,65,914,83,245,35,84,48,161,40,51,15,40,55,49,29,1,28,76,254
11273,Damontez Oliver,2017,2018,Campbell,Big South,65,968,82,201,28,61,54,140,36,54,19,97,116,44,20,7,53,110,254
11274,Kadeem Pantophlet,2012,2013,Duquesne,A-10,60,1038,89,216,38,79,51,137,25,36,57,125,182,38,19,9,41,72,254
11275,J.J. Wesley,2008,2008,Jacksonville State,OVC,24,573,82,209,17,46,65,163,25,27,11,44,55,32,18,1,22,41,254
11276,Trevor Cook,2008,2009,Texas Tech,Big 12,44,668,85,180,61,110,24,70,59,76,36,83,119,24,13,30,50,94,253
11277,Jeremiah Eason,2014,2015,Southern Mississippi,CUSA,54,1155,92,214,92,211,0,3,69,140,95,114,209,37,30,7,67,141,253
11278,Ridge McKeither,2010,2010,Chattanooga,Southern,27,471,95,178,89,159,6,19,57,92,45,119,164,24,16,4,72,78,253
11279,Kameron Ritter,2011,2013,Saint Francis (PA),NEC,69,1460,90,201,68,133,22,68,51,102,24,98,122,106,72,22,87,134,253
11280,Andrew Robinson,2016,2018,Quinnipiac,MAAC,62,797,85,255,17,43,68,212,15,23,28,73,101,14,11,1,22,45,253
11281,Anthony Sally,2009,2010,Western Kentucky,Sun Belt,65,1507,65,188,47,124,18,64,105,146,43,165,208,179,57,4,169,126,253
11282,Albert Thomas,2013,2014,Delaware State,MEAC,58,1395,89,205,80,176,9,29,66,99,40,86,126,154,37,0,92,98,253
11283,Jake Wojcik,2019,2019,Richmond,A-10,33,991,78,221,13,42,65,179,32,39,17,97,114,48,40,6,24,77,253
11284,Fiifi Aidoo,2017,2018,Grand Canyon,WAC,60,842,85,231,47,97,38,134,44,63,37,60,97,56,36,14,46,74,252
11285,Jules Bernard,2019,2019,UCLA,Pac-12,33,566,82,175,59,113,23,62,65,88,27,76,103,28,17,3,50,68,252
11286,Michael Bibby,2017,2019,Total,Total,50,951,80,189,27,60,53,129,39,45,4,68,72,77,29,6,76,92,252
11287,Matt Braeuer,2008,2008,Wichita State,MVC,21,725,93,216,49,90,44,126,22,41,16,53,69,70,25,1,46,39,252
11288,Ceylon Elgin-Taylor,2008,2009,Montana,Big Sky,49,1201,85,203,75,166,10,37,72,108,34,58,92,159,30,11,83,99,252
11289,Rodney Haddix,2008,2010,Miami (OH),MAC,69,934,82,218,48,107,34,111,54,72,26,74,100,44,33,10,68,115,252
11290,Rishawn Johnson,2008,2010,Canisius,MAAC,87,900,95,204,95,203,0,1,62,110,44,98,142,26,18,9,84,163,252
11291,Jalen Jones,2016,2019,Howard,MEAC,120,1779,98,184,93,172,5,12,51,113,122,229,351,83,45,37,89,223,252
11292,Kyle Koncz,2008,2008,Princeton,Ivy,28,936,78,221,23,49,55,172,41,49,27,109,136,41,27,3,41,77,252
11293,Danny Lewis,2019,2019,Kennesaw State,A-Sun,23,554,94,262,59,163,35,99,29,45,5,31,36,40,15,1,50,57,252
11294,Zack Moritz,2008,2011,Boise State,WAC,86,760,104,206,104,206,0,0,44,81,72,100,172,21,12,12,43,86,252
11295,Tre Nichols,2009,2012,Total,Total,56,671,87,242,62,143,25,99,53,68,10,33,43,49,27,1,44,31,252
11296,Reggis Onwukamuche,2014,2015,Prairie View,SWAC,64,1127,94,193,94,193,0,0,64,111,99,121,220,10,20,71,76,197,252
11297,Jordan Pleiman,2008,2008,Wright State,Horizon,31,723,101,168,101,168,0,0,50,82,61,127,188,7,10,12,49,91,252
11298,Jermaine Samuels,2018,2019,Villanova,Big East,60,922,80,191,44,80,36,111,56,90,66,153,219,43,16,30,48,88,252
11299,Olivier Sarr,2018,2019,Wake Forest,ACC,55,995,86,206,76,166,10,40,70,106,88,138,226,23,20,46,69,148,252
11300,Dominique Whatley,2008,2009,Bethune-Cookman,MEAC,33,748,89,218,57,119,32,99,42,70,19,52,71,26,22,6,47,69,252
11301,Austin Williams,2015,2018,North Carolina A&T,MEAC,97,1127,89,254,78,198,11,56,63,144,34,101,135,143,78,6,153,140,252
11302,Jaylon Wilson,2019,2019,Longwood,Big South,23,555,86,208,46,93,40,115,40,52,11,42,53,29,12,2,15,34,252
11303,Elliott Cole,2016,2016,Chicago State,WAC,28,527,87,233,34,76,53,157,24,27,11,37,48,48,25,0,52,44,251
11304,Marquise Collins,2018,2018,Delaware State,MEAC,28,542,84,203,53,119,31,84,52,63,18,60,78,16,7,6,42,53,251
11305,John Comeaux,2018,2019,Stephen F. Austin,Southland,54,838,87,203,71,146,16,57,61,99,34,78,112,80,61,4,49,139,251
11306,Kevin Gray,2012,2014,Northern Illinois,MAC,83,1479,97,254,97,253,0,1,57,111,110,157,267,33,28,14,73,191,251
11307,Samuel Haanpaa,2008,2008,Valparaiso,Horizon,25,695,77,174,19,39,58,135,39,47,14,62,76,25,13,1,46,33,251
11308,Darrell Jenkins,2008,2008,East Carolina,CUSA,30,841,82,201,42,101,40,100,47,64,16,67,83,181,28,0,86,57,251
11309,Jalen Little,2015,2016,Abilene Christian,Southland,57,1540,75,221,41,121,34,100,67,82,15,127,142,228,62,2,100,130,251
11310,Chris Longoria,2012,2014,Total,Total,44,859,82,233,58,137,24,96,63,81,17,77,94,56,35,5,66,77,251
11311,Scott Meredith,2016,2018,Saint Francis (PA),NEC,71,770,83,216,24,46,59,170,26,30,10,62,72,35,30,2,29,48,251
11312,Nerlens Noel,2013,2013,Kentucky,SEC,24,765,98,166,98,166,0,0,55,104,65,162,227,38,50,106,45,62,251
11313,Kristof Ongenaet,2008,2009,Syracuse,Big East,67,1150,85,171,80,140,5,31,76,121,113,196,309,75,46,38,73,151,251
11314,James Parlow,2008,2008,New Orleans,Sun Belt,30,772,84,236,29,73,55,163,28,34,9,91,100,53,39,5,39,66,251
11315,Eral Penn,2018,2019,Long Island University,NEC,61,817,87,136,82,123,5,13,72,113,81,137,218,14,20,63,28,131,251
11316,Derrick Randall,2012,2015,Total,Total,120,1081,99,185,99,185,0,0,53,102,129,131,260,4,28,38,52,155,251
11317,Cheikh Sane,2014,2015,Marshall,CUSA,63,1123,89,203,88,197,1,6,72,132,117,180,297,34,39,43,72,172,251
11318,Jelani Simmons,2019,2019,Youngstown State,Horizon,31,707,92,202,45,85,47,117,20,25,29,49,78,33,30,5,31,50,251
11319,Raheem Solomon,2019,2019,Niagara,MAAC,32,594,79,206,29,75,50,131,43,53,24,48,72,21,12,5,42,64,251
11320,Corey Spence,2014,2015,Northern Colorado,Big Sky,61,1138,87,234,73,178,14,56,63,86,22,83,105,123,31,0,83,102,251
11321,Taylor Sutlive,2014,2017,Cal Poly,Big West,62,848,88,207,22,42,66,165,9,12,17,63,80,47,25,8,24,70,251
11322,Daniel Waddy,2008,2008,Colgate,Patriot,32,907,78,209,54,130,24,79,71,107,12,100,112,90,40,12,114,87,251
11323,Karl White,2008,2008,Illinois-Chicago,Horizon,31,644,97,208,85,171,12,37,45,75,18,43,61,52,26,6,55,53,251
11324,Walter Whyte,2018,2018,Boston University,Patriot,27,664,88,183,71,137,17,46,58,86,39,96,135,30,23,14,46,46,251
11325,Devante Wilson,2014,2014,San Jose State,MWC,30,731,76,238,21,67,55,171,44,56,35,49,84,20,20,10,37,59,251
11326,Nicola Akele,2016,2018,Rhode Island,A-10,96,1125,98,208,71,139,27,69,27,47,78,130,208,47,33,28,29,165,250
11327,George Akpele,2008,2010,Grambling,SWAC,75,1080,111,219,111,219,0,0,28,90,86,150,236,16,15,63,71,149,250
11328,Joel Barkers,2010,2010,Hartford,AEC,29,620,90,208,89,207,1,1,69,123,53,80,133,20,12,5,45,81,250
11329,Joe Bova,2008,2009,Columbia,Ivy,45,865,86,234,50,119,36,115,42,54,51,119,170,31,10,2,46,87,250
11330,Antwaun Boyd,2009,2012,Total,Total,58,990,92,218,83,190,9,28,57,81,26,99,125,95,32,5,96,149,250
11331,Deleon Brown,2017,2019,Colorado,Pac-12,63,979,83,236,42,105,41,131,43,63,14,45,59,43,26,8,51,95,250
11332,LaQuentin Collins,2015,2019,Southern,SWAC,79,941,84,239,51,142,33,97,49,74,33,90,123,50,29,15,60,70,250
11333,Jabari Currie,2008,2009,DePaul,Big East,52,858,83,197,47,101,36,96,48,87,8,51,59,114,17,6,93,65,250
11334,Tripp Davis,2018,2019,Tennessee State,OVC,48,847,79,178,42,74,37,104,55,78,13,98,111,45,58,4,36,88,250
11335,Rod Earls,2008,2008,Tulsa,CUSA,39,859,87,234,41,95,46,139,30,37,17,78,95,64,18,2,68,55,250
11336,Daniel Eykyn,2008,2011,Citadel,Southern,105,1337,79,212,46,110,33,102,59,75,75,101,176,42,27,5,53,147,250
11337,Brian Grimes,2010,2011,Columbia,Ivy,40,808,93,262,93,251,0,11,64,100,62,139,201,37,28,17,60,50,250
11338,Allan Guei,2012,2013,Cal State Northridge,Big West,57,972,90,253,68,205,22,48,48,65,15,55,70,118,39,7,65,96,250
11339,Josh Hairston,2011,2014,Duke,ACC,121,1139,97,220,97,217,0,3,56,87,89,97,186,27,16,14,52,215,250
11340,Johnny Hill,2008,2010,Southeast Missouri State,OVC,76,1212,101,251,96,224,5,27,43,72,56,122,178,51,30,10,76,111,250
11341,Ryan Hill,2011,2014,Bucknell,Patriot,124,1729,77,209,65,171,12,38,84,130,16,184,200,166,50,6,126,181,250
11342,Ajani Kennedy,2018,2019,UC-Riverside,Big West,44,687,91,180,59,109,32,71,36,48,39,98,137,34,16,11,49,76,250
11343,Ifeanyi Koggu,2008,2009,Arkansas State,Sun Belt,60,1473,79,211,71,185,8,26,84,119,27,113,140,204,48,3,80,87,250
11344,Arturas Lazdauskas,2008,2010,Long Beach State,Big West,79,1222,102,192,98,177,4,15,42,71,74,139,213,90,59,45,79,179,250
11345,Mitch Lightfoot,2017,2019,Kansas,Big 12,97,1032,101,180,91,150,10,30,38,72,90,149,239,25,18,98,54,159,250
11346,Unique McLean,2018,2019,Massachusetts,A-10,56,1258,101,252,87,198,14,54,34,50,71,168,239,88,32,16,61,115,250
11347,Robert Murry,2009,2009,Morehead State,OVC,31,637,82,187,73,157,9,30,77,102,7,44,51,43,24,1,63,67,250
11348,Javon Parris,2009,2010,Marist,MAAC,60,1144,89,258,71,186,18,72,54,99,44,127,171,68,38,4,101,112,250
11349,JaQuel Richmond,2015,2018,Total,Total,60,928,91,254,65,177,26,77,42,57,12,63,75,99,23,0,74,103,250
11350,D'Mitri Riggs,2012,2012,Eastern Kentucky,OVC,30,867,80,218,42,112,38,106,52,67,18,72,90,43,41,8,28,71,250
11351,Brandon Robinson,2017,2019,North Carolina,ACC,106,998,85,205,46,102,39,103,41,62,47,100,147,99,29,13,47,124,250
11352,Jamie Schneck,2012,2015,Hartford,AEC,116,1321,104,200,104,200,0,0,42,95,54,141,195,48,21,44,76,192,250
11353,Josh Sharp,2012,2015,Brigham Young,WCC,115,1379,93,168,88,151,5,17,59,90,128,165,293,63,30,29,45,179,250
11354,Tyrell Thompson,2008,2010,Army,Patriot,70,699,94,224,82,174,12,50,50,69,28,60,88,24,35,4,77,85,250
11355,Grant Verhoeven,2013,2017,Stanford,Pac-12,117,1156,90,192,80,170,10,22,60,92,94,102,196,27,31,28,39,219,250
11356,Brennan Votel,2008,2009,Pennsylvania,Ivy,45,746,109,235,102,202,7,33,25,48,47,102,149,25,19,15,63,108,250
11357,Jarvis Williams,2011,2012,Green Bay,Horizon,33,734,100,203,100,198,0,5,50,91,53,97,150,23,24,6,77,86,250
11358,Makai Ashton-Langford,2018,2019,Providence,Big East,63,956,91,251,72,174,19,77,48,86,5,95,100,125,40,13,97,102,249
11359,Ryan Badowski,2015,2015,Longwood,Big South,34,752,78,202,17,43,61,159,32,44,15,68,83,17,22,3,26,73,249
11360,Isaiah Banks,2018,2019,Florida International,CUSA,54,739,98,203,78,112,20,91,33,69,39,50,89,41,47,9,45,86,249
11361,Arthur Bouedo,2010,2012,Wyoming,MWC,80,1197,90,245,45,93,45,152,24,41,19,66,85,68,26,1,65,83,249
11362,Miles Brookins,2018,2019,La Salle,A-10,57,855,93,171,91,159,2,12,61,74,55,74,129,22,13,30,49,148,249
11363,Paul Campbell,2008,2010,Hawaii,WAC,83,1108,105,178,105,178,0,0,39,84,116,110,226,57,21,58,54,168,249
11364,Eric Curry,2017,2019,Minnesota,Big Ten,49,961,92,217,86,178,6,39,59,87,65,158,223,68,24,30,52,99,249
11365,Reginald Delk,2009,2010,Louisville,Big East,60,833,89,191,40,69,49,122,22,34,32,76,108,45,20,18,24,60,249
11366,Marcelle Goins,2008,2008,Arkansas-Pine Bluff,SWAC,30,791,75,248,40,143,35,105,64,99,20,52,72,64,11,1,55,67,249
11367,Julius Hearn,2010,2011,Texas-Rio Grande Valley,GWC,60,1303,78,238,64,177,14,61,79,144,41,131,172,101,60,4,90,116,249
11368,Janeil Jenkins,2013,2016,Total,Total,79,945,79,155,58,101,21,54,70,93,9,52,61,90,34,0,80,87,249
11369,Ibrahim Kpaka,2009,2009,Grambling,SWAC,29,655,80,253,40,106,40,147,49,81,23,62,85,34,24,2,54,61,249
11370,Cheikh Mbacke Diong,2018,2019,Nevada-Las Vegas,MWC,56,929,97,167,97,165,0,2,55,100,91,166,257,14,33,62,56,149,249
11371,Lapri McCray-Pace,2018,2019,Morgan State,MEAC,56,720,86,207,71,165,15,42,62,97,58,79,137,33,31,7,32,85,249
11372,Eric McKinney,2009,2009,Arkansas State,Sun Belt,29,692,104,189,104,188,0,1,41,72,62,116,178,15,21,58,28,49,249
11373,Boris Meno,2008,2008,Davidson,Southern,36,732,109,221,108,203,1,18,30,45,65,129,194,14,25,28,58,73,249
11374,Taze Moore,2017,2019,Cal State Bakersfield,WAC,54,803,99,225,84,163,15,62,36,56,44,95,139,75,60,24,65,121,249
11375,Mike Pouncy,2011,2011,Central Arkansas,Southland,28,687,90,215,74,169,16,46,53,83,27,60,87,61,39,5,52,57,249
11376,Jumane Reed,2008,2009,Alcorn State,SWAC,53,1275,81,213,63,154,18,59,69,122,34,110,144,129,60,3,126,93,249
11377,K.C. Robbins,2010,2011,Illinois-Chicago,Horizon,61,828,114,236,114,236,0,0,21,34,61,150,211,16,8,48,75,118,249
11378,Casey Roberts,2013,2014,Liberty,Big South,65,753,82,213,30,80,52,133,33,49,18,66,84,44,19,1,25,85,249
11379,Rashaun Stimage,2015,2016,DePaul,Big East,46,778,95,176,94,170,1,6,58,114,83,91,174,2,18,64,38,116,249
11380,Scott Blakney,2018,2019,Idaho,Big Sky,47,827,99,175,99,172,0,3,50,72,58,103,161,22,5,12,47,131,248
11381,Kyle Camper,2008,2008,Iona,MAAC,32,913,84,251,42,112,42,139,38,67,22,81,103,123,35,9,98,93,248
11382,Daniel Camps,2014,2015,Northern Kentucky,A-Sun,45,638,95,178,91,159,4,19,54,82,44,75,119,37,29,1,46,87,248
11383,Simeon Carter,2016,2019,Total,Total,49,570,113,194,110,174,3,20,19,33,35,99,134,12,9,40,16,50,248
11384,Matt Clark,2008,2011,Citadel,Southern,89,1198,94,218,71,143,23,75,37,65,101,113,214,32,26,11,57,151,248
11385,William Cooper,2008,2011,Eastern Michigan,MAC,112,1680,102,242,93,213,9,29,35,74,102,173,275,85,65,68,116,182,248
11386,Strahinja Gavrilovic,2013,2016,Southern California,Pac-12,80,773,86,200,78,170,8,30,68,105,58,74,132,8,16,4,41,84,248
11387,Aaron Hall,2008,2009,Central Connecticut State,NEC,53,1018,110,235,107,223,3,12,25,49,73,109,182,81,31,4,76,102,248
11388,Jake Hendricks,2019,2019,Wyoming,MWC,23,827,80,201,13,36,67,165,21,33,3,63,66,24,23,0,22,60,248
11389,Keon Hill,2014,2016,Howard,MEAC,97,1146,88,288,48,154,40,134,32,51,13,44,57,129,21,2,105,79,248
11390,Andre Horne Jr.,2016,2016,Morgan State,MEAC,26,583,83,213,50,115,33,98,49,63,27,37,64,34,21,5,38,81,248
11391,Daye Kaba,2008,2010,Total,Total,35,776,90,231,60,142,30,89,38,59,38,105,143,47,22,8,53,48,248
11392,Tre Lee,2010,2013,Total,Total,60,1066,80,250,53,137,27,113,61,90,36,114,150,51,28,8,83,76,248
11393,Uros Ljeskovic,2013,2016,Total,Total,88,959,98,188,98,188,0,0,52,123,114,95,209,13,26,8,82,151,248
11394,Michael Loyd,2008,2010,Brigham Young,MWC,68,788,88,176,61,110,27,66,45,67,7,65,72,76,33,5,72,46,248
11395,Omar El Manasterly,2014,2017,Jacksonville,A-Sun,93,1188,92,186,92,186,0,0,64,103,102,178,280,30,34,6,54,175,248
11396,Ben Marcus,2016,2018,Little Rock,Sun Belt,64,702,108,167,108,167,0,0,32,77,52,94,146,18,26,18,46,104,248
11397,Brandon McDonnell,2013,2016,Dartmouth,Ivy,86,857,95,202,88,170,7,32,51,65,41,121,162,31,17,32,46,111,248
11398,Cyrus McGowan,2009,2010,Miami (FL),ACC,64,892,83,193,67,143,16,50,66,101,92,132,224,29,21,43,73,117,248
11399,Dylan Miller,2014,2018,Total,Total,89,818,109,205,105,189,4,16,26,38,61,90,151,25,17,36,32,104,248
11400,Donnell Minton,2013,2014,Lamar,Southland,54,1116,96,256,95,248,1,8,55,81,24,96,120,80,29,13,114,83,248
11401,Jerome Odem,2008,2008,Troy,Sun Belt,31,659,81,182,26,48,55,134,31,34,8,39,47,68,38,0,36,31,248
11402,Andrew Osemhen,2011,2014,Kennesaw State,A-Sun,115,1475,87,216,87,216,0,0,74,125,89,142,231,21,21,38,83,225,248
11403,Jorge Perez-Laham,2014,2016,High Point,Big South,77,1315,92,235,58,147,34,88,30,46,15,116,131,196,42,5,95,109,248
11404,Jordan Pickett,2014,2016,Total,Total,32,717,83,220,60,143,23,77,59,72,9,39,48,50,21,3,39,43,248
11405,Steve Rennard,2011,2014,Pennsylvania,Ivy,76,1329,75,194,26,51,49,143,49,68,17,86,103,89,46,1,70,143,248
11406,Victor Robbins,2013,2015,Oregon State,Pac-12,59,682,82,196,65,140,17,56,67,104,40,67,107,32,28,6,39,45,248
11407,Kelvin Sango,2008,2009,Oral Roberts,Summit,63,1301,78,186,65,124,13,62,79,125,47,93,140,125,78,16,89,126,248
11408,Ryan Schwieger,2018,2019,Princeton,Ivy,50,804,86,194,63,122,23,72,53,67,20,83,103,43,22,9,58,71,248
11409,Terrence Simmons,2008,2009,Idaho,WAC,61,1329,96,220,54,107,42,113,14,29,19,110,129,102,27,8,69,114,248
11410,Jake Belford,2013,2016,Davidson,Total,58,710,88,173,63,110,25,63,46,62,35,92,127,32,11,10,54,100,247
11411,Nick Blair,2016,2019,Total,Total,66,789,95,213,73,145,22,68,35,59,61,124,185,39,17,12,44,71,247
11412,Sherrard Brantley,2011,2013,Georgia,SEC,93,1255,81,259,15,50,66,209,19,28,7,85,92,65,17,4,54,46,247
11413,Tomas Bruha,2010,2014,Total,Total,85,1056,94,181,94,181,0,0,59,95,99,114,213,10,17,23,69,146,247
11414,Craig Cusick,2012,2013,Brigham Young,WCC,71,1277,78,207,27,77,51,130,40,61,14,120,134,148,58,0,55,100,247
11415,Caleb Donnelly,2015,2016,Northeastern,CAA,63,904,79,188,11,33,68,155,21,31,18,61,79,30,9,1,25,46,247
11416,Mack Foster,2015,2016,Louisiana-Monroe,Sun Belt,70,1061,93,238,64,127,29,111,32,51,31,72,103,54,40,9,43,101,247
11417,Stephan Hawkins,2013,2014,Robert Morris,NEC,70,1104,103,224,103,224,0,0,41,57,77,103,180,16,14,48,50,160,247
11418,Christopher Joyce,2018,2019,Air Force,MWC,42,731,86,223,49,113,37,110,38,58,17,96,113,56,12,5,32,58,247
11419,Jermaine Long,2017,2018,East Tennessee State,Southern,68,1145,74,205,50,96,24,109,75,108,24,110,134,147,76,11,99,147,247
11420,Nate Minnoy,2008,2008,Central Michigan,MAC,28,568,96,212,93,187,3,25,52,83,40,69,109,27,16,6,69,56,247
11421,Raul Orta,2008,2008,Saint Peter's,MAAC,30,828,83,210,43,98,40,112,41,50,18,61,79,31,30,9,45,73,247
11422,J'Mychal Reese,2013,2014,Texas A&M,SEC,39,961,93,245,70,183,23,62,38,51,12,75,87,69,22,4,81,73,247
11423,Brandon Rogers,2009,2010,Alcorn State,SWAC,51,880,79,207,60,147,19,60,70,101,27,81,108,44,30,0,90,102,247
11424,Trent Rogers,2009,2012,Tulane,CUSA,111,1396,74,197,37,87,37,110,62,95,11,91,102,150,61,5,112,115,247
11425,Mareceo Rutledge,2008,2009,Nevada-Las Vegas,MWC,64,806,85,199,44,86,41,113,36,55,56,96,152,24,44,2,44,85,247
11426,Rudy Stradnieks,2016,2019,Southern Illinois,MVC,108,824,99,210,84,154,15,56,34,55,52,91,143,24,7,10,54,118,247
11427,Eric Stubbs,2008,2011,North Carolina-Asheville,Big South,91,986,106,217,106,216,0,1,35,67,67,139,206,29,22,28,70,142,247
11428,Jerime Anderson,2009,2010,UCLA,Pac-10,64,1008,93,205,73,147,20,58,40,65,16,57,73,142,42,12,100,86,246
11429,Yor Anei,2019,2019,Oklahoma State,Big 12,32,753,98,159,98,159,0,0,50,78,59,96,155,22,9,85,47,102,246
11430,Tyler Benson,2008,2009,St. Bonaventure,A-10,60,1330,85,239,33,63,52,176,24,41,62,111,173,99,41,15,53,139,246
11431,Jake Byrne,2008,2008,Eastern Illinois,OVC,28,724,101,186,101,179,0,7,44,56,48,86,134,38,18,11,30,55,246
11432,Larry Dennis,2015,2018,Total,Total,73,964,105,253,105,249,0,4,36,101,50,163,213,13,18,49,71,180,246
11433,Dragon Elkaz,2019,2019,UC-Riverside,Big West,33,889,79,189,14,39,65,150,23,30,4,54,58,26,20,4,26,58,246
11434,Akiean Frederick,2018,2019,Kent State,MAC,56,833,100,180,95,155,5,25,41,58,80,89,169,29,26,22,42,124,246
11435,Sebastian Greene,2008,2008,Fordham,A-10,29,833,91,164,80,129,11,35,53,77,52,108,160,41,30,9,57,88,246
11436,James Humphrey,2008,2009,Missouri-Kansas City,Summit,58,1006,83,230,65,143,18,87,62,89,60,140,200,33,30,40,83,106,246
11437,Dominitrix Johnson,2008,2008,Illinois State,MVC,30,894,89,203,51,96,38,107,30,37,15,62,77,98,14,5,54,52,246
11438,Avery Jukes,2008,2010,Butler,Horizon,87,812,84,190,59,124,25,66,53,87,44,74,118,13,14,16,29,151,246
11439,Kevon Moore,2009,2009,North Carolina-Wilmington,CAA,27,625,82,203,60,133,22,70,60,108,28,82,110,31,27,0,49,45,246
11440,Lucas N'Guessan,2017,2019,Total,Total,76,819,93,137,93,135,0,2,60,96,70,100,170,24,19,48,71,165,246
11441,D.J. Posley,2008,2009,UC-Santa Barbara,Big West,58,1201,95,262,79,211,16,51,40,66,24,94,118,117,78,3,96,120,246
11442,A.J. Reeves,2019,2019,Providence,Big East,25,568,85,201,40,83,45,118,31,44,18,58,76,16,24,3,25,35,246
11443,Dragan Sekelja,2010,2014,Total,Total,77,981,91,208,88,199,3,9,61,104,78,168,246,73,18,29,102,150,246
11444,Kealen Washington-Ives,2017,2018,Rider,MAAC,65,1099,79,221,43,105,36,116,52,74,13,82,95,149,24,1,81,124,246
11445,Jalanni White,2018,2019,Canisius,MAAC,57,841,101,200,96,175,5,25,39,69,54,74,128,28,21,39,45,119,246
11446,Herman Wrice,2009,2010,St. Francis (NY),NEC,59,1194,101,205,101,203,0,2,44,98,105,167,272,15,35,78,78,182,246
11447,Brett Boese,2013,2016,Washington State,Pac-12,95,985,86,226,23,51,63,175,10,17,29,56,85,46,14,2,32,78,245
11448,Kirk Crecco,2009,2012,Dartmouth,Ivy,90,853,91,234,79,174,12,60,51,71,43,75,118,26,20,3,49,69,245
11449,Marquis Cunningham,2016,2017,Arkansas-Pine Bluff,SWAC,58,706,92,204,92,202,0,2,61,97,45,93,138,24,27,38,64,138,245
11450,Dave Diakite,2009,2011,Central Florida,CUSA,62,833,80,200,73,172,7,28,78,128,70,124,194,27,31,10,70,126,245
11451,Cameron Downing,2011,2013,Buffalo,MAC,69,638,88,134,88,134,0,0,69,103,48,55,103,30,7,17,58,126,245
11452,Frederic Dure,2015,2016,Arkansas State,Sun Belt,42,915,69,194,39,103,30,91,77,116,12,117,129,70,23,19,73,85,245
11453,Tony Eackles,2010,2011,Alcorn State,SWAC,54,645,70,182,54,141,16,41,89,134,20,40,60,29,22,5,77,61,245
11454,O.J. Evans,2010,2013,Northwestern State,Southland,115,1132,104,220,104,219,0,1,37,76,94,161,255,26,19,53,56,138,245
11455,Donovan Greer,2017,2019,NJIT,A-Sun,55,685,83,218,25,63,58,155,21,28,23,53,76,35,22,5,32,80,245
11456,Petey Hausley,2011,2012,Appalachian State,Southern,45,676,96,183,96,183,0,0,53,93,60,67,127,7,19,22,44,114,245
11457,Matt Heldt,2016,2019,Marquette,Big East,112,1446,92,143,92,143,0,0,61,87,112,189,301,36,20,56,39,215,245
11458,Ryghe Lyons,2018,2019,Nicholls State,Southland,59,897,110,211,107,193,3,18,22,36,72,99,171,73,30,69,77,155,245
11459,Sean McCurdy,2009,2010,William & Mary,CAA,56,1283,77,214,50,124,27,90,64,96,21,104,125,168,49,1,105,112,245
11460,Tyrell McDowell,2008,2009,Citadel,Southern,53,973,85,216,42,98,43,118,32,44,43,81,124,36,24,11,54,84,245
11461,Mikhail McLean,2011,2015,Houston,Total,101,1125,87,183,87,180,0,3,71,130,83,103,186,25,21,21,58,169,245
11462,Dwan McMillan,2011,2012,Hofstra,CAA,43,1203,78,211,75,187,3,24,86,128,15,90,105,189,53,2,110,123,245
11463,Daron Populist,2010,2012,Total,Total,64,1056,77,198,27,69,50,129,41,55,6,40,46,60,16,2,62,52,245
11464,Trevon Seymore,2016,2016,Coppin State,MEAC,24,748,79,230,58,149,21,81,66,91,22,92,114,95,32,7,58,62,245
11465,Melvin Smith,2008,2008,Texas-San Antonio,Southland,30,835,95,234,86,196,9,38,46,62,8,41,49,51,29,6,52,46,245
11466,Shawn Stockton,2009,2012,Montana,Big Sky,100,1372,89,223,62,121,27,102,40,61,17,106,123,89,40,2,81,146,245
11467,Maurice Thomas,2009,2009,St. Bonaventure,A-10,26,514,89,161,89,161,0,0,67,94,59,99,158,14,20,7,39,80,245
11468,Duane Washington Jr.,2019,2019,Ohio State,Big Ten,35,600,91,246,50,112,41,134,22,34,9,78,87,37,10,0,37,45,245
11469,Jerron Wilbut,2016,2017,Cal State Northridge,Big West,41,520,86,234,53,111,33,123,40,59,15,39,54,25,15,3,51,75,245
11470,Teddy Allen,2018,2018,West Virginia,Big 12,35,417,91,195,88,170,3,25,59,80,44,52,96,19,13,0,33,64,244
11471,Julio Anthony,2008,2008,Eastern Illinois,OVC,27,662,72,163,47,110,25,53,75,82,15,32,47,55,16,2,60,64,244
11472,Chris Bilbo,2015,2015,Troy,Sun Belt,29,1006,83,221,62,141,21,80,57,89,15,89,104,85,28,7,62,60,244
11473,M.J. Brown,2009,2010,Tennessee-Martin,OVC,49,972,85,252,71,194,14,58,60,85,22,96,118,101,48,1,75,57,244
11474,David Carr,2012,2014,Portland,WCC,72,1202,88,265,48,136,40,129,28,60,15,80,95,118,23,3,56,89,244
11475,Danny Evans,2017,2018,Maine,AEC,63,1065,87,216,44,90,43,126,27,39,34,116,150,55,32,8,71,91,244
11476,Damian Goodwin,2014,2016,Total,Total,47,783,87,228,77,178,10,50,60,117,47,101,148,46,26,21,52,114,244
11477,Brandon Hayman,2012,2015,Samford,Southern,96,846,113,206,111,191,2,15,16,50,81,66,147,28,32,14,41,111,244
11478,Doug Miller,2008,2010,Harvard,Ivy,70,1026,110,194,110,194,0,0,24,54,79,104,183,24,11,30,45,105,244
11479,Angus Riley,2015,2018,Bryant,NEC,89,902,82,230,38,89,44,141,36,51,47,116,163,36,11,7,37,133,244
11480,Darrell Riley,2017,2019,Total,Total,36,719,79,226,48,151,31,75,55,75,17,52,69,82,23,1,78,45,244
11481,Duran Roberson,2008,2010,Austin Peay,OVC,64,775,96,200,90,169,6,31,46,75,44,99,143,18,6,29,44,84,244
11482,Julian Royal,2012,2016,Total,Total,79,892,95,244,81,187,14,57,40,56,66,85,151,25,20,21,63,113,244
11483,Hunter Sabety,2017,2018,Hofstra,CAA,63,681,102,144,102,144,0,0,40,80,90,135,225,16,12,63,35,132,244
11484,Lamar Wofford-Humphrey,2017,2018,Total,Total,49,667,102,207,89,169,13,38,27,47,64,102,166,18,12,19,44,97,244
11485,Arthur Capers,2013,2014,Alabama A&M,SWAC,40,690,94,226,67,138,27,88,28,44,27,74,101,33,27,9,48,82,243
11486,Exavian Christon,2018,2019,Louisiana Tech,CUSA,40,738,87,193,53,96,34,97,35,41,16,79,95,34,23,2,39,59,243
11487,Stuart Creason,2008,2008,Colorado State,MWC,20,512,97,168,97,168,0,0,49,63,36,78,114,22,4,31,32,59,243
11488,E.J. Dawson,2008,2010,Longwood,Ind,82,1478,87,242,66,185,21,57,48,83,31,102,133,199,59,8,130,183,243
11489,Curtis Haywood II,2018,2019,Georgia Tech,ACC,44,994,80,219,31,57,49,162,34,43,15,106,121,94,47,8,57,73,243
11490,Austin Howard,2017,2017,Maine,AEC,32,683,90,236,52,135,38,101,25,37,12,60,72,28,14,1,35,30,243
11491,Keyon Jones,2018,2019,New Mexico State,WAC,59,741,83,202,24,48,59,154,18,29,26,91,117,37,28,5,37,90,243
11492,Justin Joyner,2008,2011,UC-Santa Barbara,Big West,84,2007,85,230,38,98,47,132,26,62,18,147,165,276,98,5,126,175,243
11493,Rade Kukobat,2019,2019,Eastern Illinois,OVC,32,778,85,207,68,153,17,54,56,81,65,87,152,27,15,28,43,81,243
11494,Callum McRae,2019,2019,UC-Riverside,Big West,32,600,98,177,98,176,0,1,47,73,48,106,154,30,8,10,69,56,243
11495,Ibn Muhammad,2015,2016,Iona,MAAC,68,1503,82,192,32,65,50,127,29,44,13,97,110,151,49,0,61,112,243
11496,Kenechukwu Ndefo,2019,2019,Saint Peter's,MAAC,31,847,86,197,80,170,6,27,65,99,39,114,153,27,28,56,66,95,243
11497,Reed Nikko,2017,2019,Missouri,SEC,92,919,99,177,99,177,0,0,45,84,75,121,196,23,21,55,52,141,243
11498,John Ogwuche,2017,2019,New Hampshire,AEC,54,922,79,208,42,98,37,110,48,64,31,96,127,35,25,10,35,70,243
11499,Chuba Ohams,2017,2019,Fordham,A-10,59,1038,98,234,93,210,5,24,42,89,79,207,286,43,40,53,80,147,243
11500,Daniel Regis,2018,2019,Nicholls State,Southland,50,772,91,171,90,165,1,6,60,98,73,132,205,28,14,54,51,122,243
11501,Kj Sherrill,2010,2012,Charlotte,A-10,75,1041,85,187,85,185,0,2,73,108,78,88,166,19,22,35,58,126,243
11502,Brandon Smith,2016,2018,UC-Irvine,Big West,102,1495,85,241,61,146,24,95,49,80,43,174,217,67,44,35,80,172,243
11503,Nigel Sydnor,2013,2014,NJIT,Total,49,818,79,197,54,118,25,79,60,96,29,68,97,44,21,1,46,93,243
11504,Lamont Walker,2017,2018,Texas Southern,SWAC,53,906,83,180,69,135,14,45,63,95,59,150,209,23,28,4,31,95,243
11505,DaShaun Williams,2008,2009,Houston,CUSA,56,1016,96,219,80,165,16,54,35,65,50,128,178,66,56,2,40,78,243
11506,K.J. Williams,2019,2019,Murray State,OVC,32,582,111,159,110,154,1,5,20,38,58,93,151,15,18,19,21,60,243
11507,Deaundrae Ballard,2018,2019,Florida,SEC,59,658,93,234,68,138,25,96,31,42,34,64,98,15,22,7,36,65,242
11508,Dontae Bryant,2009,2010,San Francisco,WCC,59,1591,82,222,55,139,27,83,51,98,37,159,196,205,74,2,116,88,242
11509,Karron Clarke,2008,2008,DePaul,Big East,30,745,88,201,54,104,34,97,32,56,46,97,143,21,29,11,32,69,242
11510,Spencer Coleman,2013,2013,Montana,Big Sky,32,686,87,173,63,112,24,61,44,57,31,87,118,25,24,8,37,78,242
11511,Tonnie Collier,2015,2015,Texas Southern,SWAC,33,521,73,175,36,66,37,109,59,76,28,64,92,9,8,2,33,45,242
11512,Darian Dixon,2018,2019,Northwestern State,Southland,58,847,78,157,76,149,2,8,84,126,76,79,155,25,18,17,42,103,242
11513,DeShawn Dockery,2010,2013,Total,Total,75,1494,87,237,61,142,26,95,42,99,20,97,117,141,49,3,122,152,242
11514,B.J. Duling,2018,2019,Kent State,MAC,61,796,95,226,81,174,14,52,38,89,39,99,138,30,31,32,38,124,242
11515,Elgin Fitzgerald,2008,2009,Dartmouth,Ivy,51,680,94,215,94,214,0,1,54,71,50,85,135,11,17,23,44,95,242
11516,Dwight Gentry,2009,2010,Texas-Arlington,Southland,48,761,73,172,50,98,23,74,73,97,26,70,96,69,33,2,49,71,242
11517,Ray George,2008,2008,Murray State,OVC,31,617,87,197,71,149,16,48,52,74,5,54,59,71,28,20,83,75,242
11518,TyQuane Goard,2012,2014,Total,Total,60,995,91,172,91,168,0,4,60,91,83,109,192,30,35,28,40,100,242
11519,Ron Harper Jr.,2019,2019,Rutgers,Big Ten,31,690,88,213,58,105,30,108,36,53,16,81,97,35,18,16,27,75,242
11520,Feron Hunt,2019,2019,Southern Methodist,AAC,32,753,98,177,90,145,8,32,38,55,61,143,204,22,25,28,47,63,242
11521,Lamar Johnson,2008,2009,Rider,MAAC,50,730,80,212,22,44,58,168,24,30,3,69,72,41,29,5,35,40,242
11522,Jeremy Jones,2015,2019,Total,Total,120,1184,80,147,66,108,14,39,68,109,59,199,258,55,55,26,49,140,242
11523,Collins Joseph,2019,2019,Savannah State,MEAC,31,623,79,211,30,66,49,145,35,53,19,49,68,69,24,1,46,36,242
11524,Austin Karrer,2015,2018,Texas-San Antonio,CUSA,121,1960,78,212,45,90,33,122,53,88,86,230,316,92,67,12,60,204,242
11525,Anthony King,2008,2008,Miami (FL),ACC,34,812,90,209,90,209,0,0,62,90,83,156,239,43,23,48,42,60,242
11526,Dylan Moseley,2008,2009,Texas State,Southland,58,726,84,222,39,84,45,138,29,50,48,103,151,49,32,18,57,101,242
11527,Bryan Narcisse,2009,2012,Clemson,ACC,102,1069,90,194,73,134,17,60,45,75,60,91,151,39,37,35,55,138,242
11528,Micah Potter,2017,2018,Ohio State,Big Ten,59,714,87,189,64,118,23,71,45,65,66,97,163,18,13,22,32,107,242
11529,Keith Richardson,2008,2008,Illinois State,MVC,35,1055,87,199,63,127,24,72,44,73,18,57,75,130,55,0,62,69,242
11530,Jordan Salley,2013,2014,Sacramento State,Big Sky,56,671,96,155,96,155,0,0,50,79,56,87,143,8,18,11,37,125,242
11531,Gerson Santo,2013,2014,Colorado State,MWC,63,958,89,165,89,165,0,0,64,93,80,89,169,16,18,20,30,107,242
11532,Rob Thomas,2008,2010,St. John's (NY),Big East,57,576,96,190,94,184,2,6,48,87,77,62,139,4,17,9,29,60,242
11533,Michael Tyree,2008,2009,Stony Brook,AEC,40,569,77,258,34,94,43,164,45,51,11,32,43,17,21,1,30,39,242
11534,C.J. Williamson,2016,2019,Total,Total,54,825,78,234,44,118,34,116,52,68,40,95,135,59,32,5,67,100,242
11535,Gregg Wooten,2010,2013,Samford,Southern,52,763,85,209,71,154,14,55,58,105,8,56,64,56,24,1,75,43,242
11536,Jamal Abu-Shamala,2008,2009,Minnesota,Big Ten,67,854,86,196,52,93,34,103,35,48,30,86,116,48,18,9,54,71,241
11537,O'Karo Akamune,2012,2014,Western Kentucky,Sun Belt,82,1058,95,181,95,180,0,1,51,106,117,146,263,30,45,31,61,181,241
11538,Jabari Alex,2015,2017,Mississippi Valley State,SWAC,83,1039,114,183,113,177,1,6,12,22,70,113,183,23,34,22,48,118,241
11539,Zack Atkinson,2009,2010,UC-Irvine,Big West,59,884,103,221,103,221,0,0,35,57,64,125,189,12,12,60,47,106,241
11540,Robert Baker,2017,2019,Harvard,Ivy,70,835,88,210,58,116,30,94,35,47,32,174,206,33,26,47,52,88,241
11541,Nick Billingsley,2016,2017,Texas-San Antonio,CUSA,35,425,81,202,50,111,31,91,48,62,16,59,75,9,13,10,42,60,241
11542,Luke Davis,2011,2015,Total,Total,76,1251,75,219,32,85,43,134,48,68,7,65,72,171,47,0,108,75,241
11543,Myron Dempsey,2012,2012,Texas A&M-Corpus Christi,Southland,28,775,104,217,104,217,0,0,33,81,85,116,201,25,33,22,41,81,241
11544,Kyle Doyle,2014,2015,Georgia Southern,Total,59,986,100,217,96,202,4,15,37,97,92,139,231,22,30,23,71,141,241
11545,David Duke,2019,2019,Providence,Big East,34,840,84,217,62,143,22,74,51,74,19,71,90,73,23,11,72,85,241
11546,Jemal Farmer,2010,2011,Arkansas,SEC,50,742,86,200,70,157,16,43,53,75,42,76,118,33,24,8,52,94,241
11547,Tashon Fredrick,2010,2013,Tennessee State,OVC,97,1250,82,215,69,169,13,46,64,91,73,110,183,34,38,2,65,126,241
11548,John David Gardner,2008,2010,Wright State,Horizon,36,861,85,193,66,137,19,56,52,70,19,56,75,98,35,3,55,57,241
11549,John Grant Jr.,2018,2019,Savannah State,MEAC,57,563,85,259,27,71,58,188,13,24,23,86,109,18,16,8,34,76,241
11550,Tyrese Haliburton,2019,2019,Iowa State,Big 12,35,1163,87,168,38,55,49,113,18,26,26,94,120,125,54,30,28,47,241
11551,Deric Hill,2012,2013,Florida International,Sun Belt,55,1041,75,200,58,140,17,60,74,100,27,69,96,138,89,3,97,103,241
11552,John Jones,2014,2015,Illinois State,MVC,57,854,97,187,97,186,0,1,47,88,75,122,197,11,20,37,47,134,241
11553,DJ Lindsay,2009,2009,Tennessee Tech,OVC,30,539,95,205,82,156,13,49,38,66,42,49,91,38,27,6,60,49,241
11554,Ryan Pearson,2016,2019,Navy,Patriot,93,785,84,247,34,76,50,171,23,33,9,50,59,36,18,1,55,59,241
11555,Yalen Reed,2017,2018,Alcorn State,SWAC,60,858,94,180,85,147,9,33,44,84,67,128,195,33,13,46,42,125,241
11556,Erik Stevenson,2019,2019,Wichita State,AAC,37,811,78,240,34,82,44,158,41,52,20,116,136,78,31,7,57,102,241
11557,Cam Biedscheid,2013,2016,Total,Total,39,670,81,227,40,90,41,137,37,45,9,46,55,38,9,10,36,43,240
11558,Nate Butler,2012,2013,Texas Christian,Total,64,1381,84,247,60,179,24,68,48,83,36,122,158,79,56,25,80,127,240
11559,David Gebru,2010,2012,Western Illinois,Summit,68,817,95,198,95,198,0,0,50,92,59,98,157,20,15,32,54,127,240
11560,Kyle Green,2010,2013,Air Force,MWC,54,744,76,201,29,67,47,134,41,52,19,58,77,69,24,1,49,73,240
11561,Rodney Hawkins,2015,2016,Saint Peter's,MAAC,52,782,97,227,87,194,10,33,36,63,67,112,179,26,12,22,49,114,240
11562,Erik Johansson,2017,2019,Loyola Marymount,WCC,85,930,78,221,12,30,66,191,18,24,4,47,51,42,16,1,29,48,240
11563,James Johnson,2012,2015,Total,Total,68,813,94,178,94,178,0,0,52,91,45,87,132,14,12,16,79,141,240
11564,Nemania Jokic,2008,2009,Detroit Mercy,Horizon,60,1193,77,229,34,104,43,125,43,63,57,112,169,64,22,10,86,139,240
11565,Karolis Kundrotas,2016,2019,Elon,CAA,111,966,92,217,71,156,21,61,35,65,64,138,202,28,15,17,63,135,240
11566,Jayveous McKinnis,2019,2019,Jackson State,SWAC,29,755,105,158,105,157,0,1,30,61,83,144,227,8,29,59,20,81,240
11567,Javon Pickett,2019,2019,Missouri,SEC,31,808,94,257,61,152,33,105,19,36,33,70,103,46,23,3,47,73,240
11568,Pete Rakocevic,2011,2015,Total,Total,87,931,93,219,92,197,1,22,53,84,60,112,172,23,12,36,76,151,240
11569,Heiden Ratner,2008,2009,James Madison,CAA,63,1021,76,180,34,70,42,110,46,71,20,80,100,65,41,4,58,90,240
11570,Ryan Regis,2010,2012,NJIT,GWC,90,1551,94,208,94,208,0,0,52,83,97,181,278,17,25,89,90,240,240
11571,Tyler Reynolds,2019,2019,Manhattan,MAAC,31,602,83,197,24,44,59,153,15,17,7,76,83,21,18,5,24,32,240
11572,Jourdain Scoubes,2010,2010,Utah Valley,GWC,30,754,72,213,32,89,40,124,56,77,40,125,165,20,18,4,32,74,240
11573,Kevin Thomas,2011,2014,Tulane,CUSA,105,1133,99,182,99,182,0,0,42,72,79,85,164,10,10,95,65,174,240
11574,Au'Diese Toney,2019,2019,Pittsburgh,ACC,32,806,80,222,63,153,17,69,63,95,61,117,178,15,22,4,34,62,240
11575,Trey Warren,2016,2017,Florida A&M,MEAC,46,670,91,186,90,183,1,3,57,95,70,97,167,6,6,8,70,116,240
11576,Joshua White,2013,2017,Total,Total,54,757,90,227,53,105,37,122,23,36,25,73,98,44,17,8,32,59,240
11577,Aaron Williams,2012,2015,Chicago State,Total,78,936,91,279,69,184,22,95,36,60,64,108,172,29,51,15,73,114,240
11578,Montigo Alford,2015,2016,Boise State,MWC,59,769,80,210,43,105,37,105,42,62,2,62,64,82,28,8,64,84,239
11579,Charles Bennett,2015,2015,Indiana State,MVC,30,688,74,190,33,72,41,118,50,64,12,62,74,90,24,1,56,54,239
11580,Stephan Bennett,2015,2017,Total,Total,58,964,91,201,87,190,4,11,53,96,67,93,160,24,20,31,40,128,239
11581,Julius Francis,2011,2014,Total,Total,72,1002,95,268,93,260,2,8,47,81,50,143,193,15,14,15,86,128,239
11582,Matt Freeman,2017,2019,Oklahoma,Big 12,84,831,84,226,31,70,53,156,18,23,20,100,120,28,19,16,39,84,239
11583,Jarrett Givens,2019,2019,Austin Peay,OVC,33,679,78,194,26,59,52,135,31,39,34,80,114,29,34,7,21,51,239
11584,Julian Harrell,2014,2017,Total,Total,35,728,88,197,57,110,31,87,32,59,17,80,97,48,19,14,39,95,239
11585,Josh Jackson,2009,2009,South Carolina State,MEAC,30,527,97,183,97,183,0,0,45,78,48,94,142,30,7,12,68,56,239
11586,Damion Moore,2017,2019,Temple,AAC,72,741,100,183,100,183,0,0,39,65,71,99,170,12,17,29,29,85,239
11587,Jon-Michael Nickerson,2010,2010,Kennesaw State,A-Sun,33,665,93,215,78,173,15,42,38,61,54,78,132,39,18,10,53,62,239
11588,Bubu Palo,2011,2013,Iowa State,Big 12,70,951,57,150,39,98,18,52,107,147,22,90,112,89,29,4,60,104,239
11589,Nathan Priddy,2018,2019,Elon,CAA,38,816,86,231,38,98,48,133,19,22,12,75,87,81,19,1,58,63,239
11590,Justin Reilly,2008,2010,Pennsylvania,Ivy,62,744,87,195,73,146,14,49,51,76,32,75,107,31,13,23,56,123,239
11591,Aaron Robinson,2016,2019,Quinnipiac,MAAC,81,1242,86,246,22,44,64,202,3,21,30,122,152,46,26,2,34,99,239
11592,Alex Savannah,2009,2011,Alcorn State,SWAC,79,1095,80,234,71,192,9,42,70,130,24,84,108,78,55,3,107,115,239
11593,Cameron Shelton,2019,2019,Northern Arizona,Big Sky,30,826,71,184,58,143,13,41,84,113,31,92,123,76,37,5,50,73,239
11594,Kevin Stineman,2011,2012,Southern Illinois-Edwardsville,Total,55,1201,81,199,56,121,25,78,52,77,5,114,119,121,27,0,108,97,239
11595,Armel TeTe,2017,2019,Presbyterian,Big South,83,1209,92,198,92,197,0,1,55,110,96,163,259,15,21,56,75,159,239
11596,Steve Toyloy,2009,2010,Cincinnati,Big East,67,1059,94,169,94,169,0,0,51,101,82,155,237,35,13,15,60,125,239
11597,Sam Waardenburg,2018,2019,Miami (FL),ACC,53,1107,80,192,47,106,33,86,46,60,61,111,172,55,26,20,51,102,239
11598,Keith Wooden,2008,2008,North Texas,Sun Belt,28,529,100,177,100,175,0,2,39,55,40,110,150,30,14,14,54,73,239
11599,Kraidon Woods,2008,2012,Total,Total,83,1101,92,142,92,142,0,0,55,137,78,181,259,29,24,67,74,150,239
11600,Jaylen Brantley,2016,2017,Maryland,Big Ten,65,814,82,201,38,90,44,111,30,48,13,82,95,50,24,1,30,66,238
11601,Steven Cunningham,2010,2012,Troy,Sun Belt,54,936,101,215,90,175,11,40,25,81,66,105,171,65,43,36,70,93,238
11602,Wesley Dickinson,2014,2017,Dartmouth,Ivy,100,884,92,159,92,159,0,0,54,92,79,77,156,16,20,34,54,101,238
11603,Brandon Dorsett,2012,2013,Grambling,SWAC,47,937,81,243,61,168,20,75,56,83,25,83,108,71,40,5,87,45,238
11604,Aaron Garner,2008,2009,Boise State,WAC,61,793,83,214,34,74,49,140,23,32,16,40,56,39,14,4,29,41,238
11605,Catraiva Givens,2008,2008,Jackson State,SWAC,33,943,74,210,42,111,32,99,58,89,11,73,84,118,45,3,70,81,238
11606,James Hajek,2012,2015,Weber State,Big Sky,88,1049,94,190,94,190,0,0,50,91,82,151,233,22,17,45,51,151,238
11607,K'ja Johnson,2016,2017,Florida A&M,MEAC,34,927,83,203,56,121,27,82,45,83,12,81,93,90,44,9,78,72,238
11608,Kylor Kelley,2019,2019,Oregon State,Pac-12,31,728,100,152,100,152,0,0,38,62,48,106,154,13,10,104,30,70,238
11609,Kerwin Okoro,2014,2017,Total,Total,52,646,84,231,46,116,38,115,32,43,20,60,80,36,17,12,58,60,238
11610,Bobby Parker,2019,2019,Kennesaw State,A-Sun,27,624,90,230,52,120,38,110,20,29,14,70,84,34,16,4,32,24,238
11611,Jermol Paul,2008,2012,Total,Total,84,890,77,206,63,143,14,63,70,101,39,73,112,19,21,3,75,125,238
11612,Alex Peters,2015,2018,Samford,Southern,108,1132,96,167,96,167,0,0,46,80,67,104,171,17,30,32,62,261,238
11613,Ty Rowell,2019,2019,California Baptist,WAC,31,707,76,182,21,43,55,139,31,37,8,46,54,26,11,0,31,48,238
11614,Orlando Sanchez,2014,2014,St. John's (NY),Big East,32,714,92,180,81,136,11,44,43,56,48,130,178,44,25,36,43,82,238
11615,Greg Senat,2014,2017,Wagner,NEC,104,1094,92,193,92,193,0,0,54,110,134,150,284,13,27,34,57,204,238
11616,Hunter Thompson,2019,2019,Wyoming,MWC,27,760,79,185,40,81,39,104,41,58,6,72,78,22,6,14,45,93,238
11617,Jordan Tucker,2018,2019,Total,Total,26,546,74,205,23,68,51,137,39,48,8,92,100,18,11,2,34,49,238
11618,Bryan Urrutia,2019,2019,Maryland-Eastern Shore,MEAC,30,982,83,215,69,162,14,53,58,89,13,98,111,163,51,4,92,84,238
11619,Jordan Vandenberg,2010,2014,North Carolina State,ACC,108,1317,107,175,107,174,0,1,24,48,96,170,266,47,20,94,45,203,238
11620,Kerry Weldon,2014,2015,Massachusetts-Lowell,AEC,57,1215,100,214,100,213,0,1,38,126,111,171,282,49,51,31,84,176,238
11621,Emmitt Williams,2019,2019,Louisiana State,SEC,34,671,89,145,88,139,1,6,59,86,87,95,182,13,11,22,38,66,238
11622,Tim Williams,2010,2013,Saint Mary's (CA),WCC,73,515,88,152,86,143,2,9,60,84,47,107,154,15,10,31,34,82,238
11623,William Wilson,2010,2013,North Florida,A-Sun,124,2321,91,264,74,207,17,57,39,75,22,159,181,379,97,3,201,153,238
11624,Bryan Akinkugbe,2014,2015,North Carolina A&T,MEAC,58,886,87,200,87,199,0,1,63,107,76,88,164,16,12,49,74,149,237
11625,B.J. Bailey,2010,2013,Total,Total,46,856,74,164,35,79,39,85,50,69,20,89,109,43,26,18,38,84,237
11626,Daquan Cook,2013,2017,Total,Total,71,785,80,246,45,130,35,116,42,59,18,44,62,54,26,2,49,62,237
11627,Brian Freeman,2008,2009,Long Beach State,Big West,61,1157,91,170,80,140,11,30,44,65,78,177,255,102,46,47,100,160,237
11628,Chris Fuller,2008,2008,Florida International,Sun Belt,29,853,77,182,54,119,23,63,60,93,23,63,86,62,30,8,78,69,237
11629,Brandon Hall,2009,2012,Saint Peter's,MAAC,120,2122,77,256,54,166,23,90,60,102,18,155,173,248,138,5,141,229,237
11630,Shawn Hopkins,2016,2018,Troy,Sun Belt,74,793,80,215,37,74,43,141,34,55,37,99,136,33,15,11,41,74,237
11631,Walter Jackson,2011,2012,Sacramento State,Big Sky,37,950,100,194,96,170,4,24,33,46,72,94,166,36,26,30,43,63,237
11632,Skal Labissiere,2016,2016,Kentucky,SEC,36,567,98,190,98,188,0,2,41,62,35,78,113,11,9,59,33,108,237
11633,Mason Leggett,2012,2013,Jacksonville State,OVC,58,1137,80,214,69,178,11,36,66,99,27,105,132,81,61,6,87,75,237
11634,Ryan McTavish,2012,2013,Presbyterian,Big South,59,1170,90,220,65,126,25,94,32,40,28,117,145,24,16,5,51,114,237
11635,Rayshawn Miller,2016,2019,Total,Total,73,1298,88,252,44,106,44,146,17,27,13,88,101,103,33,3,65,80,237
11636,Tim Morris,2008,2008,Washington,Pac-10,33,776,99,218,86,174,13,44,26,44,40,78,118,63,30,7,49,94,237
11637,Luke Moyer,2013,2015,Total,Total,52,641,76,174,14,39,62,135,23,32,11,36,47,46,9,0,45,52,237
11638,Robert Palacios,2008,2009,Northern Colorado,Big Sky,53,1139,89,211,88,199,1,12,58,100,90,155,245,97,65,4,85,114,237
11639,Andre' Ratliff,2008,2008,Grambling,SWAC,26,772,81,215,33,74,48,141,27,42,17,36,53,79,18,0,61,46,237
11640,Shane Reybold,2011,2014,North Carolina-Wilmington,CAA,82,977,91,183,91,183,0,0,55,96,95,146,241,19,37,40,46,159,237
11641,D'Angelo Richardson,2017,2018,Southern Mississippi,CUSA,62,1075,76,230,47,122,29,108,56,72,15,73,88,103,33,2,76,101,237
11642,Roberts Blumbergs,2018,2019,Grand Canyon,WAC,54,659,80,208,56,100,24,108,52,68,41,102,143,32,19,20,46,65,236
11643,Brian Chestnut,2008,2009,Coppin State,MEAC,69,1314,84,218,84,218,0,0,68,117,89,144,233,21,18,10,88,83,236
11644,Dean Danos,2014,2016,Northern Kentucky,Total,78,888,76,173,28,64,48,109,36,44,13,72,85,75,21,1,66,97,236
11645,Mecklen Davis,2008,2008,Montana State,Big Sky,30,638,80,179,71,156,9,23,67,93,49,55,104,34,24,1,46,87,236
11646,Ross Forman,2008,2009,Loyola (IL),Horizon,49,1056,90,213,55,94,35,119,21,29,43,86,129,36,20,10,32,81,236
11647,Matthew Friday,2009,2012,Samford,Southern,106,1396,104,199,97,148,7,51,21,47,69,148,217,154,56,46,111,127,236
11648,Shawn Grant,2010,2010,Maryland-Baltimore County,AEC,29,650,82,219,44,110,38,109,34,45,13,62,75,18,19,4,31,53,236
11649,Ryan Hargrave,2011,2013,Presbyterian,Big South,67,767,85,212,55,111,30,101,36,46,33,95,128,20,3,3,36,109,236
11650,Malcolm Herron,2012,2013,Eastern Illinois,OVC,55,666,81,229,41,112,40,117,34,42,24,73,97,28,20,6,36,63,236
11651,Anthony Ike,2008,2008,Texas Southern,SWAC,32,711,74,185,55,145,19,40,69,110,61,88,149,21,16,4,44,85,236
11652,Jamel Jackson,2010,2011,Seton Hall,Big East,50,613,81,224,19,42,62,182,12,19,8,37,45,32,14,3,19,45,236
11653,Jelani Johnson,2010,2011,Western Illinois,Summit,53,1176,88,227,45,127,43,100,17,27,25,120,145,59,52,12,73,93,236
11654,Steve Johnston,2013,2015,Fairfield,MAAC,63,973,65,209,9,27,56,182,50,72,12,60,72,37,27,2,41,93,236
11655,Bobby Jones,2013,2014,Tennessee-Martin,OVC,54,634,76,230,29,82,47,148,37,60,25,53,78,15,26,9,32,87,236
11656,Ra'Shawn Langston,2019,2019,Louisiana Tech,CUSA,33,741,79,208,39,83,40,125,38,48,8,55,63,53,24,3,23,50,236
11657,Junior Longrus,2013,2016,Washington State,Pac-12,125,1761,100,205,100,202,0,3,36,96,152,182,334,80,54,73,79,230,236
11658,Szymon Lukasiak,2008,2010,Jacksonville,A-Sun,88,876,103,214,103,213,0,1,30,69,87,123,210,11,8,35,84,201,236
11659,Malik Martin,2019,2019,Charlotte,CUSA,25,791,76,190,49,96,27,94,57,75,15,87,102,27,29,13,36,50,236
11660,Eddren McCain,2009,2010,Bradley,MVC,55,1162,83,216,62,133,21,83,49,78,49,85,134,145,41,1,96,99,236
11661,Robert McCoy,2019,2019,Portland State,Big Sky,32,701,80,204,58,114,22,90,54,88,73,111,184,29,32,19,43,87,236
11662,Zach McRoberts,2015,2019,Total,Total,112,1860,86,202,59,121,27,81,37,58,92,222,314,100,80,20,52,192,236
11663,Anthony Murphy,2019,2019,Drake,MVC,34,722,76,171,54,93,22,78,62,77,27,128,155,47,19,14,46,78,236
11664,Jake Newton,2015,2016,Southern Illinois-Edwardsville,OVC,53,781,76,236,19,85,57,151,27,40,22,69,91,36,23,5,48,81,236
11665,Dekyron Nicks,2008,2008,Southeastern Louisiana,Southland,30,935,72,156,44,90,28,66,64,80,16,92,108,123,39,5,72,70,236
11666,Antwon Oliver,2013,2014,Campbell,Big South,61,958,91,219,67,115,24,104,30,49,59,105,164,48,37,46,53,120,236
11667,Raymon Pratt,2017,2018,North Carolina A&T,MEAC,53,764,93,204,83,161,10,43,40,67,31,70,101,29,14,5,42,73,236
11668,Jereme Richmond,2011,2011,Illinois,Big Ten,31,685,104,197,102,185,2,12,26,43,53,103,156,57,13,13,54,51,236
11669,Jay Shunnar,2009,2011,Toledo,MAC,64,1101,73,199,39,84,34,115,56,79,11,61,72,53,26,6,57,82,236
11670,Stephen Wilson,2011,2014,Savannah State,Total,109,999,72,243,43,134,29,109,63,89,20,50,70,66,43,0,80,127,236
11671,Ahmed Ali,2019,2019,Washington State,Pac-12,32,678,76,204,31,66,45,138,38,46,18,41,59,92,22,2,39,69,235
11672,Jordan Allou,2011,2012,Montana State,Big Sky,59,949,100,173,100,172,0,1,35,83,92,95,187,16,28,24,45,160,235
11673,Anthony Borden,2012,2013,Central Arkansas,Southland,51,851,103,213,103,213,0,0,29,64,75,111,186,22,19,83,64,126,235
11674,Brandon Cataldo,2012,2015,Portland State,Big Sky,85,680,101,179,101,179,0,0,33,52,71,110,181,13,8,35,36,112,235
11675,Julian Conyers,2008,2008,Coppin State,MEAC,35,737,90,241,61,146,29,95,26,36,17,66,83,28,27,6,44,63,235
11676,Blake Davis,2014,2014,Grand Canyon,WAC,30,895,77,197,32,70,45,127,36,44,27,87,114,50,23,17,40,95,235
11677,Remi Dibo,2014,2014,West Virginia,Big 12,32,621,79,200,28,64,51,136,26,31,24,76,100,21,12,6,20,86,235
11678,Arturo Dubois,2009,2009,Delaware State,MEAC,26,655,101,213,101,213,0,0,33,58,60,105,165,35,7,45,70,92,235
11679,Brett Ervin,2010,2012,Elon,Southern,79,745,83,188,41,71,42,117,27,44,40,102,142,12,7,0,34,85,235
11680,Cory Farmer,2008,2008,East Carolina,CUSA,30,746,78,217,39,124,39,93,40,55,13,46,59,48,20,4,42,56,235
11681,Kyle Ingram,2016,2018,Idaho State,Big Sky,43,911,100,194,99,193,1,1,34,55,58,131,189,63,12,44,46,125,235
11682,DeAngelo Isby,2018,2018,Utah State,MWC,28,521,79,187,57,109,22,78,55,69,23,57,80,32,13,2,43,44,235
11683,Jordan Jahr,2011,2013,Evansville,MVC,58,708,80,217,47,109,33,108,42,53,40,95,135,27,12,9,42,103,235
11684,Omari Lawrence,2010,2014,Total,Total,98,938,87,225,76,174,11,51,50,88,37,109,146,59,54,15,60,112,235
11685,Dederick Lee,2015,2018,Total,Total,84,1265,71,219,11,39,60,180,33,57,20,105,125,165,45,10,94,123,235
11686,Tavin Lovan,2019,2019,Alabama-Birmingham,CUSA,33,682,92,173,88,161,4,12,47,74,54,76,130,26,27,7,40,54,235
11687,Nehemiah Mack,2018,2019,Manhattan,MAAC,62,1246,73,180,36,79,37,101,52,64,20,59,79,123,56,1,70,137,235
11688,Prince Moss,2019,2019,Grambling,SWAC,34,573,80,159,48,90,32,69,43,59,13,85,98,23,21,4,46,76,235
11689,Jayden Saddler,2019,2019,Southern,SWAC,28,810,88,178,81,157,7,21,52,72,21,58,79,100,45,3,78,80,235
11690,Gerron Scissum,2016,2019,Total,Total,51,778,94,223,88,195,6,28,41,64,63,105,168,35,17,17,66,89,235
11691,Lonnie Smith,2011,2012,Louisiana Tech,WAC,47,854,76,210,29,82,47,128,36,56,23,83,106,30,16,9,40,78,235
11692,Dinjiyl Walker,2015,2016,Oklahoma,Big 12,71,797,84,238,43,108,41,130,26,47,21,64,85,47,29,4,54,98,235
11693,Kawanise Wilkins,2019,2019,Western Michigan,MAC,32,742,83,199,70,140,13,59,56,76,44,106,150,49,16,4,57,92,235
11694,Matt Wilson,2010,2013,North Carolina-Wilmington,CAA,88,1143,90,180,89,179,1,1,54,99,74,114,188,30,10,33,76,163,235
11695,Trevin Woods,2015,2016,Long Island University,NEC,59,930,82,239,37,83,45,156,26,34,67,128,195,20,28,30,35,114,235
11696,Dave Bell,2019,2019,Jacksonville,A-Sun,32,568,98,179,98,178,0,1,38,64,64,114,178,11,14,40,52,69,234
11697,Deng Deng,2013,2015,Total,Total,55,687,81,201,48,90,33,111,39,65,35,85,120,12,17,20,46,54,234
11698,Paul Eckerle,2008,2011,Saint Louis,A-10,88,1175,78,207,31,73,47,134,31,48,11,38,49,57,17,7,63,114,234
11699,Michael Harrington,2008,2009,Detroit Mercy,Horizon,60,1135,77,159,77,159,0,0,80,119,96,135,231,27,23,27,66,144,234
11700,Mo Hughley,2012,2014,Total,Total,71,879,80,165,80,163,0,2,74,119,70,107,177,57,42,29,62,137,234
11701,Omari Isreal,2008,2008,Loyola (MD),MAAC,32,883,88,175,88,173,0,2,58,83,68,125,193,36,19,54,68,119,234
11702,Alex Ogundadegbe,2011,2014,Binghamton,AEC,109,1244,91,216,91,214,0,2,52,85,75,118,193,31,36,18,60,180,234
11703,Robert Pressey,2008,2008,Coppin State,MEAC,37,882,83,188,83,188,0,0,68,113,73,135,208,14,16,23,57,116,234
11704,Everage Richardson,2008,2008,Coastal Carolina,Big South,17,425,98,189,73,121,25,68,13,22,16,53,69,39,34,2,28,31,234
11705,Ty'Quan Bitting,2014,2017,Total,Total,68,583,98,148,98,148,0,0,37,78,51,77,128,14,12,35,39,86,233
11706,Peyton Broughton,2018,2019,Eastern Kentucky,OVC,57,901,81,220,44,110,37,110,34,43,40,45,85,40,30,5,25,68,233
11707,Isaac Chatman,2019,2019,Campbell,Big South,32,876,86,168,61,102,25,66,36,62,30,106,136,28,19,15,27,91,233
11708,Kendric Davis,2019,2019,Texas Christian,Big 12,37,634,79,193,64,146,15,47,60,85,12,50,62,75,33,1,59,58,233
11709,Ryan Hare,2009,2009,Southern Illinois,MVC,31,748,71,174,49,116,22,58,69,86,22,73,95,32,18,0,61,84,233
11710,Jamal Johnson,2018,2018,Memphis,AAC,34,901,70,200,23,59,47,141,46,66,25,86,111,35,22,16,32,65,233
11711,Maxwell Kupchak,2016,2019,UC-Santa Barbara,Big West,97,1144,84,227,77,189,7,38,58,83,43,168,211,50,16,20,59,117,233
11712,Asad Lamot,2015,2016,North Carolina-Greensboro,Southern,64,1105,78,187,25,52,53,135,24,33,16,76,92,40,27,5,36,129,233
11713,Jordan Lemons,2008,2009,Grambling,SWAC,55,894,95,242,77,186,18,56,25,47,17,78,95,56,26,10,72,97,233
11714,Kaelen Malone,2017,2019,Total,Total,55,798,92,257,70,176,22,81,27,36,6,62,68,134,22,0,62,60,233
11715,Gabe McGlothan,2019,2019,Southeast Missouri State,OVC,31,670,93,204,72,144,21,60,26,43,58,134,192,29,20,20,41,98,233
11716,Jonathan Milligan,2016,2018,Pittsburgh,ACC,63,828,74,195,45,92,29,103,56,73,6,38,44,65,11,2,55,57,233
11717,Justin Pride,2016,2017,Cal State Bakersfield,WAC,68,1189,66,181,65,176,1,5,100,169,42,109,151,174,65,4,89,156,233
11718,Filip Rebraca,2019,2019,North Dakota,Summit,29,627,96,180,86,152,10,28,31,52,49,123,172,18,15,26,43,75,233
11719,Kendall Russell,2009,2010,Western Carolina,Southern,56,882,81,160,80,156,1,4,70,94,103,121,224,33,35,14,55,116,233
11720,Everett Spencer,2008,2008,South Carolina State,MEAC,31,771,93,231,69,146,24,85,23,39,44,92,136,65,22,12,93,66,233
11721,Marlon Taylor,2019,2019,Louisiana State,SEC,35,818,81,175,66,116,15,59,56,83,46,80,126,19,23,7,39,68,233
11722,Michael Taylor,2009,2010,Montana,Big Sky,58,950,76,176,24,45,52,131,29,34,7,63,70,54,22,3,40,69,233
11723,Lamont Austin,2011,2012,Morehead State,OVC,64,1457,68,202,46,118,22,84,74,90,24,71,95,161,76,2,103,135,232
11724,Javon Baumann,2014,2017,Saint Joseph's,A-10,99,1191,97,155,97,155,0,0,38,105,116,156,272,24,24,66,55,163,232
11725,Josh Crawford,2009,2010,Indiana State,MVC,61,796,90,203,79,168,11,35,41,54,51,109,160,18,20,61,60,142,232
11726,Davante Drinkard,2011,2014,Southern Illinois,MVC,108,1425,92,224,92,224,0,0,48,100,85,110,195,26,14,46,85,192,232
11727,Dallas Elmore,2009,2011,Boston College,ACC,77,1075,78,187,65,135,13,52,63,82,32,74,106,45,31,16,66,88,232
11728,Maxwell Evans,2018,2019,Vanderbilt,SEC,60,796,72,192,38,86,34,106,54,74,27,71,98,50,18,2,55,58,232
11729,Evan Faulkner,2010,2011,Radford,Big South,58,1118,65,238,20,61,45,177,57,78,10,86,96,88,40,4,84,74,232
11730,Jack Flournoy,2013,2014,Northern Kentucky,A-Sun,56,658,81,206,33,64,48,142,22,30,15,48,63,21,10,8,27,62,232
11731,Both Gach,2019,2019,Utah,Pac-12,30,602,77,163,47,68,30,95,48,56,16,46,62,63,16,4,52,40,232
11732,Arnold Gore,2008,2008,Western Carolina,Southern,31,739,92,238,79,201,13,37,35,61,36,54,90,42,26,7,64,90,232
11733,Everette Hammond,2019,2019,South Carolina Upstate,Big South,32,603,81,218,48,134,33,84,37,49,12,62,74,57,22,2,37,53,232
11734,Patrick Jackson,2009,2013,Total,Total,94,1074,85,236,76,178,9,58,53,95,70,112,182,28,27,8,64,122,232
11735,Ronald Jackson,2019,2019,North Carolina A&T,MEAC,31,642,79,145,71,122,8,23,66,89,58,86,144,20,22,13,36,63,232
11736,Jon Jaques,2008,2010,Cornell,Ivy,57,609,80,172,34,66,46,106,26,32,32,68,100,27,36,4,32,87,232
11737,Tyler Jones,2008,2009,Eastern Michigan,MAC,51,1148,61,186,38,103,23,83,87,122,48,61,109,65,30,0,61,81,232
11738,Eugene Lawrence,2008,2008,St. John's (NY),Big East,30,836,67,195,42,98,25,97,73,104,18,66,84,110,51,4,68,73,232
11739,Jamal Lewis,2013,2016,Pennsylvania,Ivy,79,1288,81,233,58,148,23,85,47,79,15,93,108,133,60,4,102,118,232
11740,Kobe Magee,2018,2019,Texas-El Paso,CUSA,58,1185,84,209,33,73,51,136,13,24,17,85,102,104,20,0,67,50,232
11741,Antwan Maxwell,2017,2019,Total,Total,57,741,91,246,65,145,26,101,24,41,34,103,137,29,17,27,54,87,232
11742,Blaise Mbargorba,2015,2017,Boston University,Patriot,70,832,98,176,98,176,0,0,36,55,48,98,146,14,6,40,48,113,232
11743,Andre Statam,2016,2017,Jacksonville State,OVC,65,724,81,209,36,80,45,129,25,33,34,91,125,21,11,3,32,123,232
11744,Keaton Van Soelen,2018,2019,Air Force,MWC,60,1190,87,204,71,131,16,73,42,62,59,117,176,60,29,22,45,80,232
11745,Alan Vest,2016,2019,Wright State,Horizon,90,1231,84,190,48,100,36,90,28,40,40,141,181,54,34,3,45,72,232
11746,Steven Adams,2013,2013,Pittsburgh,Big East,32,749,100,175,100,175,0,0,31,70,90,113,203,20,21,65,35,52,231
11747,Cordero Barkley,2008,2010,Green Bay,Horizon,63,1094,76,198,59,133,17,65,62,89,57,123,180,63,33,27,58,137,231
11748,Challe Barton,2012,2014,Oregon State,Pac-12,93,1336,77,205,48,108,29,97,48,62,12,70,82,105,38,4,98,147,231
11749,Jamie Batish,2015,2016,Western Illinois,Summit,49,930,79,193,15,34,64,159,9,13,5,60,65,22,11,3,10,59,231
11750,Eric Bowles,2016,2018,Central Connecticut State,NEC,71,1512,80,199,64,152,16,47,55,93,36,93,129,175,62,2,110,153,231
11751,Tanner Clayton,2014,2015,Stephen F. Austin,Southland,67,1002,96,189,89,172,7,17,32,47,97,130,227,36,23,95,32,133,231
11752,Casey Cosgrove,2008,2008,Quinnipiac,NEC,29,742,71,190,15,42,56,148,33,46,9,55,64,86,18,1,63,50,231
11753,Justin Davis,2018,2018,Cal State Bakersfield,WAC,30,652,80,176,56,108,24,68,47,55,51,114,165,25,26,2,34,73,231
11754,Guy Edi,2012,2013,Gonzaga,WCC,56,764,76,179,59,120,17,59,62,105,34,91,125,32,23,4,42,65,231
11755,Brandon Ford,2012,2015,Howard,MEAC,74,946,77,209,68,160,9,49,68,95,14,59,73,44,37,1,58,57,231
11756,Kenneth Hall,2012,2015,Western Carolina,Southern,122,1506,94,178,94,178,0,0,43,76,119,175,294,64,26,124,72,273,231
11757,Jean Harris,2009,2012,Brown,Ivy,44,617,81,197,32,69,49,128,20,24,9,44,53,28,22,2,49,35,231
11758,Melik Martin,2018,2019,Monmouth,MAAC,63,1047,86,188,65,129,21,59,38,61,39,115,154,46,25,22,65,123,231
11759,Darrian McKinstry,2009,2009,New Orleans,Sun Belt,23,584,84,197,58,123,26,74,37,52,9,36,45,61,40,3,62,49,231
11760,Kalem Porterie,2008,2009,Northwestern State,Southland,56,682,89,174,89,174,0,0,53,79,65,109,174,25,15,3,60,76,231
11761,Javon Ralling,2010,2013,Binghamton,AEC,71,1028,85,209,85,208,0,1,61,103,69,100,169,29,10,1,68,97,231
11762,Ty Rogers,2008,2008,Western Kentucky,Sun Belt,36,780,86,191,40,66,46,125,13,20,19,62,81,39,27,1,26,74,231
11763,Matt Salley,2008,2008,Bradley,MVC,38,912,91,179,90,177,1,2,48,71,94,170,264,50,32,35,61,118,231
11764,Jarad Scott,2014,2016,Winthrop,Big South,76,762,84,175,55,96,29,79,34,56,48,123,171,21,15,16,46,121,231
11765,Tafari Toney,2008,2008,Houston,CUSA,34,728,93,188,86,161,7,27,38,60,89,125,214,18,25,27,42,106,231
11766,Cameron Bacote,2018,2018,Maryland-Eastern Shore,MEAC,32,849,85,235,40,84,45,151,15,19,10,48,58,62,15,0,43,30,230
11767,Ivan Bender,2016,2019,Maryland,Big Ten,80,779,92,147,91,143,1,4,45,74,54,128,182,58,7,15,69,117,230
11768,Sheldon Blackwell,2014,2016,Cal State Fullerton,Big West,70,1366,85,213,77,176,8,37,52,97,39,143,182,110,38,7,67,104,230
11769,Quintin Dailey,2010,2012,Eastern Michigan,MAC,86,1049,81,220,44,108,37,112,31,43,35,96,131,59,39,8,60,81,230
11770,Chase Freeman,2018,2019,Wagner,NEC,55,1071,63,168,30,70,33,98,71,84,14,63,77,100,32,1,61,77,230
11771,Eric Gaines,2011,2012,Kent State,MAC,63,1047,82,194,69,148,13,46,53,98,44,89,133,34,52,11,46,106,230
11772,Jeff Garrett,2017,2018,Northern Kentucky,Horizon,61,725,96,193,92,166,4,27,34,68,78,149,227,21,29,24,47,73,230
11773,Kikko Haydar,2011,2014,Arkansas,SEC,94,952,71,192,13,39,58,153,30,42,33,74,107,64,47,0,32,143,230
11774,Dan Monckton,2008,2012,Total,Total,66,855,88,202,72,138,16,64,38,56,40,112,152,53,35,18,62,90,230
11775,De'Vondre Perry,2018,2019,Temple,AAC,64,1009,78,207,44,87,34,120,40,56,36,124,160,47,42,24,48,146,230
11776,Selvedin Planincic,2017,2018,Canisius,MAAC,59,714,86,152,74,100,12,52,46,69,37,105,142,31,13,52,58,132,230
11777,Thomas Reuter,2013,2014,Eastern Washington,Big Sky,59,1010,81,228,62,149,19,79,49,89,49,111,160,69,24,17,75,114,230
11778,Josh Simmons,2008,2009,Colorado State,MWC,46,875,72,204,61,158,11,46,75,117,42,91,133,65,20,15,86,111,230
11779,Byron Walker,2009,2010,Alabama State,SWAC,39,691,96,208,95,206,1,2,37,56,42,95,137,17,17,34,48,82,230
11780,Jordan Whitfield,2018,2019,Campbell,Big South,58,1134,84,195,47,87,37,108,25,31,23,84,107,102,30,2,53,86,230
11781,Jonathan Wiley,2015,2018,Total,Total,62,781,87,186,87,181,0,5,56,81,53,124,177,31,19,14,49,108,230
11782,Terrance Akins,2008,2008,Little Rock,Sun Belt,31,658,78,221,30,84,48,137,25,34,5,60,65,59,20,1,42,50,229
11783,Ryan Bernstein,2016,2018,Total,Total,66,1331,87,252,53,130,34,122,21,43,40,112,152,142,46,3,68,91,229
11784,Chris Bethel,2008,2009,Fordham,A-10,30,469,94,205,85,167,9,38,32,49,50,89,139,14,30,17,28,66,229
11785,Nik Biberaj,2015,2016,Old Dominion,CUSA,64,942,87,227,71,166,16,61,39,55,66,102,168,49,14,30,22,112,229
11786,Jeff Budinich,2011,2013,Montana State,Big Sky,77,607,84,235,37,86,47,149,14,19,31,85,116,11,7,24,24,85,229
11787,Clay Byrd,2014,2016,North Carolina-Greensboro,Southern,45,835,72,205,4,12,68,193,17,19,2,39,41,28,11,4,25,59,229
11788,Travis Carroll,2011,2014,Purdue,Big Ten,125,1341,100,189,96,179,4,10,25,45,121,125,246,40,31,42,36,165,229
11789,Chevez Goodwin,2017,2019,Total,Total,70,808,103,184,103,183,0,1,23,65,104,147,251,12,16,30,39,130,229
11790,Tre' Ivory,2015,2018,Austin Peay,OVC,114,1607,76,269,60,200,16,69,61,119,26,95,121,203,61,1,97,157,229
11791,Greg McClinton,2015,2018,Total,Total,87,949,92,188,91,182,1,6,44,77,87,104,191,34,23,14,58,120,229
11792,Louie McCroskey,2008,2008,Marist,MAAC,19,479,88,196,63,135,25,61,28,47,38,61,99,23,13,5,41,46,229
11793,Adam McDermott,2016,2018,Total,Total,40,803,71,175,10,26,61,149,26,30,14,67,81,21,23,0,17,52,229
11794,Quentin Millora-Brown,2019,2019,Rice,CUSA,32,746,101,169,101,169,0,0,27,60,69,119,188,39,9,36,35,75,229
11795,Daniel Peace,2016,2017,Troy,Sun Belt,68,1304,74,191,73,180,1,11,80,156,17,86,103,178,84,1,125,178,229
11796,Will Richardson,2019,2019,Oregon,Pac-12,38,922,80,171,65,117,15,54,54,80,24,66,90,95,43,7,64,69,229
11797,Darnell Tillman,2016,2017,Missouri-Kansas City,WAC,66,1011,94,154,94,154,0,0,41,78,138,156,294,16,31,36,44,148,229
11798,Kyle Young,2018,2019,Ohio State,Big Ten,56,853,97,159,95,143,2,16,33,59,67,109,176,32,24,19,32,84,229
11799,Chris Blake,2011,2011,Detroit Mercy,Horizon,21,506,84,183,60,119,24,64,36,54,11,50,61,32,20,5,55,63,228
11800,Alec Brennan,2015,2018,Princeton,Ivy,103,832,86,173,58,108,28,65,28,51,51,92,143,39,23,35,43,147,228
11801,Kevin Bright,2013,2013,Vanderbilt,SEC,33,966,77,188,23,55,54,133,20,34,33,147,180,39,20,13,50,60,228
11802,Will Brown,2009,2012,Total,Total,73,1038,96,210,96,206,0,4,36,79,81,147,228,14,30,48,53,174,228
11803,Jordan Demercy,2008,2010,Florida State,ACC,87,1285,84,204,67,137,17,67,43,69,53,127,180,90,60,23,106,122,228
11804,Tyree Eady,2019,2019,North Dakota State,Summit,35,703,86,176,50,89,36,87,20,22,21,61,82,29,16,2,24,29,228
11805,John Gardiner,2008,2008,Sam Houston State,Southland,31,653,99,191,99,191,0,0,30,52,55,95,150,20,18,41,36,95,228
11806,Darrian Gray,2014,2015,Southeast Missouri State,OVC,35,701,87,203,55,99,32,104,22,36,28,72,100,40,14,8,32,50,228
11807,Robert Jones III,2017,2017,Idaho State,Big Sky,30,706,82,175,50,93,32,82,32,48,23,79,102,35,21,15,51,87,228
11808,Garland Judkins,2009,2011,Total,Total,52,864,83,198,72,150,11,48,51,73,17,56,73,68,26,5,110,80,228
11809,Nate Laszewski,2019,2019,Notre Dame,ACC,33,626,74,189,30,59,44,130,36,50,45,83,128,7,7,12,18,55,228
11810,Logan Lowery,2011,2014,Total,Total,55,673,86,199,64,141,22,58,34,47,25,56,81,27,17,9,53,61,228
11811,Marcus McClary,2018,2019,Monmouth,MAAC,66,1060,87,179,77,161,10,18,44,76,49,81,130,45,28,2,53,118,228
11812,Erik Nakken,2015,2018,Idaho State,Big Sky,106,1093,74,206,4,10,70,196,10,17,6,66,72,22,11,4,36,78,228
11813,Fallou Ndoye,2015,2019,Total,Total,98,1157,92,206,92,205,0,1,44,97,86,146,232,15,9,27,108,229,228
11814,Aleksa Nikolic,2015,2017,Marshall,CUSA,59,1202,93,292,76,214,17,78,25,37,35,165,200,141,49,9,117,95,228
11815,Jamar Ragland,2010,2011,Alcorn State,SWAC,37,696,85,218,70,165,15,53,43,76,25,79,104,27,19,6,63,69,228
11816,Denzel Richardson,2015,2015,Eastern Kentucky,OVC,33,646,76,182,42,88,34,94,42,56,22,82,104,21,20,1,41,40,228
11817,Andreas Schreiber,2008,2011,Pennsylvania,Ivy,51,621,89,201,84,173,5,28,45,81,48,96,144,23,15,34,83,115,228
11818,Tariq Simmons,2018,2018,Citadel,Southern,32,487,87,230,60,138,27,92,27,50,14,53,67,60,25,2,49,27,228
11819,Austin Smith,2009,2011,Total,Total,60,636,91,150,90,149,1,1,45,73,61,64,125,24,22,22,50,156,228
11820,A.J. Wilson,2018,2019,George Mason,A-10,61,685,84,170,80,154,4,16,56,99,73,95,168,6,24,70,37,106,228
11821,Callum Barker,2016,2018,Bradley,MVC,73,1032,82,176,79,152,3,24,60,96,67,132,199,15,22,22,75,151,227
11822,Cameron Dobbs,2013,2014,Mississippi Valley State,SWAC,52,549,82,248,37,80,45,168,18,29,11,26,37,28,16,2,28,50,227
11823,Levi Dyer,2008,2008,Illinois State,MVC,35,683,74,193,21,66,53,127,26,37,17,68,85,39,17,12,27,70,227
11824,Andy Genao,2009,2009,Eastern Washington,Big Sky,30,733,94,199,85,174,9,25,30,41,55,115,170,43,19,7,52,55,227
11825,Scott Grable,2008,2011,Elon,Southern,77,1044,77,153,77,151,0,2,73,116,96,125,221,51,27,16,75,182,227
11826,Joell Hopkins,2014,2015,Total,Total,46,625,84,160,84,155,0,5,59,107,43,61,104,9,19,15,37,68,227
11827,Stan Januska,2010,2010,North Florida,A-Sun,29,668,73,195,25,53,48,142,33,48,11,64,75,42,22,5,38,58,227
11828,Jax Levitch,2017,2018,Purdue-Fort Wayne,Summit,58,1119,71,159,11,26,60,133,25,40,35,136,171,45,39,12,29,75,227
11829,Taggart Lockhart,2012,2013,Little Rock,Sun Belt,54,966,77,199,53,113,24,86,49,79,56,81,137,49,24,7,41,108,227
11830,Anthony Monaco,2013,2015,Northern Kentucky,A-Sun,72,1221,68,202,35,86,33,116,58,67,29,141,170,69,29,8,75,144,227
11831,Jalen Morgan,2016,2018,Western Illinois,Summit,73,773,91,169,91,166,0,3,45,68,40,100,140,23,9,18,49,113,227
11832,Matthew Moyer,2018,2019,Total,Total,66,1007,80,188,67,130,13,58,54,86,78,134,212,34,20,21,46,100,227
11833,Zach Price,2012,2016,Total,Total,67,806,86,171,86,171,0,0,55,101,71,118,189,5,13,27,46,139,227
11834,Antoine Smith Jr,2019,2019,Incarnate Word,Southland,31,697,82,181,48,88,34,93,29,36,25,77,102,16,10,10,41,81,227
11835,Clifton Spiller,2008,2011,Wagner,NEC,108,1163,85,156,85,156,0,0,57,103,113,172,285,23,33,25,80,193,227
11836,Adam Ward,2016,2017,Nicholls State,Southland,62,877,91,168,91,167,0,1,45,105,73,97,170,24,24,60,48,143,227
11837,Dionte Adams,2013,2016,Hampton,MEAC,89,1027,86,191,86,188,0,3,54,85,110,156,266,29,28,53,48,133,226
11838,Rohan Brown,2013,2016,La Salle,A-10,111,1175,86,178,73,129,13,49,41,70,102,140,242,29,35,18,52,94,226
11839,Chanse Creekmur,2011,2012,Arizona State,Total,57,1055,73,194,14,26,59,168,21,28,26,78,104,27,25,9,33,71,226
11840,Adrian Delph,2019,2019,Appalachian State,Sun Belt,32,614,83,185,44,79,39,106,21,32,24,65,89,25,17,8,33,53,226
11841,Jordan Dickerson,2013,2016,Total,Total,114,1540,84,168,84,166,0,2,58,99,113,177,290,25,23,142,64,264,226
11842,Joe Fulce,2009,2011,Marquette,Big East,74,715,92,187,81,154,11,33,31,35,59,120,179,25,24,19,23,102,226
11843,Brandon Gonzalez,2018,2019,Southeastern Louisiana,Southland,50,777,72,183,22,48,50,135,32,39,44,89,133,29,20,5,38,78,226
11844,John Gooden,2008,2009,St. Francis (NY),NEC,58,831,91,192,91,192,0,0,44,82,59,116,175,22,15,16,54,122,226
11845,Greg Hamlin,2008,2009,East Tennessee State,A-Sun,54,973,92,180,92,179,0,1,42,65,76,129,205,45,47,69,55,145,226
11846,Steven Hess,2008,2010,William & Mary,CAA,82,838,92,150,92,147,0,3,42,64,60,140,200,50,26,22,76,111,226
11847,Michael Laster,2019,2019,Bowling Green State,MAC,33,623,79,205,64,161,15,44,53,76,21,90,111,88,35,3,54,45,226
11848,Justin Leemow,2010,2012,Total,Total,58,1231,90,240,70,165,20,75,26,54,17,68,85,154,84,8,112,140,226
11849,Liam McMorrow,2011,2012,Tennessee Tech,OVC,62,754,81,140,81,140,0,0,64,115,79,112,191,14,17,21,72,148,226
11850,Kevin Noreen,2011,2014,West Virginia,Total,94,1391,74,138,66,111,8,27,70,109,133,165,298,62,35,29,53,229,226
11851,Anthony Walker,2014,2015,Texas-Arlington,Sun Belt,57,784,97,144,97,144,0,0,32,54,54,124,178,10,16,47,37,127,226
11852,Torrence Watson,2019,2019,Missouri,SEC,32,731,73,200,20,53,53,147,27,39,10,39,49,17,6,3,27,52,226
11853,E'Torrion Wilridge,2016,2019,Georgia,SEC,119,1601,75,183,57,102,18,81,58,100,40,148,188,113,32,42,87,86,226
11854,Isaiah Allen,2008,2008,Texas-San Antonio,Southland,30,788,72,195,41,89,31,106,50,68,16,52,68,42,26,2,64,85,225
11855,Daveon Balls,2013,2014,Northern Illinois,MAC,61,1157,73,249,50,154,23,95,56,70,17,98,115,99,41,1,91,109,225
11856,Kilian Cato,2012,2014,Maine,AEC,55,798,79,209,30,67,49,142,18,23,21,85,106,21,22,8,33,94,225
11857,Ty'Lik Evans,2018,2018,Savannah State,MEAC,27,492,75,222,47,98,28,124,47,69,47,40,87,69,36,0,48,57,225
11858,Jailan Haslem,2018,2019,Charlotte,CUSA,56,865,94,169,94,168,0,1,37,72,98,123,221,31,8,24,64,143,225
11859,P.J. Horne,2018,2019,Virginia Tech,ACC,57,707,91,157,88,143,3,14,40,58,63,69,132,12,9,15,44,89,225
11860,Anthony Longpre,2018,2019,Saint Joseph's,A-10,59,1015,74,218,34,111,40,107,37,51,32,157,189,48,18,16,37,84,225
11861,Steve Moore,2009,2012,Missouri,Big 12,121,1386,85,164,82,154,3,10,52,92,81,181,262,55,46,105,58,247,225
11862,Sandy Perry,2009,2010,Georgia Southern,Southern,46,732,95,207,93,195,2,12,33,49,39,43,82,13,17,15,35,89,225
11863,Tyree Robinson,2018,2018,Youngstown State,Horizon,30,385,97,156,97,156,0,0,31,58,38,69,107,13,27,29,37,75,225
11864,Dreshawn Vance,2008,2008,Cal Poly,Big West,30,564,79,139,78,135,1,4,66,110,57,83,140,13,19,34,22,50,225
11865,Alex Vilarino,2019,2019,Boston University,Patriot,33,714,88,176,81,155,7,21,42,61,8,61,69,62,27,8,44,41,225
11866,David Weaver,2008,2010,Wake Forest,ACC,90,1035,88,162,82,149,6,13,43,68,73,125,198,24,19,56,44,148,225
11867,Lawrence Williams,2008,2009,Marist,MAAC,53,684,81,166,81,166,0,0,63,121,72,94,166,9,12,18,62,110,225
11868,Timothy Zephyr,2009,2011,Norfolk State,MEAC,79,1020,98,243,93,215,5,28,24,38,62,99,161,42,21,33,58,168,225
11869,Corey Bailey,2008,2008,Nevada-Las Vegas,MWC,35,839,94,197,85,162,9,35,27,50,51,84,135,37,25,8,36,86,224
11870,Chris Baskerville,2009,2011,Central Connecticut State,NEC,64,768,89,159,89,159,0,0,46,80,77,76,153,21,17,7,48,75,224
11871,Dante Buford,2016,2017,Oklahoma,Big 12,62,726,71,195,42,111,29,84,53,75,35,70,105,25,16,15,41,55,224
11872,Tommy Carpenter,2013,2016,Dartmouth,Ivy,92,978,95,181,93,167,2,14,32,59,49,120,169,86,25,14,78,105,224
11873,Donel Cathcart III,2019,2019,Youngstown State,Horizon,32,521,75,174,47,95,28,79,46,57,15,39,54,17,12,9,35,43,224
11874,Darian Donald,2010,2011,Mississippi Valley State,SWAC,55,815,76,215,47,106,29,109,43,70,39,80,119,24,22,8,51,79,224
11875,Isaiah Felder,2016,2018,Savannah State,MEAC,87,780,73,250,15,47,58,203,20,27,20,51,71,56,38,1,63,63,224
11876,David Foster,2010,2011,Utah,MWC,60,1255,94,185,94,185,0,0,36,70,90,210,300,36,16,214,63,155,224
11877,Loomis Gerring,2015,2016,Missouri State,MVC,57,869,81,235,74,197,7,38,55,80,64,100,164,22,24,11,58,106,224
11878,Todd Golden,2008,2008,Saint Mary's (CA),WCC,32,830,61,130,5,8,56,122,46,56,8,55,63,82,27,4,23,53,224
11879,Corey Hall,2013,2014,Cal State Bakersfield,Total,57,830,80,175,68,139,12,36,52,82,65,144,209,15,25,9,60,120,224
11880,Aaron Henry,2019,2019,Michigan State,Big Ten,38,834,89,184,75,146,14,38,32,48,38,109,147,61,25,19,50,69,224
11881,Dustin Hobaugh,2012,2016,Total,Total,91,1035,70,191,45,104,25,87,59,87,54,125,179,25,25,5,45,109,224
11882,Chibueze Jacobs,2017,2019,Sacramento State,Big Sky,88,850,77,162,58,118,19,44,51,68,58,118,176,16,19,23,38,91,224
11883,Yves Jules,2010,2013,Total,Total,73,761,86,204,63,137,23,67,29,43,12,42,54,31,24,1,60,106,224
11884,Cardell McFarland,2009,2010,Missouri State,MVC,34,726,72,170,54,105,18,65,62,80,18,35,53,43,14,1,66,66,224
11885,Emmanuel Olojakpoke,2017,2019,Akron,MAC,79,812,98,155,98,154,0,1,28,64,68,93,161,7,17,71,37,159,224
11886,Patrell Rogers,2018,2018,South Carolina State,MEAC,20,434,78,189,63,128,15,61,53,78,15,39,54,23,7,4,28,35,224
11887,Jordan Stone,2012,2014,Utah State,Total,93,1017,77,136,77,136,0,0,70,124,109,140,249,20,15,20,55,124,224
11888,Rony Tchatchoua,2008,2009,New Hampshire,AEC,52,857,81,165,75,142,6,23,56,95,57,108,165,21,33,19,42,116,224
11889,Marvell Waithe,2011,2012,Arkansas,SEC,53,738,77,177,58,110,19,67,51,75,57,118,175,30,28,39,37,63,224
11890,Ty Walker,2009,2012,Wake Forest,ACC,70,1066,96,215,96,215,0,0,32,53,72,154,226,28,29,144,47,62,224
11891,Bryce Washington,2019,2019,Pennsylvania,Ivy,30,625,72,175,21,47,51,128,29,35,20,70,90,14,13,6,30,44,224
11892,Adrion Webber,2014,2015,Oral Roberts,Total,66,806,64,187,26,58,38,129,58,66,37,86,123,20,21,2,24,63,224
11893,Aaron Young,2015,2018,Princeton,Ivy,89,763,69,169,11,24,58,145,28,32,8,42,50,44,16,1,22,79,224
11894,Michael Akuchie,2018,2019,Youngstown State,Horizon,59,608,76,199,33,64,43,135,28,35,47,103,150,15,17,17,43,85,223
11895,Jamal Allen,2019,2019,Missouri-Kansas City,WAC,32,596,73,187,33,59,40,128,37,59,15,94,109,12,31,25,23,80,223
11896,Walt Allen,2011,2011,Presbyterian,Big South,31,894,74,156,41,73,33,83,42,60,36,91,127,50,16,9,36,57,223
11897,Lance Brasher,2008,2008,Louisiana-Monroe,Sun Belt,30,873,73,191,29,64,44,127,33,54,50,95,145,40,18,0,32,98,223
11898,Matt Formisano,2008,2011,Utah State,WAC,100,922,93,206,93,204,0,2,37,57,54,111,165,27,12,2,40,91,223
11899,Jarred Godfrey,2019,2019,Purdue-Fort Wayne,Summit,33,519,82,165,62,100,20,65,39,55,10,51,61,36,26,3,25,19,223
11900,Jacob Green,2008,2011,Total,Total,84,1137,81,221,81,221,0,0,61,110,84,130,214,17,30,75,62,218,223
11901,Lincoln Gunn,2008,2008,Princeton,Ivy,26,832,75,190,33,70,42,120,31,39,20,70,90,81,21,1,70,34,223
11902,Matt Hanson,2008,2008,Cal Poly,Big West,30,674,92,192,74,148,18,44,21,54,49,110,159,15,15,9,37,59,223
11903,A.J. Hawkins,2009,2009,Wichita State,MVC,34,838,88,207,80,170,8,37,39,64,39,55,94,45,32,16,39,59,223
11904,Chris Henson,2011,2012,Central Arkansas,Southland,47,672,83,217,59,133,24,84,33,48,43,112,155,23,11,25,31,83,223
11905,Patrick Ingram,2016,2017,Idaho,Big Sky,58,796,78,179,66,148,12,31,55,90,36,92,128,66,31,8,68,98,223
11906,Isaiah Massey,2012,2014,Louisiana Tech,Total,67,759,83,165,82,163,1,2,56,80,61,133,194,16,24,25,30,131,223
11907,DeAnthony McCallum,2019,2019,Jacksonville,A-Sun,32,543,74,170,43,78,31,92,44,59,9,38,47,36,17,11,47,72,223
11908,Malachi Nix,2014,2015,Fairleigh Dickinson,NEC,58,904,54,182,34,115,20,67,95,130,12,57,69,82,47,1,91,93,223
11909,Roman Penn,2018,2018,Siena,MAAC,23,742,67,164,43,93,24,71,65,78,38,74,112,69,29,5,45,68,223
11910,Darren Prentice,2008,2008,New Mexico,MWC,32,645,72,181,28,64,44,117,35,48,13,39,52,75,21,3,38,31,223
11911,Ray Shipman,2009,2010,Florida,SEC,68,871,85,181,79,143,6,38,47,68,46,78,124,32,53,4,41,70,223
11912,Joshea Singleton,2012,2016,Total,Total,62,670,71,184,55,126,16,58,65,100,36,58,94,26,10,13,59,75,223
11913,Theo Smalling,2008,2009,Hampton,MEAC,60,1433,70,180,69,177,1,3,82,156,126,213,339,50,42,45,85,173,223
11914,Jake Stephens,2019,2019,Virginia Military Institute,Southern,32,599,79,181,38,62,41,119,24,31,24,88,112,34,15,19,39,73,223
11915,Maurice White,2014,2015,Siena,MAAC,61,704,73,244,72,227,1,17,76,113,55,75,130,26,29,9,59,85,223
11916,Rashad Woods,2008,2009,Kent State,MAC,47,540,83,195,42,88,41,107,16,24,23,55,78,13,13,4,24,60,223
11917,Femi Akinpetide,2009,2013,Total,Total,91,999,83,211,82,207,1,4,55,97,77,100,177,21,9,14,63,134,222
11918,Michael Anderson,2008,2008,Virginia Commonwealth,CAA,31,736,76,172,60,127,16,45,54,88,47,97,144,22,25,28,55,71,222
11919,Cortney Bell,2011,2012,Prairie View,SWAC,59,869,89,189,88,186,1,3,43,88,92,141,233,27,22,36,58,110,222
11920,Brandon Cassise,2008,2008,Oakland,Summit,23,598,72,195,30,64,42,131,36,43,15,41,56,64,27,1,47,46,222
11921,Jon Evans,2011,2013,Houston Baptist,GWC,65,1193,66,210,26,78,40,132,50,71,31,77,108,113,46,3,98,149,222
11922,Ali Faruq-Bey,2016,2016,Idaho State,Big Sky,17,402,73,183,41,85,32,98,44,61,9,30,39,15,20,2,41,26,222
11923,Anthony Fields,2012,2016,Total,Total,100,1229,83,209,68,153,15,56,41,62,10,54,64,127,31,0,90,101,222
11924,Tiandre Jackson-Young,2019,2019,Texas-Arlington,Sun Belt,33,760,81,191,36,78,45,113,15,21,34,77,111,22,14,5,16,54,222
11925,Bobby King,2014,2015,Total,Total,64,847,94,169,94,169,0,0,34,68,104,122,226,23,26,48,59,138,222
11926,Daniel King,2011,2012,Texas Southern,SWAC,64,1267,81,158,81,157,0,1,60,100,92,188,280,51,43,30,71,181,222
11927,Tommy Kuhse,2018,2019,Saint Mary's (CA),WCC,58,963,79,187,60,132,19,55,45,55,6,91,97,106,28,6,56,69,222
11928,Keegan McDowell,2018,2019,Liberty,Total,68,821,76,183,33,67,43,116,27,29,8,58,66,35,10,3,34,63,222
11929,Lawrence Nwevo,2008,2010,Lamar,Southland,51,657,94,200,94,200,0,0,34,79,62,83,145,14,13,6,48,85,222
11930,Steve Profeta,2008,2009,Saint Francis (PA),NEC,55,772,66,185,22,52,44,133,46,58,31,70,101,41,34,7,35,106,222
11931,MJ Randolp,2019,2019,Florida A&M,MEAC,31,755,90,175,86,157,4,18,38,76,32,88,120,52,36,2,85,71,222
11932,Isaac Reid,2008,2009,Loyola (MD),MAAC,49,898,75,219,59,161,16,58,56,76,88,134,222,23,22,22,54,100,222
11933,Reggie Reid,2016,2017,Florida Gulf Coast,A-Sun,67,1029,79,217,50,111,29,106,35,58,7,74,81,171,44,4,73,97,222
11934,Dominick Scelfo,2012,2014,Cornell,Ivy,62,818,72,224,22,52,50,172,28,51,9,44,53,54,21,0,36,49,222
11935,Donnie Stith,2008,2008,Tulane,CUSA,32,733,76,176,71,145,5,31,65,95,50,105,155,41,27,39,57,69,222
11936,Johnathan Walker,2017,2018,Delaware State,MEAC,33,726,80,187,63,128,17,59,45,66,23,34,57,58,31,3,53,63,222
11937,Michael Wang,2019,2019,Pennsylvania,Ivy,26,471,81,178,55,94,26,84,34,48,21,73,94,27,12,6,31,29,222
11938,Johathan Brooks,2011,2011,Charleston Southern,Big South,31,718,95,208,94,207,1,1,30,38,67,140,207,35,39,32,44,78,221
11939,Matthew Brunell,2008,2010,Eastern Washington,Big Sky,84,1262,81,210,63,159,18,51,41,69,57,112,169,43,32,39,96,181,221
11940,Jamarius Burton,2019,2019,Wichita State,AAC,37,889,78,200,68,162,10,38,55,77,42,84,126,126,19,3,68,72,221
11941,Isaiah Coleman-Lands,2018,2019,Miami (OH),MAC,40,709,74,183,21,49,53,134,20,30,18,51,69,69,29,3,44,57,221
11942,Carter Collins,2018,2019,Davidson,A-10,59,938,80,178,52,89,28,89,33,49,34,107,141,38,27,4,35,94,221
11943,Ebrima Dibba,2019,2019,Coastal Carolina,Sun Belt,26,800,74,163,61,120,13,43,60,78,9,98,107,123,34,4,67,48,221
11944,Brison Gresham,2017,2019,Total,Total,65,844,98,147,98,147,0,0,25,61,93,124,217,23,15,76,51,161,221
11945,Eric Katenda,2014,2016,Total,Total,48,560,82,157,81,156,1,1,56,82,46,72,118,8,16,23,38,96,221
11946,James Kendrick,2008,2008,Alcorn State,SWAC,29,629,90,176,89,173,1,3,40,56,53,72,125,12,15,11,43,96,221
11947,Londell King,2018,2018,Morehead State,OVC,26,517,83,154,71,115,12,39,43,62,69,104,173,18,15,27,52,77,221
11948,Reggie Oliver,2017,2017,Quinnipiac,MAAC,29,630,72,220,32,96,40,124,37,52,16,67,83,65,17,0,62,72,221
11949,John Pettway,2018,2019,South Alabama,Sun Belt,58,815,87,167,85,160,2,7,45,60,22,59,81,74,43,4,64,89,221
11950,Geddes Robinson,2009,2009,Jacksonville State,OVC,27,486,83,164,83,164,0,0,55,93,53,78,131,20,11,7,42,53,221
11951,Andrew Stire,2011,2013,Army,Patriot,73,890,89,154,89,154,0,0,43,74,58,85,143,33,21,16,55,117,221
11952,Justin Williams,2008,2008,Sacramento State,Big Sky,27,664,100,200,100,199,0,1,21,33,40,83,123,45,50,31,47,78,221
11953,Shaq Carr,2017,2018,Grand Canyon,WAC,48,838,76,157,69,141,7,16,61,71,23,74,97,121,27,5,90,65,220
11954,De'Andre Eggins,2008,2008,Little Rock,Sun Belt,30,626,69,168,55,116,14,52,68,98,52,63,115,37,23,5,56,59,220
11955,Oren Faulk,2011,2014,Hartford,AEC,102,945,84,180,84,174,0,6,52,99,54,94,148,58,26,33,82,149,220
11956,Maurice Kirby,2016,2018,Total,Total,85,905,92,194,92,193,0,1,36,73,75,144,219,26,16,20,51,140,220
11957,Tony Lewis,2008,2010,Loyola (MD),MAAC,82,765,84,159,75,131,9,28,43,69,53,75,128,38,28,13,46,88,220
11958,Jose Long,2012,2014,Alabama A&M,SWAC,81,1255,72,212,53,138,19,74,57,113,69,156,225,57,29,11,45,124,220
11959,Keith Maren,2008,2008,Air Force,MWC,30,849,80,168,49,86,31,82,29,52,12,98,110,46,34,18,48,77,220
11960,Cheikh Mbodji,2012,2013,Cincinnati,Big East,62,986,79,180,78,177,1,3,61,97,99,120,219,12,9,109,36,164,220
11961,Justin McCloud,2015,2016,Illinois State,MVC,62,897,74,204,8,18,66,186,6,9,8,78,86,41,19,2,21,58,220
11962,Marcus McIntosh,2008,2008,UC-Irvine,Big West,30,734,78,170,69,132,9,38,55,81,12,45,57,41,30,4,35,54,220
11963,Keaton Miles,2012,2016,Total,Total,109,1280,79,225,72,194,7,31,55,103,84,123,207,90,49,51,62,212,220
11964,Elbryan Neal,2009,2010,McNeese State,Southland,48,778,82,188,81,181,1,7,55,96,73,138,211,36,27,37,93,125,220
11965,Billy Oliver,2010,2012,Penn State,Big Ten,58,986,72,208,26,59,46,149,30,46,53,68,121,21,19,20,46,146,220
11966,Tanner Omlid,2014,2015,Army,Patriot,36,634,85,200,58,102,27,98,23,35,53,115,168,61,74,20,36,90,220
11967,Rob Phinisee,2019,2019,Indiana,Big Ten,32,874,78,216,51,129,27,87,37,55,12,93,105,94,36,4,41,67,220
11968,Antonio Rizzuto,2019,2019,Albany (NY),AEC,24,667,67,188,16,45,51,143,35,54,9,50,59,38,16,4,27,55,220
11969,DeVonte Smith,2014,2015,Little Rock,Sun Belt,53,1355,76,187,57,126,19,61,49,80,23,103,126,135,53,2,50,95,220
11970,Aher Uguak,2017,2019,Total,Total,53,994,75,155,70,127,5,28,65,98,42,90,132,41,36,8,60,84,220
11971,Richard Amardi,2014,2014,Oregon,Pac-12,34,546,89,171,88,168,1,3,40,72,42,92,134,13,25,17,39,116,219
11972,Manny Camper,2018,2019,Siena,MAAC,45,867,78,158,73,126,5,32,58,108,59,117,176,39,28,10,48,87,219
11973,Mark Carbone,2017,2019,Total,Total,55,823,71,206,21,58,50,148,27,31,11,78,89,49,14,3,52,108,219
11974,Josh Dotzler,2008,2009,Creighton,MVC,68,1441,74,219,63,173,11,46,60,86,10,103,113,239,122,10,93,158,219
11975,Jamarcus Ellis,2008,2008,Indiana,Big Ten,32,978,78,191,63,134,15,57,48,65,55,170,225,108,47,20,76,90,219
11976,Cody Graham,2018,2019,Incarnate Word,Southland,51,1158,86,201,69,132,17,69,30,43,26,62,88,107,32,3,71,62,219
11977,Moussa Gueye,2012,2014,Total,Total,82,1209,79,162,79,162,0,0,61,91,119,212,331,17,24,134,136,232,219
11978,Richard Harward,2018,2019,Utah Valley,WAC,43,464,80,132,80,132,0,0,59,95,59,110,169,15,4,23,16,57,219
11979,Tony Kynard,2014,2015,Bethune-Cookman,MEAC,43,845,76,244,72,201,4,43,63,77,33,57,90,129,55,3,84,89,219
11980,Shane Laurie,2008,2009,Missouri State,MVC,41,981,77,212,29,78,48,134,17,27,22,86,108,74,28,6,49,85,219
11981,Rakim Lubin,2015,2017,Total,Total,47,574,83,156,83,155,0,1,53,92,50,97,147,11,4,12,61,123,219
11982,Brailen Neely,2017,2019,Oakland,Horizon,61,1142,65,175,44,101,21,74,68,87,12,96,108,253,60,3,91,85,219
11983,Travis Nelson,2008,2008,Wyoming,MWC,30,479,87,142,87,142,0,0,45,57,23,56,79,9,5,29,37,74,219
11984,Billy Parrish,2008,2009,Eastern Illinois,OVC,57,1048,90,192,85,177,5,15,34,53,72,118,190,55,22,7,46,130,219
11985,Abel Porter,2017,2019,Utah State,MWC,61,941,65,159,32,70,33,89,56,83,5,90,95,113,29,3,58,95,219
11986,Drew Rackley,2017,2018,North Carolina-Asheville,Big South,55,698,72,166,27,63,45,103,30,43,7,44,51,43,30,2,38,67,219
11987,Amir Rashid,2010,2011,Central Michigan,MAC,43,1073,75,251,64,200,11,51,58,94,15,78,93,104,63,1,87,85,219
11988,Andres Sandoval,2008,2008,Dayton,A-10,34,743,74,178,48,92,26,86,45,77,26,72,98,43,33,4,32,82,219
11989,Joseph Taylor,2008,2008,Wyoming,MWC,30,664,86,147,77,115,9,32,38,64,52,152,204,39,31,38,76,84,219
11990,Mikel Tyson,2016,2017,Alabama State,SWAC,55,677,88,150,88,148,0,2,43,82,75,98,173,14,11,28,45,108,219
11991,Dallas Watson,2019,2019,Saint Peter's,MAAC,31,934,71,205,35,98,36,107,41,62,7,63,70,89,13,2,100,48,219
11992,Bryce Webster,2010,2010,Cal State Fullerton,Big West,31,727,85,144,85,144,0,0,49,64,59,92,151,8,9,21,33,77,219
11993,Sharone Wright Jr,2019,2019,Wake Forest,ACC,31,689,84,205,64,142,20,63,31,56,16,57,73,30,11,1,39,59,219
11994,Cecil Bent,2009,2011,Florida A&M,MEAC,74,412,90,197,90,197,0,0,38,84,41,80,121,13,9,13,66,168,218
11995,Antonio Bivins,2014,2014,Massachusetts-Lowell,AEC,16,440,72,142,72,140,0,2,74,97,38,56,94,7,20,5,27,47,218
11996,Derrick Dandridge,2017,2017,Florida A&M,MEAC,30,626,79,187,76,173,3,14,57,95,41,96,137,20,12,6,41,78,218
11997,Marquel De Lancey,2011,2012,Old Dominion,CAA,70,1275,79,220,65,174,14,46,46,74,26,105,131,125,45,2,90,93,218
11998,Brenden Evans,2014,2015,Utah Valley,WAC,59,855,77,177,75,167,2,10,62,96,69,110,179,30,21,10,52,126,218
11999,C.J. Foster,2015,2018,Arkansas State,Sun Belt,62,1041,72,178,53,107,19,71,55,93,46,60,106,47,15,7,63,115,218
12000,Anthony Glover,2015,2015,Chicago State,WAC,32,679,74,204,35,88,39,116,31,47,14,30,44,38,26,2,43,40,218
12001,Daniel Gomis,2014,2016,Oregon State,Pac-12,73,1064,81,158,81,158,0,0,56,102,86,118,204,25,21,73,74,190,218
12002,Charles Hill,2013,2015,Texas Christian,Big 12,52,798,78,239,51,145,27,94,35,57,24,73,97,43,20,11,50,75,218
12003,Ralph Hill,2011,2015,Total,Total,90,690,75,168,35,56,40,112,28,40,31,85,116,31,19,14,23,78,218
12004,Will Johnston,2012,2015,Virginia Tech,ACC,87,1206,68,192,6,20,62,172,20,33,15,84,99,36,20,2,21,81,218
12005,Kyle Kager,2012,2014,American,Patriot,62,755,79,172,63,119,16,53,44,60,34,116,150,39,17,9,56,57,218
12006,Seth Miliner,2019,2019,Cleveland State,Horizon,31,741,78,194,53,112,25,82,37,53,40,105,145,32,19,2,29,60,218
12007,Darin Nagle,2008,2008,Idaho,WAC,27,662,81,176,57,95,24,81,32,60,23,86,109,32,15,39,32,66,218
12008,Nafis Richardson,2011,2011,Sam Houston State,Southland,31,660,76,188,55,121,21,67,45,79,18,45,63,55,25,3,57,63,218
12009,Frank Snow,2014,2015,Southern,SWAC,59,745,79,159,79,159,0,0,60,106,72,96,168,11,15,56,49,123,218
12010,Caleb Steffensmeier,2013,2014,Omaha,Summit,63,1072,69,185,24,60,45,125,35,46,11,71,82,102,48,9,41,102,218
12011,Brent Stephens,2008,2008,Missouri-Kansas City,Summit,22,529,65,177,40,112,25,65,63,82,23,51,74,32,12,3,31,68,218
12012,Chad Wilson,2009,2011,Delaware State,MEAC,63,963,75,225,22,60,53,165,15,26,16,52,68,35,29,1,43,60,218
12013,Buddy Boeheim,2019,2019,Syracuse,ACC,32,546,72,190,25,56,47,134,26,33,18,34,52,33,18,3,25,38,217
12014,Matt Causey,2008,2008,Georgia Tech,ACC,30,538,72,171,36,86,36,85,37,49,8,37,45,111,29,1,72,82,217
12015,Ashtin Chastain,2017,2019,San Jose State,MWC,72,1036,81,181,77,162,4,19,51,113,63,123,186,33,10,11,70,119,217
12016,Sydney Coleman,2012,2013,Jackson State,SWAC,60,1284,81,181,81,181,0,0,55,94,79,136,215,19,25,42,50,71,217
12017,Austin Cooley,2009,2010,Niagara,MAAC,64,759,79,237,40,99,39,138,20,39,36,67,103,30,30,25,42,79,217
12018,DeAundre Cranston,2009,2010,Mississippi,SEC,66,1083,82,175,66,120,16,55,37,63,114,159,273,29,34,38,47,189,217
12019,Jalen Crawford,2012,2013,Bradley,MVC,65,879,83,240,44,117,39,123,12,19,20,52,72,44,22,3,46,53,217
12020,Joshua Floyd,2017,2017,Savannah State,MEAC,29,614,73,190,40,89,33,101,38,62,30,50,80,75,20,1,50,30,217
12021,Tracy Hector,2016,2019,Total,Total,46,1086,79,201,76,180,3,21,56,105,49,132,181,107,47,7,88,89,217
12022,Taishi Ito,2008,2010,Portland,WCC,90,1380,63,218,34,96,29,122,62,83,13,69,82,145,51,0,89,108,217
12023,Christian Jacob,2019,2019,Chicago State,WAC,20,510,88,174,87,171,1,3,40,63,48,66,114,12,24,6,45,72,217
12024,Diontae Jones,2017,2018,Grambling,SWAC,47,669,80,194,64,152,16,42,41,51,42,85,127,20,33,9,49,113,217
12025,Wadly Mompremier,2014,2018,Total,Total,88,816,77,160,65,121,12,39,51,100,65,135,200,13,12,66,66,111,217
12026,Zach Nutall,2019,2019,Sam Houston State,Southland,33,559,85,185,53,99,32,86,15,26,33,74,107,31,21,10,25,46,217
12027,Aamahne Santos,2019,2019,Jacksonville,A-Sun,32,915,73,202,30,75,43,127,28,29,10,47,57,78,20,2,49,43,217
12028,Denny Slay,2018,2019,High Point,Big South,57,1051,80,222,59,134,21,88,36,49,14,96,110,98,25,1,59,59,217
12029,De'Angelo Speech,2011,2014,Central Connecticut State,NEC,74,1274,71,204,53,160,18,44,57,88,53,131,184,100,71,4,113,157,217
12030,Chris Sullivan,2016,2019,Brown,Ivy,106,960,70,180,21,41,49,139,28,36,26,82,108,26,32,2,21,109,217
12031,Melvin Tabb,2011,2014,Total,Total,69,769,74,165,73,162,1,3,68,114,75,99,174,17,10,8,52,132,217
12032,Charles Taylor,2014,2018,Total,Total,51,820,80,220,76,190,4,30,53,86,53,89,142,29,29,13,63,112,217
12033,Montrell Thornton,2010,2011,Little Rock,Sun Belt,60,816,85,153,85,153,0,0,47,74,57,119,176,19,23,52,39,133,217
12034,Eric Weary,2013,2016,Total,Total,60,735,77,242,38,73,39,169,24,35,46,91,137,28,18,13,38,65,217
12035,Clark Woods,2008,2008,Sacramento State,Big Sky,28,738,66,184,19,53,47,131,38,49,11,56,67,29,36,8,42,54,217
12036,Abiola Akintola,2016,2019,Denver,Summit,88,1090,87,167,87,167,0,0,42,89,86,136,222,32,20,29,46,155,216
12037,Justin Benton,2017,2018,Southern Illinois-Edwardsville,OVC,53,1133,77,202,47,120,30,82,32,47,21,60,81,111,19,4,70,109,216
12038,Andy Brown,2012,2013,Stanford,Pac-12,42,802,86,176,72,136,14,40,30,58,43,60,103,37,38,9,38,56,216
12039,Josh Chavis,2011,2011,South Carolina Upstate,A-Sun,28,863,69,227,12,40,57,187,21,25,8,41,49,83,27,1,45,55,216
12040,Mark Gomillia,2010,2011,Stephen F. Austin,Southland,59,760,92,182,90,158,2,24,30,53,40,50,90,26,13,4,38,54,216
12041,Brian Greene,2013,2017,Total,Total,100,1122,79,242,50,154,29,88,29,46,17,76,93,101,44,8,71,103,216
12042,Julian Harris,2015,2018,Texas-Arlington,Sun Belt,94,884,77,177,69,153,8,24,54,85,65,94,159,22,13,14,54,119,216
12043,Danny Herrera,2012,2014,Total,Total,32,675,80,178,59,118,21,60,35,50,27,62,89,16,16,2,28,77,216
12044,Demarshay Johnson,2008,2008,Nevada,WAC,33,750,87,162,87,161,0,1,42,71,58,95,153,35,18,32,41,89,216
12045,Michael Lacey,2009,2011,Idaho State,Big Sky,58,916,77,179,71,148,6,31,56,84,54,87,141,32,28,5,53,86,216
12046,Cameron Lewis,2016,2019,Howard,MEAC,85,984,80,160,78,155,2,5,54,80,83,108,191,36,25,22,58,170,216
12047,Devon McMillan,2012,2013,Fordham,A-10,31,790,72,228,64,181,8,47,64,111,23,55,78,83,34,7,83,77,216
12048,Caleb Nero,2019,2019,Weber State,Big Sky,33,643,79,171,61,118,18,53,40,51,8,47,55,47,21,2,36,39,216
12049,J.J. Richardson,2010,2014,Total,Total,88,696,86,167,86,166,0,1,44,76,48,89,137,18,18,10,58,141,216
12050,Nick Sidorakis,2008,2011,Oklahoma State,Big 12,119,1197,78,208,34,70,44,138,16,24,12,97,109,66,45,2,60,89,216
12051,Jerel Stephenson,2009,2009,North Carolina-Wilmington,CAA,28,682,77,166,73,153,4,13,58,89,53,88,141,50,15,6,62,77,216
12052,Israel Barnes,2019,2019,Weber State,Big Sky,33,809,79,202,46,103,33,99,24,48,15,55,70,48,24,7,40,67,215
12053,Ricky Council II,2016,2019,Total,Total,53,579,67,183,16,34,51,149,30,34,13,43,56,17,14,8,22,30,215
12054,Najul Ervin,2008,2010,Northern Illinois,MAC,83,1205,94,187,94,181,0,6,27,85,100,163,263,58,58,45,89,141,215
12055,R.J. Fuqua,2018,2018,Oral Roberts,Summit,27,794,75,214,47,127,28,87,37,48,8,64,72,79,31,3,55,60,215
12056,Vilgot Larsson,2019,2019,Maine,AEC,32,949,82,190,53,102,29,88,22,41,38,84,122,41,19,16,50,92,215
12057,Cole Long,2017,2019,Detroit Mercy,Horizon,79,1022,77,219,53,132,24,87,37,54,62,110,172,56,21,33,46,132,215
12058,Matt Milk,2011,2014,St. Francis (NY),NEC,116,1083,93,176,93,176,0,0,29,47,80,92,172,22,20,43,50,168,215
12059,Dee Montgomery,2019,2019,Purdue-Fort Wayne,Summit,33,571,75,182,36,76,39,106,26,46,9,49,58,33,26,6,30,62,215
12060,Marvin Nesbitt Jr.,2018,2019,Missouri-Kansas City,WAC,51,815,79,192,60,133,19,59,38,59,54,142,196,56,35,17,49,114,215
12061,Justin Newton,2009,2012,St. Francis (NY),NEC,117,2437,70,211,51,116,19,95,56,93,78,234,312,301,136,12,190,272,215
12062,Alex Olesinski,2016,2019,UCLA,Pac-12,73,932,70,150,49,84,21,66,54,77,76,138,214,21,24,20,30,130,215
12063,Xavier Rogers,2012,2012,Grambling,SWAC,25,720,77,230,38,98,39,132,22,38,14,46,60,40,23,0,47,65,215
12064,Rocco Rubino,2008,2009,St. Francis (NY),NEC,57,851,68,178,25,67,43,111,36,56,35,50,85,40,20,0,40,48,215
12065,Kyle Sikora,2012,2015,Total,Total,91,1217,88,154,88,154,0,0,39,84,70,169,239,7,14,55,72,144,215
12066,Jeremy Smith,2019,2019,California Baptist,WAC,31,658,75,178,37,89,38,89,27,32,11,47,58,51,18,2,21,42,215
12067,Samuta Avea,2018,2019,Hawaii,Big West,58,696,82,191,63,129,19,62,31,48,43,115,158,28,10,11,47,56,214
12068,Marvin Bragg,2018,2019,American,Patriot,49,1040,75,169,44,70,31,99,33,53,28,102,130,50,32,20,39,91,214
12069,Ladon Carter,2014,2014,Tennessee Tech,OVC,31,549,92,143,92,143,0,0,30,64,60,80,140,21,38,38,35,36,214
12070,Jack Crowder,2010,2011,Southern Illinois,MVC,54,700,77,178,54,109,23,69,37,55,54,72,126,14,20,8,36,72,214
12071,Leo Davis,2010,2011,Centenary (LA),Summit,49,887,72,208,28,86,44,122,26,42,12,41,53,71,21,0,79,53,214
12072,David Dees,2008,2008,Louisiana,Sun Belt,27,498,57,155,38,92,19,63,81,122,37,55,92,31,14,5,48,36,214
12073,Josh Duell,2008,2009,Siena,MAAC,52,948,63,173,31,79,32,94,56,70,43,92,135,45,26,20,31,110,214
12074,Fred Ellis,2009,2012,Baylor,Big 12,99,967,68,192,49,124,19,68,59,76,58,123,181,52,30,16,70,125,214
12075,Kennedy Esume,2015,2016,Cal State Fullerton,Big West,61,990,85,199,85,199,0,0,44,89,98,163,261,14,23,28,49,128,214
12076,L.J. Frazier,2009,2010,Eastern Michigan,MAC,64,958,64,205,18,71,46,134,40,61,11,73,84,77,32,0,61,74,214
12077,Quinton Goods,2008,2010,Charleston Southern,Big South,78,879,94,189,93,185,1,4,25,45,101,140,241,33,30,33,70,116,214
12078,Raymond Gregory,2010,2013,Jackson State,SWAC,94,900,78,178,78,177,0,1,58,117,66,76,142,9,12,54,77,146,214
12079,Jamon Hill,2008,2008,San Jose State,WAC,32,796,67,188,52,134,15,54,65,92,22,62,84,68,24,0,55,36,214
12080,James Keefe,2008,2010,UCLA,Pac-10,79,1093,84,176,69,132,15,44,31,67,101,136,237,28,24,31,50,140,214
12081,Chris Kupets,2011,2011,Utah,MWC,29,540,76,196,47,113,29,83,33,41,4,43,47,36,15,0,50,52,214
12082,Jacob Lancaster,2014,2014,Abilene Christian,Southland,31,434,88,159,87,158,1,1,37,58,45,99,144,7,7,37,41,49,214
12083,Freddie McSwain,2017,2018,Indiana,Big Ten,62,704,77,159,77,155,0,4,60,102,95,122,217,20,20,21,51,100,214
12084,Stephen O'Suji,2015,2019,Houston Baptist,Southland,63,717,64,180,41,120,23,60,63,92,27,58,85,73,37,2,62,55,214
12085,Michael Onyebalu,2015,2018,UC-Davis,Big West,71,1007,65,148,30,65,35,83,49,63,11,125,136,38,28,2,59,102,214
12086,Elijah Ray,2014,2015,IUPUI,Summit,45,561,77,165,62,117,15,48,45,60,33,83,116,12,9,0,47,57,214
12087,Devon Williams,2014,2016,New Mexico,MWC,38,737,76,166,71,147,5,19,57,82,49,60,109,21,18,20,48,73,214
12088,Jackson Aldridge,2012,2015,Butler,Total,103,912,63,203,39,109,24,94,63,92,9,64,73,63,22,0,78,73,213
12089,Matt Beachler,2018,2019,Central Michigan,MAC,69,706,70,187,22,33,48,154,25,39,11,68,79,30,23,6,23,54,213
12090,Keilan Blanks,2013,2014,Lamar,Southland,39,743,68,193,45,129,23,64,54,69,14,59,73,72,14,3,77,50,213
12091,Eugene Blue,2009,2010,Detroit Mercy,Horizon,55,773,88,153,88,153,0,0,37,72,45,76,121,13,11,9,64,128,213
12092,Lucas Devenny,2010,2014,Total,Big West,111,1348,86,169,86,169,0,0,41,89,122,180,302,48,22,25,51,139,213
12093,Michael Grant,2014,2015,Abilene Christian,Southland,56,858,70,155,70,149,0,6,73,109,39,66,105,36,47,13,64,105,213
12094,LeMon Gregory,2015,2016,Lamar,Southland,56,714,93,156,93,156,0,0,27,56,56,107,163,13,15,22,59,120,213
12095,Keenan Gumbs,2019,2019,Liberty,A-Sun,36,595,79,164,59,108,20,56,35,46,27,51,78,38,25,4,31,47,213
12096,Kevin Hunt,2019,2019,McNeese State,Southland,31,725,76,196,46,111,30,85,31,46,11,52,63,89,18,7,81,61,213
12097,Brandon Key,2018,2018,South Dakota State,Summit,34,632,72,157,59,116,13,41,56,81,11,40,51,112,19,0,55,35,213
12098,Dominique Langston,2011,2011,Quinnipiac,NEC,30,688,71,185,46,103,25,82,46,63,45,87,132,59,15,7,55,78,213
12099,Markell Lodge,2016,2019,Saint Joseph's,A-10,80,953,93,129,93,129,0,0,27,62,78,132,210,7,19,55,19,109,213
12100,L.J. Owens,2019,2019,William & Mary,CAA,31,745,74,156,45,82,29,74,36,50,8,42,50,32,14,5,25,60,213
12101,Justin Satchell,2016,2016,Niagara,MAAC,32,613,87,207,65,130,22,77,17,26,37,88,125,20,17,7,41,53,213
12102,Dominique Shellman,2010,2011,Jacksonville State,OVC,45,1179,73,208,57,152,16,56,51,76,9,75,84,199,33,4,132,97,213
12103,Reilly Walsh,2016,2019,NJIT,A-Sun,61,977,80,174,50,97,30,77,23,36,40,80,120,55,46,5,49,110,213
12104,Eric Waterford,2009,2012,Portland,WCC,79,903,76,202,53,136,23,66,38,63,20,66,86,111,21,3,72,70,213
12105,Juan Cardenas,2019,2019,Bryant,NEC,29,646,64,126,41,66,23,60,61,86,44,96,140,11,24,45,30,81,212
12106,Justin Cheek,2011,2013,High Point,Big South,71,843,68,201,39,105,29,96,47,62,22,58,80,35,26,5,47,79,212
12107,Damian Chong-Qui,2019,2019,Mount St. Mary's,NEC,31,884,73,199,49,110,24,89,42,63,12,76,88,116,26,1,51,75,212
12108,Frederick Coleman,2011,2012,Southern,SWAC,61,1342,90,174,90,170,0,4,32,107,72,180,252,48,34,40,99,180,212
12109,Connor Crabtree,2019,2019,Tulane,AAC,30,626,65,150,36,71,29,79,53,66,13,46,59,34,19,6,36,53,212
12110,John Fulkerson,2017,2019,Tennessee,SEC,76,871,77,144,77,144,0,0,58,87,71,119,190,50,45,43,51,126,212
12111,Mark Gray,2016,2016,Grambling,SWAC,31,830,65,162,46,97,19,65,63,89,32,107,139,16,15,5,52,69,212
12112,Clayton Hughes,2018,2019,Indiana State,MVC,57,944,82,181,57,101,25,80,23,37,16,70,86,51,23,10,67,121,212
12113,Christian Hunter,2008,2008,Virginia Military Institute,Big South,29,717,70,230,8,34,62,196,10,14,13,47,60,66,32,1,32,30,212
12114,Jaelin Llewellyn,2019,2019,Princeton,Ivy,21,693,83,250,59,155,24,95,22,38,12,52,64,55,12,4,37,34,212
12115,Dathan Lyles,2010,2011,Cal State Northridge,Big West,56,942,72,220,46,122,26,98,42,57,9,75,84,131,46,2,85,92,212
12116,Rinaldo Mafra,2012,2013,Jacksonville State,OVC,59,817,78,152,78,152,0,0,56,98,54,99,153,17,14,22,46,135,212
12117,Eric Monroe,2017,2019,Yale,Ivy,77,950,71,166,23,41,48,125,22,24,9,94,103,100,25,5,70,76,212
12118,Zavier Peart,2017,2019,Total,Total,60,790,91,197,89,189,2,8,28,56,58,110,168,18,6,31,44,141,212
12119,Christian Turner,2017,2019,Gardner-Webb,Big South,92,1584,67,159,46,100,21,59,57,80,10,117,127,196,78,2,90,158,212
12120,Matt Veretto,2019,2019,Delaware,CAA,33,656,78,161,42,69,36,92,20,30,31,61,92,12,8,6,16,65,212
12121,Nemanja Zarkovic,2015,2017,Fordham,A-10,69,1145,73,218,27,72,46,146,20,33,25,61,86,84,34,2,53,129,212
12122,Djery Baptiste,2017,2019,Total,Total,84,1074,79,161,79,161,0,0,53,83,94,155,249,11,16,64,69,185,211
12123,James Beck,2018,2019,Oakland,Horizon,51,840,81,195,80,186,1,9,48,80,69,135,204,39,10,15,44,104,211
12124,Alex Bran,2013,2016,Chattanooga,Southern,74,542,76,181,33,63,43,118,16,21,10,40,50,27,21,5,47,47,211
12125,Virshon Cotton,2018,2018,Akron,MAC,29,595,59,163,22,64,37,99,56,74,4,54,58,51,21,0,57,42,211
12126,Jacob Cushing,2017,2019,Delaware,CAA,70,868,73,198,33,69,40,129,25,33,19,106,125,23,7,7,40,82,211
12127,Taj Finger,2008,2008,Stanford,Pac-10,36,658,79,143,77,134,2,9,51,68,83,75,158,18,16,12,25,70,211
12128,Dane Goodwin,2019,2019,Notre Dame,ACC,33,810,70,186,46,116,24,70,47,61,39,68,107,36,14,5,27,38,211
12129,Hunter Houston,2008,2010,Virginia Military Institute,Big South,63,636,81,224,43,88,38,136,11,27,41,57,98,24,24,9,29,66,211
12130,Nick Lake,2008,2010,Princeton,Ivy,66,734,72,169,34,62,38,107,29,38,42,71,113,24,15,3,40,101,211
12131,Renan Lenz,2013,2014,Utah,Pac-12,62,615,83,160,80,147,3,13,42,56,33,83,116,25,17,41,30,87,211
12132,Jeremiah Ostrowski,2011,2012,Hawaii,WAC,45,1246,70,183,52,110,18,73,53,88,18,87,105,251,53,1,110,91,211
12133,Randy Oveneke,2008,2008,Drexel,CAA,32,898,86,188,84,175,2,13,37,62,62,96,158,32,24,7,51,81,211
12134,Michael Rembert,2008,2008,Southeast Missouri State,OVC,29,596,79,153,77,144,2,9,51,100,57,93,150,18,19,19,49,75,211
12135,Samir Stewart,2019,2019,Manhattan,MAAC,32,707,61,163,12,40,49,123,40,47,11,25,36,64,29,1,58,69,211
12136,Scott Ulaneo,2017,2018,Seattle,WAC,64,810,71,160,60,116,11,44,58,110,53,131,184,47,18,13,58,141,211
12137,Kieran Woods,2016,2016,Chicago State,WAC,22,475,75,177,69,149,6,28,55,92,32,60,92,60,39,8,51,58,211
12138,Kenny Brewer,2008,2009,Army,Patriot,42,564,77,159,77,158,0,1,56,78,30,63,93,35,19,5,49,56,210
12139,Richard Brown,2011,2012,Furman,Southern,51,875,68,175,52,119,16,56,58,70,9,54,63,92,22,4,62,47,210
12140,Jordan Giddings,2016,2017,Prairie View,SWAC,60,678,68,178,58,140,10,38,64,87,22,33,55,27,17,2,38,90,210
12141,Dayon Goodman,2015,2016,Utah Valley,WAC,46,617,77,135,77,131,0,4,56,87,54,87,141,20,14,16,34,81,210
12142,Joseph Jack,2008,2008,Southern,SWAC,30,667,65,159,56,128,9,31,71,93,42,110,152,18,18,48,25,83,210
12143,Mamadou Ndaiye,2016,2019,Saint Peter's,MAAC,79,636,77,171,69,149,8,22,48,84,69,92,161,14,10,9,40,98,210
12144,Reggie Rawlins,2008,2008,Sam Houston State,Southland,31,477,79,170,75,150,4,20,48,64,38,54,92,23,4,6,36,51,210
12145,Beloved Rogers,2009,2011,Total,Total,65,812,69,224,22,71,47,153,25,40,24,60,84,47,22,4,51,88,210
12146,Alonzo Sule,2019,2019,Texas State,Sun Belt,33,483,82,134,82,133,0,1,46,67,67,75,142,10,4,10,34,68,210
12147,Jordan Weirick,2010,2011,Southern Utah,Summit,53,737,82,198,54,129,28,69,18,24,22,83,105,46,22,4,47,80,210
12148,David Wishon,2012,2016,Total,Total,80,771,81,166,81,166,0,0,48,93,62,104,166,8,9,41,75,109,210
12149,Brennan Wyatt,2011,2013,Navy,Patriot,85,1031,59,210,33,99,26,111,66,95,13,82,95,118,45,0,89,92,210
12150,Trevor Anderson,2017,2019,Total,Total,28,625,64,155,28,61,36,94,45,56,12,54,66,56,15,1,38,35,209
12151,Carter Cook,2011,2012,South Carolina Upstate,A-Sun,53,634,76,173,59,115,17,58,40,61,38,65,103,56,26,9,45,76,209
12152,Cameron Corcoran,2018,2018,Little Rock,Sun Belt,31,516,64,152,18,44,46,108,35,45,4,16,20,28,9,1,29,18,209
12153,Jared Dimakos,2014,2016,Chicago State,WAC,52,689,77,163,56,95,21,68,34,59,30,72,102,26,20,2,45,103,209
12154,Pat Ewing,2008,2008,Georgetown,Big East,34,738,74,140,61,94,13,46,48,73,49,94,143,62,33,23,54,83,209
12155,Dilon Farr,2012,2012,Utah,Pac-12,31,803,84,179,66,131,18,48,23,41,31,117,148,15,27,16,43,67,209
12156,Raquan Mitchell,2016,2018,Total,Total,31,696,83,203,73,150,10,53,33,45,17,70,87,50,19,6,28,46,209
12157,Nolan Narain,2017,2019,San Diego State,MWC,64,684,88,158,79,129,9,29,24,45,55,69,124,25,14,11,43,112,209
12158,Ben Nwachukwu,2008,2008,Columbia,Ivy,29,533,82,158,82,158,0,0,45,65,45,77,122,13,8,18,46,66,209
12159,Michael Palarca,2009,2010,South Dakota State,Summit,60,1104,71,210,54,148,17,62,50,70,25,61,86,146,44,2,84,89,209
12160,Ray Reed,2008,2008,Cal State Fullerton,Big West,33,640,79,149,79,144,0,5,51,92,17,44,61,87,40,1,56,73,209
12161,Cormac Ryan,2019,2019,Stanford,Pac-12,24,684,66,198,17,43,49,155,28,38,8,75,83,45,24,4,38,60,209
12162,Galin Smith,2018,2019,Alabama,SEC,63,802,90,159,90,159,0,0,29,77,58,75,133,6,5,38,55,108,209
12163,Wynston Tabbs,2019,2019,Boston College,ACC,15,471,72,164,54,108,18,56,47,57,5,54,59,41,17,3,25,29,209
12164,Korey Thieleke,2011,2014,Portland,WCC,82,1015,79,206,71,166,8,40,43,68,48,98,146,49,52,43,58,111,209
12165,Connor Vanover,2019,2019,University of California,Pac-12,28,490,83,177,56,101,27,76,16,24,21,61,82,5,7,35,18,38,209
12166,Charles Waters,2015,2016,Arkansas State,Sun Belt,56,747,82,182,82,179,0,3,45,61,67,132,199,14,31,51,40,143,209
12167,Madison Williams,2017,2018,Illinois State,MVC,59,1054,74,234,35,97,39,137,22,38,9,94,103,61,47,11,59,119,209
12168,Michael Anumba,2019,2019,Winthrop,Big South,30,709,68,143,53,91,15,52,57,81,45,70,115,49,13,4,49,76,208
12169,Channel Banks,2019,2019,Akron,MAC,32,678,75,185,34,65,41,120,17,29,13,65,78,25,31,3,28,65,208
12170,Wayne Burton,2009,2010,Little Rock,Sun Belt,57,744,90,185,90,185,0,0,28,79,56,98,154,12,12,35,57,152,208
12171,Robert Bush,2008,2008,Illinois-Chicago,Horizon,28,675,70,194,34,95,36,99,32,41,23,63,86,30,15,4,31,35,208
12172,Alex Caldwell,2019,2019,Southeast Missouri State,OVC,24,496,71,158,41,81,30,77,36,46,14,31,45,40,22,5,31,51,208
12173,Albert Christensson,2015,2017,Central Arkansas,Southland,85,834,73,176,62,144,11,32,51,103,55,87,142,21,8,5,77,123,208
12174,Gairges Daow,2018,2019,Northern Illinois,MAC,65,1083,77,189,56,114,21,75,33,45,47,143,190,46,26,8,57,90,208
12175,Jackson Davis,2015,2018,Total,Total,58,497,79,167,75,148,4,19,46,66,35,104,139,9,27,14,35,77,208
12176,Brandon Foust,2008,2008,Southeast Missouri State,OVC,18,430,76,158,66,131,10,27,46,59,32,83,115,26,17,9,29,29,208
12177,Colen Gaynor,2017,2019,Maryland-Eastern Shore,MEAC,47,817,78,187,59,119,19,68,33,58,57,109,166,15,23,10,46,103,208
12178,Tom Herzog,2008,2011,Total,Total,73,619,84,152,84,152,0,0,40,63,48,97,145,6,16,73,34,81,208
12179,Kashaun Hicks,2017,2019,Central Connecticut State,NEC,50,687,69,189,42,102,27,87,43,61,30,70,100,22,16,10,62,81,208
12180,LaBarrius Hill,2017,2018,McNeese State,Southland,56,960,81,145,80,141,1,4,45,67,66,125,191,26,16,69,48,152,208
12181,Darius Hines,2019,2019,Marist,MAAC,31,834,72,176,50,113,22,63,42,51,4,47,51,55,25,3,47,57,208
12182,Ryan Jehle,2008,2010,Missouri State,MVC,65,900,78,157,65,104,13,53,39,63,44,99,143,29,17,9,50,110,208
12183,Logan Kinghorn,2008,2008,Idaho State,Big Sky,30,727,68,169,59,138,9,31,63,78,53,104,157,25,23,6,58,64,208
12184,Matthew Moss,2013,2016,Total,Total,88,767,76,205,36,70,40,135,16,26,40,71,111,17,18,14,33,151,208
12185,Richard Peters,2015,2017,Total,Total,85,916,89,154,89,154,0,0,30,60,72,137,209,14,14,21,64,131,208
12186,Tadre Sheppard,2011,2011,Central Arkansas,Southland,22,624,71,142,70,137,1,5,65,102,55,61,116,15,22,18,32,48,208
12187,Brandon Thomas,2008,2008,Texas State,Southland,29,681,87,167,87,166,0,1,34,106,81,78,159,50,54,7,51,96,208
12188,Jordan Tyson,2015,2019,Total,Total,93,1133,80,162,80,162,0,0,48,88,69,159,228,8,18,74,63,215,208
12189,Chris Watson,2011,2012,Florida A&M,MEAC,40,702,70,178,41,94,29,84,39,73,23,59,82,25,30,7,51,66,208
12190,Doug Wiggins,2008,2008,Connecticut,Big East,31,586,69,168,38,82,31,86,39,41,20,65,85,76,32,2,31,45,208
12191,Sam Alabakis,2017,2018,Louisiana-Monroe,Sun Belt,63,1176,83,153,83,153,0,0,41,71,67,114,181,6,12,20,65,159,207
12192,Pat Bergmann,2009,2012,Vermont,AEC,103,571,88,149,86,147,2,2,29,48,59,84,143,17,3,23,46,79,207
12193,Chad Bowie,2019,2019,Sam Houston State,Southland,30,596,74,180,48,104,26,76,33,43,12,66,78,70,48,4,60,61,207
12194,Milija Cosic,2018,2019,St. Francis (NY),NEC,30,547,78,165,65,131,13,34,38,51,44,42,86,10,10,6,44,79,207
12195,Michael Durr,2019,2019,South Florida,AAC,37,790,75,149,75,148,0,1,57,108,77,152,229,14,11,46,52,100,207
12196,Vadim Fedotov,2008,2009,Buffalo,MAC,40,763,77,157,77,157,0,0,53,67,70,55,125,29,13,7,54,73,207
12197,Kobe Gantz,2017,2018,Delaware State,MEAC,33,685,65,163,48,109,17,54,60,98,30,55,85,87,27,2,58,71,207
12198,Perris Hicks,2018,2018,Fordham,A-10,29,713,65,166,30,54,35,112,42,56,8,28,36,29,36,0,27,63,207
12199,Norbert Janicek,2017,2017,Utah State,MWC,32,659,91,157,90,154,1,3,24,49,37,74,111,17,9,4,56,68,207
12200,Logan McConathy,2008,2011,Northwestern State,Southland,119,1442,61,222,35,112,26,110,59,77,16,91,107,165,52,5,170,180,207
12201,Brandon Miller,2019,2019,Alabama A&M,SWAC,32,1106,71,220,34,112,37,108,28,36,19,96,115,131,48,1,76,56,207
12202,Karl Nicholas,2018,2019,Total,Total,43,520,88,175,88,175,0,0,31,71,55,68,123,15,13,29,53,112,207
12203,Tony Peters,2010,2013,Saint Francis (PA),NEC,101,1095,89,206,88,197,1,9,28,65,52,100,152,51,13,13,87,130,207
12204,Filip Petrusev,2019,2019,Gonzaga,WCC,32,366,67,121,58,91,9,30,64,75,22,65,87,10,5,15,20,49,207
12205,Jovan Robinson,2008,2008,Canisius,MAAC,29,651,69,189,18,58,51,131,18,34,21,43,64,38,17,6,37,55,207
12206,Paul Roemer,2008,2010,UC-Santa Barbara,Big West,81,1296,61,168,29,67,32,101,53,79,28,87,115,127,65,12,93,154,207
12207,Karlis Silins,2017,2019,Total,Total,39,583,72,130,64,108,8,22,55,80,47,75,122,18,7,17,52,64,207
12208,Herb Tanner,2008,2010,Fordham,A-10,78,1298,75,241,53,141,22,100,35,74,27,62,89,96,40,8,99,132,207
12209,Devonte Thomas,2008,2009,San Jose State,WAC,62,786,81,192,81,191,0,1,45,74,71,120,191,29,17,0,45,80,207
12210,Jon'Tee Willhite,2008,2008,Eastern Illinois,OVC,29,732,80,205,71,173,9,32,38,59,18,93,111,97,20,2,54,50,207
12211,Tione Womack,2013,2014,Houston,Total,65,1240,79,186,60,132,19,54,30,48,17,107,124,150,47,8,75,120,207
12212,Eli Wright,2017,2018,Mississippi State,SEC,64,861,77,170,60,115,17,55,36,53,41,80,121,37,20,11,37,91,207
12213,Jeff Allgood,2011,2012,Eastern Kentucky,OVC,63,768,67,176,11,30,56,146,16,20,4,58,62,47,20,1,35,72,206
12214,Alex Arians,2019,2019,South Dakota State,Summit,33,949,76,141,57,90,19,51,35,45,24,137,161,70,26,1,35,72,206
12215,Deshon Bayless,2016,2017,Arkansas-Pine Bluff,SWAC,38,630,79,190,61,138,18,52,30,55,34,58,92,19,32,5,61,95,206
12216,Fred Bouie,2009,2009,Delaware State,MEAC,31,716,72,201,34,86,38,115,24,43,17,32,49,39,19,3,39,45,206
12217,Brandon Carroll,2018,2019,Bryant,NEC,43,622,75,174,64,130,11,44,45,69,48,98,146,21,26,14,36,87,206
12218,A'Daeron Duncan,2008,2008,Coppin State,MEAC,33,740,70,194,57,143,13,51,53,69,38,81,119,44,29,14,54,54,206
12219,Tyrik Edwards,2017,2018,Jacksonville State,OVC,66,800,69,161,65,141,4,20,64,91,18,78,96,96,20,5,50,32,206
12220,Al Eichelberger,2017,2019,Total,Total,57,625,76,151,75,150,1,1,53,109,68,65,133,19,13,26,53,89,206
12221,Sean Flood,2019,2019,Longwood,Big South,33,707,64,161,13,36,51,125,27,35,6,66,72,57,22,2,43,41,206
12222,Brock Gardner,2017,2017,Liberty,Big South,35,630,76,148,55,89,21,59,33,51,16,91,107,26,12,15,34,71,206
12223,Pierre Henderson-Niles,2009,2010,Memphis,CUSA,59,863,89,184,89,184,0,0,28,65,103,146,249,6,26,32,50,124,206
12224,P.J. Hill,2008,2010,Ohio State,Big Ten,82,960,58,142,28,62,30,80,60,83,21,78,99,99,28,4,69,97,206
12225,Demetrius Johnson,2008,2008,Purdue-Fort Wayne,Summit,25,721,66,156,58,134,8,22,66,91,10,84,94,142,21,25,95,57,206
12226,Mike Johnson,2009,2010,Albany (NY),AEC,52,1049,75,199,66,153,9,46,47,81,45,94,139,139,43,5,91,93,206
12227,Shawn Jones,2018,2019,Massachusetts-Lowell,AEC,48,758,66,168,57,135,9,33,65,88,23,46,69,98,25,8,53,75,206
12228,Rashaud Nixon,2008,2008,Tennessee Tech,OVC,32,657,82,166,82,166,0,0,42,79,47,46,93,44,38,7,46,59,206
12229,Taj Owens,2013,2016,Radford,Big South,90,764,68,174,57,140,11,34,59,71,21,61,82,91,33,4,46,82,206
12230,Deividas Petravicius,2008,2009,Northwestern State,Southland,61,731,70,195,53,131,17,64,49,63,56,100,156,65,29,2,84,66,206
12231,Rogers Printup,2016,2019,UC-Davis,Big West,72,998,72,197,26,44,46,153,16,18,14,107,121,31,29,12,29,92,206
12232,Jeremy Robinson,2010,2011,Radford,Big South,51,803,55,151,40,100,15,51,81,128,20,60,80,77,34,0,66,92,206
12233,Josh Selby,2011,2011,Kansas,Big 12,26,530,72,193,38,99,34,94,28,37,10,48,58,56,21,1,53,44,206
12234,Yusef Smith,2008,2009,Saint Mary's (CA),WCC,64,756,72,166,50,111,22,55,40,66,58,119,177,20,13,32,52,116,206
12235,Terron Stowe,2010,2011,Delaware State,MEAC,49,642,76,158,75,157,1,1,53,86,52,69,121,9,12,4,41,54,206
12236,Charles Thomas IV,2016,2019,Wisconsin,Big Ten,109,736,78,196,69,159,9,37,41,66,65,105,170,18,10,27,36,117,206
12237,Darius Thompson,2018,2018,Tennessee-Martin,OVC,31,739,64,167,40,90,24,77,54,64,6,58,64,45,30,15,40,68,206
12238,David Brown,2010,2012,Gardner-Webb,Big South,50,531,71,195,12,29,59,166,4,8,14,29,43,20,17,2,29,19,205
12239,Ryan Burkhardt,2018,2019,North Florida,A-Sun,64,870,67,166,5,15,62,151,9,11,11,64,75,40,14,3,35,33,205
12240,Jamal Cain,2018,2019,Marquette,Big East,63,834,80,170,48,93,32,77,13,31,45,131,176,27,39,18,58,78,205
12241,Julian Daughtry,2018,2018,Jackson State,SWAC,32,797,65,176,34,92,31,84,44,62,26,42,68,39,30,4,32,65,205
12242,Jerrelle DeBerry,2017,2018,Total,Total,30,418,60,151,30,77,30,74,55,73,20,44,64,15,5,5,31,53,205
12243,LaMarr Drake,2009,2010,Texas A&M-Corpus Christi,Southland,40,940,69,184,44,99,25,85,42,62,23,67,90,120,49,3,105,90,205
12244,Adam Hrucaniuk,2008,2008,Cincinnati,Big East,32,776,69,185,64,165,5,20,62,88,58,112,170,26,11,11,69,100,205
12245,Payton Hulsey,2017,2018,Total,Total,33,856,69,199,61,169,8,30,59,93,37,111,148,102,49,3,75,78,205
12246,Kaleb Hunter,2019,2019,North Carolina-Greensboro,Southern,36,606,75,160,56,107,19,53,36,50,23,56,79,25,21,6,27,32,205
12247,Shaunvanta Ingram,2010,2011,Alcorn State,SWAC,49,598,74,221,61,153,13,68,44,65,33,80,113,25,14,4,67,64,205
12248,John Lamb,2008,2010,Morehead State,OVC,57,740,61,185,6,15,55,170,28,34,5,42,47,33,22,1,35,63,205
12249,Chris McComber,2014,2017,Columbia,Ivy,78,961,71,189,22,36,49,153,14,27,30,60,90,30,11,7,21,102,205
12250,Zach McCormick,2015,2017,Miami (OH),MAC,52,918,81,227,56,128,25,99,18,33,21,45,66,45,32,4,30,91,205
12251,Jaylan McGill,2018,2019,Charlotte,CUSA,56,1089,70,185,23,54,47,131,18,25,7,54,61,33,16,3,34,74,205
12252,Quade Milum,2008,2008,Akron,MAC,34,669,79,153,72,132,7,21,40,71,35,71,106,15,12,21,30,50,205
12253,Ricky Nelson,2018,2019,Weber State,Big Sky,52,975,62,146,43,102,19,44,62,88,11,45,56,102,26,0,42,90,205
12254,Xavier Pinson,2019,2019,Missouri,SEC,31,570,63,153,37,88,26,65,53,68,23,59,82,71,19,0,72,63,205
12255,Quinton Ray,2014,2017,Campbell,Big South,117,2069,74,231,58,140,16,91,41,63,51,139,190,199,64,4,120,145,205
12256,Tre Todd,2019,2019,Alabama A&M,SWAC,24,544,63,150,28,59,35,91,44,66,9,27,36,27,21,1,52,56,205
12257,Marques Wilson,2018,2019,Lehigh,Patriot,41,708,74,163,39,79,35,84,22,27,20,80,100,49,32,4,38,57,205
12258,Jimmy Binnie,2008,2008,Dayton,A-10,34,875,72,174,32,60,40,114,20,37,30,103,133,48,19,5,34,57,204
12259,Donoven Carlisle,2018,2019,Denver,Summit,56,963,81,153,65,110,16,43,26,42,49,173,222,31,17,16,48,96,204
12260,Jeremiah Hill,2014,2014,Savannah State,MEAC,32,583,68,205,27,72,41,133,27,35,15,32,47,31,19,3,34,39,204
12261,Joe Holliday,2008,2008,Southern,SWAC,27,696,68,169,27,63,41,106,27,35,18,59,77,32,21,4,35,36,204
12262,Ahmad Ibrahim,2012,2012,Rice,CUSA,33,614,77,208,50,120,27,88,23,32,15,48,63,33,18,15,37,58,204
12263,Shay'rone Jett,2017,2018,Prairie View,SWAC,52,675,78,154,67,112,11,42,37,57,42,86,128,16,13,24,21,99,204
12264,Tanner Johnson,2017,2019,Bryant,NEC,54,633,68,212,7,16,61,196,7,10,11,67,78,19,3,0,20,51,204
12265,Kenny Jones,2019,2019,Loyola (MD),Patriot,32,648,75,165,35,64,40,101,14,19,5,35,40,70,28,2,43,48,204
12266,Brian McNair,2010,2011,Gardner-Webb,Big South,51,916,76,239,46,130,30,109,22,32,14,65,79,88,50,15,65,82,204
12267,Skyelar Potter,2019,2019,Wright State,Horizon,35,585,65,171,39,88,26,83,48,69,37,96,133,20,12,1,39,50,204
12268,Elvin Rodriguez,2018,2019,Denver,Summit,51,499,71,189,58,136,13,53,49,79,17,45,62,37,18,2,42,36,204
12269,Luis Santos,2016,2017,South Florida,AAC,45,617,76,148,76,146,0,2,52,72,66,91,157,6,17,28,45,79,204
12270,Michael Selling,2009,2010,Sacramento State,Big Sky,48,699,87,214,81,179,6,35,24,39,51,91,142,20,23,6,49,108,204
12271,Jeremy Thomas,2008,2008,Sam Houston State,Southland,31,585,63,154,26,43,37,111,41,50,12,34,46,54,18,0,23,38,204
12272,Chris Thompson,2015,2016,Southern Utah,Big Sky,50,565,72,191,39,96,33,95,27,37,18,104,122,17,10,18,45,37,204
12273,Jan van der Kooij,2009,2011,Longwood,Ind,53,672,76,201,36,72,40,129,12,22,35,101,136,30,12,6,34,70,204
12274,Zion Young,2019,2019,Western Illinois,Summit,31,530,70,159,43,100,27,59,37,47,16,50,66,20,10,1,37,42,204
12275,Christian Barrett,2019,2019,Lamar,Southland,27,517,62,113,61,111,1,2,78,112,81,120,201,20,11,5,37,56,203
12276,Mike Bersch,2010,2013,American,Patriot,56,772,72,226,19,44,53,182,6,9,15,75,90,32,14,7,34,62,203
12277,Michael Bolden,2014,2015,Cal Poly,Big West,54,1012,69,204,22,63,47,141,18,27,35,66,101,32,30,11,17,59,203
12278,Duran Diaz,2008,2008,Grambling,SWAC,26,562,65,172,15,39,50,133,23,29,11,42,53,22,9,1,27,54,203
12279,Jon'te Dotson,2014,2017,Northern Colorado,Big Sky,67,1101,64,183,37,86,27,97,48,77,46,123,169,40,29,18,59,109,203
12280,Shawn Echols,2011,2011,Houston Baptist,GWC,31,784,71,178,44,104,27,74,34,60,34,34,68,55,45,0,56,101,203
12281,Tereke Eckwood,2018,2019,Mississippi Valley State,SWAC,37,764,67,200,57,150,10,50,59,84,14,72,86,70,32,2,67,46,203
12282,Armani Flannigan,2014,2015,North Texas,CUSA,60,739,81,151,81,150,0,1,41,93,59,82,141,9,24,47,35,72,203
12283,Dutch Gaitley,2008,2011,Total,Total,99,1681,58,175,54,159,4,16,83,130,110,256,366,92,38,64,122,249,203
12284,Nick Guadarrama,2019,2019,New Hampshire,AEC,26,638,73,161,45,92,28,69,29,60,35,105,140,40,24,9,42,61,203
12285,Sekou Harris,2013,2015,Total,Total,44,691,71,203,50,143,21,60,40,59,14,52,66,86,18,8,87,62,203
12286,Elvis Harvey,2019,2019,Nicholls State,Southland,31,644,65,173,39,98,26,75,47,63,42,107,149,20,18,21,49,105,203
12287,Vince Holmes,2017,2019,Total,Total,58,1116,68,169,63,136,5,33,62,106,38,101,139,115,44,24,89,104,203
12288,Jayce Johnson,2019,2019,Middle Tennessee,CUSA,31,865,66,183,62,151,4,32,67,116,39,113,152,63,26,8,78,89,203
12289,Tyrone Mattison,2008,2009,Long Island University,NEC,58,675,55,156,27,69,28,87,65,77,27,54,81,29,24,3,36,64,203
12290,Malik Muller,2015,2015,Virginia Tech,ACC,33,661,72,184,31,77,41,107,18,32,7,74,81,47,29,3,44,56,203
12291,David Nzekwesi,2019,2019,Denver,Summit,25,338,66,112,53,89,13,23,58,70,23,55,78,5,5,8,18,25,203
12292,Chuck Ogbodo,2014,2017,North Carolina-Wilmington,CAA,93,980,84,144,84,144,0,0,35,62,101,149,250,8,20,78,62,172,203
12293,Jesse Pritchard,2011,2014,Yale,Ivy,100,1215,63,190,22,61,41,129,36,54,51,114,165,43,19,10,39,101,203
12294,Shaun Reynolds,2008,2008,New Orleans,Sun Belt,32,875,63,157,47,109,16,48,61,77,7,65,72,93,29,0,65,77,203
12295,Maureece Rice,2008,2008,George Washington,A-10,22,615,71,206,38,104,33,102,28,34,15,44,59,60,15,3,37,25,203
12296,Dexter Shankle,2008,2008,Texas-Rio Grande Valley,Ind,29,801,68,137,25,47,43,90,24,39,6,62,68,47,12,3,24,70,203
12297,Delshon Strickland,2019,2019,Chicago State,WAC,26,606,77,187,54,103,23,84,26,37,10,58,68,19,12,5,36,53,203
12298,Donald Thomas,2008,2009,Sacramento State,Big Sky,52,699,71,182,58,133,13,49,48,81,40,63,103,24,22,3,45,45,203
12299,Marcus Wallace,2015,2016,Southeast Missouri State,OVC,37,661,72,160,54,107,18,53,41,69,25,53,78,69,43,4,53,66,203
12300,Grant Weatherford,2019,2019,IUPUI,Horizon,33,862,70,142,59,118,11,24,52,72,25,75,100,83,38,4,49,86,203
12301,Khiry White,2013,2014,Savannah State,MEAC,53,1121,70,170,60,126,10,44,53,85,28,80,108,69,54,4,111,114,203
12302,"Jamal Williams,",2013,2014,Texas Tech,Big 12,57,895,63,195,34,92,29,103,48,66,20,71,91,66,23,3,52,77,203
12303,Stavon Williams,2009,2009,Utah State,WAC,34,622,68,162,22,54,46,108,21,25,6,36,42,46,16,4,28,46,203
12304,Cameron Witt,2009,2011,Valparaiso,Horizon,72,693,88,198,85,177,3,21,24,48,43,60,103,28,7,21,67,137,203
12305,Abdul Ahmed,2014,2015,Cal State Bakersfield,WAC,58,790,72,205,43,112,29,93,29,42,45,86,131,31,11,11,48,105,202
12306,Aaron Augustin,2017,2019,Stephen F. Austin,Southland,72,1371,65,178,41,101,24,77,48,81,18,99,117,188,79,3,106,129,202
12307,Reed Baker,2011,2011,Florida Gulf Coast,A-Sun,14,391,64,168,43,96,21,72,53,61,7,29,36,14,22,0,27,13,202
12308,John Barnes,2009,2010,Jacksonville State,OVC,56,810,65,193,30,78,35,115,37,55,13,51,64,72,34,6,70,74,202
12309,Wabissa Bede,2018,2019,Virginia Tech,ACC,63,1118,76,177,44,95,32,82,18,31,12,98,110,105,45,6,46,85,202
12310,Koang Doluony,2010,2013,Total,Total,73,799,69,181,37,75,32,106,32,43,56,95,151,16,22,19,54,86,202
12311,Mohammed Fall,2012,2012,Montana State,Big Sky,28,682,78,151,78,151,0,0,46,57,60,92,152,25,15,36,43,85,202
12312,Rakym Felder,2017,2017,South Carolina,SEC,36,538,62,152,28,71,34,81,44,67,7,46,53,47,21,4,49,51,202
12313,Isaac Gassman,2018,2019,Illinois State,MVC,58,852,72,173,30,67,42,106,16,24,30,70,100,28,25,2,18,71,202
12314,Isaiah Gurley,2016,2019,Total,Total,73,738,63,198,36,94,27,104,49,66,22,96,118,37,18,5,34,58,202
12315,John Michael Hall,2008,2009,Drake,MVC,63,616,77,187,68,153,9,34,39,53,24,44,68,46,37,4,62,59,202
12316,Brent Holder,2008,2008,Texas State,Southland,29,476,63,179,16,37,47,142,29,34,18,57,75,25,16,3,25,56,202
12317,Valentine Izundu,2013,2017,Total,Total,77,1034,84,130,84,130,0,0,34,84,91,93,184,13,13,126,39,145,202
12318,Mookie Jones,2009,2012,Syracuse,Big East,46,411,67,160,17,34,50,126,18,27,14,43,57,27,31,8,20,40,202
12319,J.P. Kambola,2012,2015,Marshall,CUSA,49,529,82,150,71,105,11,45,27,44,56,80,136,5,10,31,31,61,202
12320,Max Kenyi,2009,2010,Harvard,Ivy,43,769,65,175,43,108,22,67,50,72,9,56,65,22,36,15,51,75,202
12321,Ethan Layer,2012,2015,Liberty,Big South,81,669,58,161,7,14,51,147,35,49,6,41,47,40,14,2,30,75,202
12322,Anthony Mayo,2011,2014,Stony Brook,AEC,98,1069,78,210,78,210,0,0,46,66,61,144,205,18,11,63,42,147,202
12323,Jordan McCabe,2019,2019,West Virginia,Big 12,35,647,66,205,22,75,44,130,26,35,13,42,55,88,31,0,50,50,202
12324,John Meeks,2018,2019,Bucknell,Patriot,54,472,82,163,64,115,18,48,20,27,29,44,73,27,10,3,33,31,202
12325,Stephon Mosley,2013,2014,Saint Francis (PA),NEC,26,600,74,164,70,151,4,13,50,67,53,57,110,13,8,8,48,80,202
12326,Isaiah Mucius,2019,2019,Wake Forest,ACC,31,676,70,219,51,138,19,81,43,70,40,76,116,23,12,8,30,37,202
12327,L'Hassane Niangane,2016,2018,Gardner-Webb,Big South,98,1554,72,163,72,163,0,0,58,118,201,201,402,35,19,100,95,280,202
12328,Trey Parker,2008,2010,Texas-Arlington,Southland,83,1098,74,119,74,119,0,0,54,90,76,149,225,27,32,113,40,202,202
12329,Clent Stewart,2008,2008,Kansas State,Big 12,30,874,65,192,34,92,31,100,41,57,34,57,91,94,29,3,68,52,202
12330,Deshaun Thrower,2015,2016,Stony Brook,AEC,62,900,67,231,45,140,22,91,46,59,17,59,76,58,22,1,38,73,202
12331,Mezie Uzochukwu,2011,2011,South Carolina Upstate,A-Sun,30,793,80,178,80,169,0,9,42,80,40,70,110,39,23,6,51,71,202
12332,Corey Arentsen,2013,2014,Austin Peay,OVC,58,666,65,168,12,32,53,136,18,24,21,74,95,46,24,2,29,36,201
12333,Marco Banegas-Flores,2015,2015,Massachusetts-Lowell,AEC,27,747,62,164,31,82,31,82,46,58,9,59,68,52,50,1,55,51,201
12334,Chris Bass,2009,2012,Louisiana State,SEC,123,1959,75,220,58,149,17,71,34,79,32,184,216,269,70,9,129,124,201
12335,Adrian Brown,2016,2019,McNeese State,Southland,97,729,75,171,73,167,2,4,49,83,46,86,132,16,20,22,46,125,201
12336,Matt Christiansen,2013,2015,San Francisco,WCC,81,998,87,172,87,171,0,1,27,50,56,114,170,36,11,22,51,158,201
12337,Kewain Gant,2008,2008,Arkansas State,Sun Belt,30,682,95,177,95,177,0,0,11,17,42,97,139,39,11,30,42,72,201
12338,Brett Gifford,2008,2010,Albany (NY),AEC,90,1409,87,163,87,162,0,1,27,41,78,207,285,31,27,63,79,208,201
12339,Vernon Goodridge,2009,2009,La Salle,A-10,30,630,84,145,84,145,0,0,33,55,56,121,177,11,16,49,34,94,201
12340,Matt Hagerbaumer,2013,2014,Omaha,Summit,63,1068,90,120,90,120,0,0,21,42,68,207,275,37,31,55,32,100,201
12341,Keaton Hervey,2018,2018,Incarnate Word,Southland,25,587,60,160,49,121,11,39,70,90,19,39,58,29,11,6,40,46,201
12342,James Hunter,2013,2015,Total,Total,50,480,83,169,83,169,0,0,35,52,56,62,118,9,8,19,30,52,201
12343,Jordan Jones,2017,2018,Charleston Southern,Big South,60,730,77,111,77,111,0,0,47,79,65,88,153,7,16,52,54,135,201
12344,Derek Koch,2018,2018,Bowling Green State,MAC,30,642,67,162,54,125,13,37,54,65,70,93,163,34,11,14,34,84,201
12345,Claybrin McMath,2011,2014,Bryant,NEC,92,968,82,220,61,132,21,88,16,26,42,101,143,21,20,20,35,160,201
12346,Trey Mourning,2015,2019,Georgetown,Big East,62,614,75,171,69,133,6,38,45,72,42,83,125,28,12,14,43,93,201
12347,John Smith,2008,2009,Alabama A&M,SWAC,48,713,80,157,80,157,0,0,41,92,92,149,241,20,22,50,65,111,201
12348,Sean Thomas,2009,2010,Morgan State,MEAC,61,1020,66,184,59,157,7,27,62,93,9,54,63,118,28,7,89,86,201
12349,Aric Van Weelden,2008,2010,Loyola (IL),Horizon,75,1438,67,170,39,78,28,92,39,60,42,119,161,92,37,7,67,129,201
12350,Leondre Washington,2018,2018,Robert Morris,NEC,24,569,56,168,32,89,24,79,65,87,11,38,49,51,22,0,46,45,201
12351,Jeremiah Worthem,2014,2016,Total,Total,29,558,66,154,54,127,12,27,57,79,33,70,103,24,12,1,33,57,201
12352,Christian Albright,2015,2017,Total,Southland,53,680,81,195,65,136,16,59,22,35,37,100,137,40,19,16,50,99,200
12353,Devron Bostick,2009,2010,Minnesota,Big Ten,54,565,77,181,55,105,22,76,24,35,29,61,90,42,32,7,41,39,200
12354,KJ Buffen,2019,2019,Mississippi,SEC,33,690,69,145,65,129,4,16,58,84,51,94,145,38,26,16,55,82,200
12355,Brendan Casper,2014,2017,Saint Joseph's,A-10,73,709,78,185,72,147,6,38,38,62,42,92,134,49,36,3,42,101,200
12356,Kene Chukwuka,2018,2019,Pittsburgh,ACC,63,1112,74,164,60,94,14,70,38,64,73,123,196,38,25,31,47,157,200
12357,Rodrigo De Souza,2012,2013,Pacific,Big West,48,787,64,154,34,72,30,82,42,66,21,76,97,86,46,0,41,92,200
12358,Jarvis Doles,2018,2019,Drexel,CAA,53,597,63,151,26,56,37,95,37,45,23,71,94,14,9,6,19,71,200
12359,Kyler Erickson,2015,2017,Omaha,Summit,62,1017,53,146,26,64,27,82,67,91,9,88,97,43,24,5,23,69,200
12360,Brandon Giles,2008,2008,Longwood,Ind,31,877,60,167,10,41,50,126,30,37,7,59,66,115,17,2,75,65,200
12361,Zach Jacobs,2018,2019,James Madison,CAA,63,902,77,187,65,129,12,58,34,45,68,140,208,23,19,35,34,125,200
12362,Calvin Johnson,2008,2009,Santa Clara,WCC,61,1284,62,168,5,14,57,154,19,22,9,56,65,63,27,3,47,106,200
12363,Chad Johnson,2011,2014,Colgate,Patriot,99,933,80,195,66,134,14,61,26,49,30,78,108,52,22,4,73,128,200
12364,Daylen Kountz,2019,2019,Colorado,Pac-12,36,616,71,164,55,112,16,52,42,65,3,46,49,46,15,3,41,46,200
12365,Mekhi Lairy,2019,2019,Miami (OH),MAC,32,548,71,169,47,96,24,73,34,39,19,33,52,43,17,0,34,50,200
12366,Jagos Lasic,2016,2018,St. Francis (NY),NEC,64,815,70,163,45,96,25,67,35,43,43,95,138,34,31,8,48,83,200
12367,Tray Maddox,2019,2019,Oakland,Horizon,30,609,70,170,47,109,23,61,37,53,13,58,71,47,20,3,33,38,200
12368,Paulius Packevicius,2008,2008,Rice,CUSA,18,565,75,169,75,169,0,0,50,74,49,128,177,13,18,24,55,57,200
12369,Kevin Porter Jr,2019,2019,Southern California,Pac-12,21,464,74,157,46,89,28,68,24,46,20,64,84,30,17,11,39,44,200
12370,Colin Slater,2017,2018,Tulane,AAC,60,701,60,194,31,78,29,116,51,62,14,38,52,54,18,3,48,68,200
12371,Jevon Thomas,2014,2017,Total,Total,62,1233,64,199,53,156,11,43,61,138,33,111,144,165,58,1,107,141,200
12372,Austin Torres,2015,2018,Notre Dame,ACC,121,903,88,145,88,145,0,0,24,58,78,115,193,26,32,24,38,138,200
12373,Phil Wallace,2008,2008,Coastal Carolina,Big South,27,558,75,163,75,162,0,1,50,84,59,78,137,32,17,4,35,60,200
12374,Karon Waller,2013,2015,Binghamton,AEC,67,856,59,172,33,88,26,84,56,78,26,116,142,32,21,1,51,53,200
12375,Zac Watson,2019,2019,UC-Riverside,Big West,33,703,80,158,73,128,7,30,33,65,43,88,131,32,22,13,57,70,200
12376,Jesse Woodard,2008,2010,Total,Total,54,800,67,205,37,94,30,111,36,53,10,51,61,62,20,2,64,88,200
12377,Cliff Alexander,2015,2015,Kansas,Big 12,28,492,73,129,73,129,0,0,53,79,55,93,148,12,5,37,28,57,199
12378,Greg Avery,2009,2009,Western Carolina,Southern,30,638,78,206,67,158,11,48,32,57,47,70,117,33,36,6,57,67,199
12379,Andrew Brommer,2009,2012,Iowa,Big Ten,103,989,75,139,75,138,0,1,49,106,64,105,169,39,26,35,65,176,199
12380,Mehdi Cheriet,2009,2011,San Diego State,MWC,56,645,76,166,59,100,17,66,30,43,39,57,96,25,11,13,30,83,199
12381,Jordan Costner,2008,2010,Saint Peter's,MAAC,77,1264,62,180,35,93,27,87,48,82,78,93,171,32,30,19,77,160,199
12382,Max Craig,2008,2011,Total,Total,66,691,82,178,82,178,0,0,35,73,67,73,140,10,14,5,56,98,199
12383,T.J. Czeski,2009,2011,Wagner,NEC,72,983,71,186,57,145,14,41,43,67,18,91,109,104,42,12,115,151,199
12384,Decardo Day,2017,2019,Total,Total,46,717,61,174,45,114,16,60,61,92,5,71,76,88,25,6,82,93,199
12385,Juwan Durham,2017,2019,Total,Total,55,646,81,147,79,145,2,2,35,54,56,92,148,20,14,72,25,86,199
12386,Sheldon Hagigal,2014,2014,St. Francis (NY),NEC,23,465,67,171,45,98,22,73,43,57,16,37,53,25,20,3,44,54,199
12387,Stefan Lakic,2018,2019,Samford,Southern,63,717,76,171,48,87,28,84,19,24,17,96,113,18,14,5,41,68,199
12388,Abdi Lidonde,2008,2008,Old Dominion,CAA,34,600,68,178,20,42,48,136,15,23,18,36,54,30,20,2,32,38,199
12389,Nick Malonga,2016,2017,North Florida,A-Sun,58,855,70,196,46,97,24,99,35,59,33,88,121,39,15,7,52,96,199
12390,Jayme Miller,2008,2008,Cal State Northridge,Big West,30,517,77,138,77,137,0,1,45,73,58,73,131,11,12,2,39,117,199
12391,Mickey Mitchell,2016,2019,Total,Total,53,889,72,154,63,129,9,25,46,80,61,144,205,60,29,19,63,120,199
12392,Mack Montgomery,2008,2008,Columbia,Ivy,28,616,69,143,54,86,15,57,46,57,16,92,108,47,19,3,47,71,199
12393,Dwight Murray Jr,2019,2019,Incarnate Word,Southland,30,743,74,158,47,86,27,72,24,28,6,60,66,67,21,2,60,61,199
12394,Tyray Petty,2010,2010,Utah Valley,GWC,28,807,69,169,38,88,31,81,30,41,36,106,142,46,29,9,45,61,199
12395,Michael Porter,2008,2009,Kentucky,SEC,61,1232,65,188,20,60,45,128,24,30,16,74,90,119,52,7,119,116,199
12396,Johncarlos Reyes,2016,2019,Boston College,ACC,91,725,90,161,90,161,0,0,19,45,55,98,153,12,12,29,45,122,199
12397,Tony Sabato,2013,2016,Elon,Total,98,1067,84,207,84,206,0,1,31,60,53,100,153,51,11,18,66,173,199
12398,Allan Saint-Gelais,2010,2012,Total,Total,55,801,69,155,56,115,13,40,48,68,32,84,116,27,15,13,61,123,199
12399,R.J. Smith,2019,2019,Sam Houston State,Southland,30,501,72,167,47,110,25,57,30,41,46,68,114,20,11,3,22,83,199
12400,Adrian Woodard,2008,2008,Hampton,MEAC,30,770,67,167,48,106,19,61,46,75,68,99,167,27,24,13,38,89,199
12401,Lachlan Anderson,2017,2019,Eastern Kentucky,OVC,54,570,72,168,58,100,14,68,40,63,54,93,147,18,24,13,44,48,198
12402,Travis Atson,2017,2019,Total,Total,53,702,67,192,36,87,31,105,33,48,30,95,125,32,21,6,48,64,198
12403,Joshua Batson,2014,2017,Chicago State,WAC,98,1407,66,270,50,184,16,86,50,95,49,101,150,120,73,3,92,171,198
12404,Lenell Brown,2012,2014,Central Arkansas,Southland,81,958,75,198,47,100,28,98,20,41,29,78,107,67,35,4,78,71,198
12405,Guglielmo Caruso,2019,2019,Santa Clara,WCC,31,652,74,142,65,114,9,28,41,62,39,91,130,24,15,31,41,106,198
12406,Roger Dugas,2010,2013,Elon,Southern,64,788,74,208,40,93,34,115,16,26,55,121,176,21,17,2,31,58,198
12407,Brolin Floyd,2009,2009,Liberty,Big South,33,778,74,158,64,120,10,38,40,66,59,97,156,41,21,5,50,85,198
12408,Earl Gee,2008,2011,Longwood,Ind,91,680,64,158,48,111,16,47,54,71,28,32,60,104,40,2,76,75,198
12409,Kaylen Gregory,2008,2009,Marist,MAAC,38,635,72,156,52,100,20,56,34,56,18,95,113,24,21,11,62,75,198
12410,Jarred Guest,2012,2015,Virginia Commonwealth,Total,124,1005,86,204,84,195,2,9,24,45,117,114,231,20,49,26,58,181,198
12411,Connor Harding,2019,2019,Brigham Young,WCC,32,621,68,147,47,79,21,68,41,61,12,82,94,36,11,6,25,48,198
12412,Rio Haskett,2018,2019,Harvard,Ivy,63,946,72,218,37,114,35,104,19,34,25,85,110,64,37,1,67,117,198
12413,Nathan Hedgecock,2008,2011,Army,Patriot,71,646,69,180,33,79,36,101,24,36,24,75,99,36,12,1,46,70,198
12414,Jacquess Hobbs,2018,2019,Eastern Kentucky,OVC,38,837,72,219,56,149,16,70,38,54,15,85,100,116,56,0,62,90,198
12415,Randy Holmes,2016,2016,Bethune-Cookman,MEAC,32,714,70,184,54,125,16,59,42,53,44,82,126,29,23,7,43,89,198
12416,Martin Iti,2008,2008,New Mexico State,WAC,35,543,74,146,74,144,0,2,50,103,71,105,176,10,7,42,49,87,198
12417,Collin Johnson,2011,2013,Coppin State,MEAC,68,831,74,186,49,103,25,83,25,33,35,74,109,28,42,6,44,92,198
12418,Breon Key,2012,2015,Total,Total,71,722,63,139,47,78,16,61,56,81,39,46,85,49,33,11,38,101,198
12419,Abdullahi Kuso,2008,2008,Gonzaga,WCC,33,501,73,125,73,124,0,1,52,79,54,79,133,7,18,35,34,93,198
12420,Omar Leary,2008,2009,Oklahoma,Big 12,69,930,65,171,23,56,42,115,26,31,16,54,70,84,31,1,47,81,198
12421,K.J. Lee,2015,2016,Marist,MAAC,58,1115,70,175,49,120,21,55,37,54,19,102,121,73,25,7,63,57,198
12422,Todd Lowenthal,2009,2011,UC-Davis,Big West,74,1658,70,149,61,128,9,21,49,74,65,188,253,147,74,1,75,136,198
12423,Yannis Mendy,2019,2019,Robert Morris,NEC,35,600,80,141,80,140,0,1,38,51,58,77,135,20,13,3,41,81,198
12424,Trevor Moore,2018,2019,Cincinnati,AAC,69,823,62,190,18,40,44,150,30,43,28,80,108,32,32,3,25,79,198
12425,Dominic Nelson,2016,2017,Southeastern Louisiana,Southland,62,1179,73,156,73,156,0,0,52,120,114,210,324,12,14,81,77,157,198
12426,Marcus Rhodes,2008,2008,Southeast Missouri State,OVC,31,575,77,171,58,117,19,54,25,45,25,44,69,52,15,7,42,47,198
12427,Ashton Spears,2017,2018,Jacksonville State,OVC,60,681,56,146,32,67,24,79,62,85,22,65,87,48,28,1,35,63,198
12428,Trevon Taylor,2019,2019,Wyoming,MWC,31,833,61,139,44,84,17,55,59,78,21,76,97,22,17,11,49,80,198
12429,Lauri Toivonen,2013,2014,Texas-Rio Grande Valley,Total,64,1213,74,154,73,145,1,9,49,78,77,112,189,54,33,15,44,143,198
12430,Jaylin Andrews,2019,2019,Loyola (MD),Patriot,30,699,67,162,38,71,29,91,34,53,23,58,81,33,30,5,28,50,197
12431,Cleavon Barlow,2008,2009,UC-Riverside,Big West,48,805,69,131,63,111,6,20,53,76,51,86,137,47,35,6,96,106,197
12432,Riley Battin,2019,2019,Utah,Pac-12,31,624,73,151,46,76,27,75,24,35,24,81,105,36,7,1,28,49,197
12433,Jonathan Blount,2011,2011,Centenary (LA),Summit,30,583,63,156,46,104,17,52,54,73,19,35,54,21,21,0,42,37,197
12434,Will Bogan,2008,2008,Southeast Missouri State,OVC,28,431,81,143,80,141,1,2,34,62,49,54,103,12,15,23,37,86,197
12435,A.J. Cheeseman,2017,2019,Total,Total,40,567,75,182,73,169,2,13,45,80,24,61,85,17,18,13,46,73,197
12436,Dale Francis,2013,2016,Texas A&M-Corpus Christi,Southland,116,1276,78,197,45,94,33,103,8,14,53,91,144,12,22,18,46,244,197
12437,Bracken Funk,2011,2011,Fresno State,WAC,31,583,67,165,54,108,13,57,50,75,44,78,122,29,30,25,32,64,197
12438,Jordan Gilliam,2019,2019,UC-Riverside,Big West,29,559,67,190,46,123,21,67,42,71,26,69,95,72,16,7,47,66,197
12439,Jordan Giusti,2013,2014,Saint Mary's (CA),WCC,68,1183,64,173,36,87,28,86,41,63,35,81,116,84,52,12,45,141,197
12440,Solomon Hainna,2017,2019,Total,Total,66,980,54,147,49,130,5,17,84,119,54,115,169,23,33,13,37,132,197
12441,Daniel Johnson,2008,2008,Pepperdine,WCC,21,405,65,158,52,106,13,52,54,66,29,51,80,16,19,12,48,51,197
12442,Jonathan King,2012,2012,Stephen F. Austin,Southland,31,671,66,129,64,122,2,7,63,91,73,75,148,23,28,5,42,73,197
12443,Garrett Kissel,2008,2011,Vermont,AEC,113,979,76,160,76,160,0,0,45,120,86,169,255,15,13,5,59,153,197
12444,Justice Kithcart,2017,2019,Total,Total,58,818,68,179,29,69,39,110,22,48,14,50,64,68,22,5,35,66,197
12445,James Lewis Jr.,2018,2018,Chattanooga,Southern,27,700,67,132,67,132,0,0,63,95,60,85,145,19,8,6,57,67,197
12446,Kevin Marfo,2017,2019,Total,Total,48,667,56,126,56,126,0,0,85,143,92,159,251,27,13,20,37,96,197
12447,Connor McClenaghan,2015,2018,Marist,MAAC,97,857,67,179,48,116,19,63,44,75,38,82,120,38,23,43,67,171,197
12448,William McClure,2010,2011,Central Michigan,MAC,61,1275,76,191,76,191,0,0,45,95,150,171,321,25,56,77,70,190,197
12449,Danny McElroy,2010,2011,Bowling Green State,MAC,54,799,89,216,88,199,1,17,18,37,47,84,131,11,26,13,71,93,197
12450,Sultan Muhammad,2013,2013,Green Bay,Horizon,34,798,63,157,19,39,44,118,27,34,12,67,79,44,16,2,36,32,197
12451,Goodluck Okonoboh,2015,2016,Nevada-Las Vegas,MWC,37,918,83,165,83,165,0,0,31,91,66,92,158,23,20,97,35,96,197
12452,Jelani Pruitt,2018,2018,Chicago State,WAC,30,468,78,183,71,159,7,24,34,64,43,73,116,24,16,3,49,51,197
12453,Will Sherrill,2008,2011,Virginia,ACC,70,927,77,188,40,85,37,103,6,11,59,102,161,30,28,8,34,102,197
12454,Stephon Smith,2012,2013,San Jose State,WAC,58,906,78,195,78,195,0,0,41,67,67,99,166,19,16,16,50,123,197
12455,Jan Svandrlik,2017,2018,Iona,MAAC,65,604,59,137,10,24,49,113,30,35,33,85,118,15,16,11,12,74,197
12456,Josiah Turner,2012,2012,Arizona,Pac-12,29,721,63,151,56,120,7,31,64,102,23,66,89,70,31,8,60,51,197
12457,Austin Venable,2016,2017,Presbyterian,Big South,55,691,87,169,87,169,0,0,23,37,38,90,128,9,13,30,51,112,197
12458,LeTrell Viser,2015,2015,Eastern Illinois,OVC,32,730,71,194,27,62,44,132,11,21,6,74,80,34,40,15,39,70,197
12459,Josh Boyd,2017,2017,Northwestern State,Southland,25,448,58,150,33,76,25,74,55,88,22,42,64,57,15,2,65,71,196
12460,Kris Clark,2008,2008,Utah State,WAC,35,1023,72,187,57,129,15,58,37,47,12,50,62,224,35,3,94,69,196
12461,Nick Colella,2012,2013,Penn State,Big Ten,57,1215,60,193,10,31,50,162,26,37,19,92,111,46,31,7,31,120,196
12462,Jordan Dressler,2010,2010,Toledo,MAC,32,778,83,158,82,157,1,1,29,50,55,87,142,21,13,6,50,102,196
12463,Abrian Edwards,2018,2018,Sam Houston State,Southland,32,685,70,139,63,116,7,23,49,72,38,79,117,74,22,2,53,62,196
12464,Iwin Ellis,2018,2019,Prairie View,SWAC,69,1128,87,122,87,122,0,0,22,53,69,139,208,19,27,20,31,151,196
12465,Carlbe Ervin II,2016,2017,Kansas State,Big 12,68,1001,69,162,55,111,14,51,44,59,49,103,152,98,38,8,67,101,196
12466,Jason Hartford,2008,2008,Cornell,Ivy,27,499,83,148,70,108,13,40,17,24,43,69,112,15,8,8,27,38,196
12467,Kobe King,2018,2019,Wisconsin,Big Ten,44,837,76,169,54,99,22,70,22,32,28,59,87,23,11,5,20,37,196
12468,Tony Lewis,2017,2019,Total,Total,47,578,83,196,81,174,2,22,28,47,45,105,150,21,10,21,67,83,196
12469,Joe Mbang,2008,2008,Rhode Island,A-10,31,501,67,163,47,89,20,74,42,61,43,85,128,9,12,10,19,42,196
12470,Anthony McClain,2008,2011,Cincinnati,Big East,98,687,76,153,76,153,0,0,44,86,93,110,203,13,4,60,37,89,196
12471,Steve McElvene,2016,2016,Dayton,A-10,32,588,86,141,86,141,0,0,24,38,59,120,179,15,5,55,43,92,196
12472,Jordan Ratliffe,2018,2018,Virginia Military Institute,Southern,27,471,72,185,49,100,23,85,29,39,23,42,65,20,20,1,41,37,196
12473,John Swinton,2012,2015,Wofford,Southern,104,1215,58,144,37,82,21,62,59,70,21,91,112,121,40,7,55,125,196
12474,Munis Tutu,2016,2017,Loyola Marymount,WCC,61,966,63,197,44,122,19,75,51,70,24,72,96,139,51,8,70,102,196
12475,Ray Barreno,2014,2017,Total,Total,64,839,76,150,76,150,0,0,43,64,91,168,259,18,8,31,76,149,195
12476,Frank Borden,2008,2009,American,Patriot,62,1076,67,195,54,138,13,57,48,65,44,107,151,64,47,16,89,165,195
12477,Michael Czepil,2008,2009,Nicholls State,Southland,33,560,64,132,34,52,30,80,37,41,23,51,74,42,23,2,43,37,195
12478,Scottie Farrington,2011,2012,Louisiana,Sun Belt,47,535,62,120,62,119,0,1,71,133,57,89,146,8,12,41,50,80,195
12479,Dejuan Flowers,2009,2010,North Dakota State,Summit,44,731,70,132,70,132,0,0,55,84,67,113,180,11,15,25,43,77,195
12480,Caleb Hollander,2018,2019,Belmont,OVC,33,467,78,186,45,81,33,105,6,15,30,96,126,21,15,4,14,45,195
12481,Charles Ieans,2013,2014,Coppin State,MEAC,58,772,74,191,55,135,19,56,28,51,38,82,120,25,14,22,43,104,195
12482,Gregory Jones-Rollins,2019,2019,Mississippi Valley State,SWAC,19,490,71,184,61,135,10,49,43,64,18,43,61,29,17,7,51,36,195
12483,Javier Langarica,2018,2019,George Washington,A-10,43,750,71,192,65,150,6,42,47,60,54,132,186,22,18,39,46,97,195
12484,Steve Luptak,2008,2011,American,Patriot,99,1353,63,182,25,65,38,117,31,46,16,92,108,117,20,2,74,97,195
12485,Sam Masten,2019,2019,Northern Colorado,Big Sky,32,729,68,153,49,95,19,58,40,59,16,54,70,44,12,0,46,55,195
12486,Trey McDonald,2012,2015,Ohio State,Big Ten,102,1016,80,153,80,153,0,0,35,88,84,94,178,16,16,41,49,146,195
12487,Taylor McHugh,2016,2019,Bryant,NEC,95,1448,63,209,25,79,38,130,31,46,23,109,132,141,31,1,75,115,195
12488,Hermann Opoku,2008,2010,George Washington,A-10,70,809,69,116,69,116,0,0,57,90,77,102,179,6,17,25,47,143,195
12489,John Ortiz,2008,2009,Texas Christian,MWC,56,800,73,201,69,179,4,22,45,76,81,116,197,16,37,10,54,95,195
12490,T.J. Parham,2018,2019,Green Bay,Horizon,45,457,64,193,31,90,33,103,34,48,22,58,80,26,26,4,28,37,195
12491,Marese Phelps,2013,2014,Norfolk State,MEAC,54,886,73,226,46,128,27,98,22,39,18,50,68,104,57,1,82,85,195
12492,Dan Robinson,2017,2018,Norfolk State,MEAC,62,940,77,174,77,174,0,0,41,71,97,121,218,25,11,53,69,174,195
12493,PJ Santavenere,2012,2014,St. Francis (NY),NEC,66,644,68,186,34,62,34,124,25,33,21,39,60,21,28,2,27,87,195
12494,Brandon Suggs,2017,2019,Total,Total,61,995,80,130,80,130,0,0,35,68,84,104,188,16,29,30,30,128,195
12495,Isaiah Taylor,2017,2017,Stephen F. Austin,Southland,33,511,60,154,25,49,35,105,40,52,13,36,49,18,10,6,43,46,195
12496,Morgan Taylor,2019,2019,Incarnate Word,Southland,17,531,59,159,54,128,5,31,72,91,10,35,45,55,17,2,52,49,195
12497,Henry Welsh,2017,2019,Harvard,Ivy,71,741,85,178,81,161,4,17,21,33,62,112,174,22,15,22,44,88,195
12498,Kim Aiken Jr.,2019,2019,Eastern Washington,Big Sky,29,501,67,164,38,74,29,90,31,45,47,99,146,15,17,20,25,62,194
12499,Tope Arikawe,2018,2019,North Texas,CUSA,63,592,75,162,75,160,0,2,44,75,81,94,175,5,17,26,39,92,194
12500,Barret Benson,2017,2019,Northwestern,Big Ten,96,863,72,144,70,136,2,8,48,87,70,148,218,37,24,47,43,170,194
12501,Keon Burns,2015,2018,New Hampshire,AEC,85,969,62,181,15,49,47,132,23,32,20,98,118,46,13,1,40,67,194
12502,Jorge Camacho,2009,2009,Eastern Kentucky,OVC,31,453,76,134,76,132,0,2,42,56,50,42,92,39,15,6,29,55,194
12503,Mike Capocci,2008,2011,Northwestern,Big Ten,98,856,70,141,65,123,5,18,49,79,55,86,141,62,51,15,55,113,194
12504,Daymond Cowlah,2011,2012,UC-Riverside,Big West,55,758,71,164,51,111,20,53,32,43,13,57,70,72,33,5,53,68,194
12505,Corey Daugherty,2016,2017,Brown,Ivy,45,739,66,197,25,55,41,142,21,28,11,57,68,75,33,3,44,89,194
12506,Aric Dickerson,2013,2016,Total,Total,60,711,66,191,16,44,50,147,12,18,8,34,42,23,13,2,42,47,194
12507,Steve Egee,2009,2012,Columbia,Ivy,81,842,69,205,43,109,26,96,30,42,15,65,80,53,29,2,72,91,194
12508,Rod Emmanuel,2010,2010,Middle Tennessee,Sun Belt,33,666,69,176,48,110,21,66,35,58,2,93,95,40,26,4,47,64,194
12509,Antwon Harris,2008,2008,Winthrop,Big South,30,523,74,160,71,144,3,16,43,71,23,63,86,24,14,4,42,45,194
12510,Darian Harris,2015,2017,Oral Roberts,Summit,83,1070,62,169,15,34,47,135,23,37,28,138,166,81,32,11,43,102,194
12511,Brandon Herbert,2008,2009,Binghamton,AEC,56,725,64,178,24,67,40,111,26,38,23,54,77,33,28,4,37,95,194
12512,Derron Hobbs,2009,2013,Total,Total,43,745,53,199,31,117,22,82,66,91,9,66,75,70,16,2,103,74,194
12513,Cooper Kaifes,2019,2019,Loyola (IL),MVC,34,743,64,133,11,19,53,114,13,16,2,43,45,48,16,2,29,40,194
12514,Andre Kelly,2019,2019,University of California,Pac-12,31,609,70,127,68,124,2,3,52,76,32,84,116,7,14,13,27,70,194
12515,Jeremy Lay,2010,2010,Hawaii,WAC,23,558,52,174,24,70,28,104,62,78,9,33,42,54,17,0,45,49,194
12516,Quadri Moore,2015,2017,Cincinnati,AAC,80,618,69,187,52,129,17,58,39,53,31,68,99,15,21,9,57,81,194
12517,Trevelin Queen,2019,2019,New Mexico State,WAC,25,381,75,158,47,78,28,80,16,26,33,39,72,42,25,19,18,33,194
12518,Victor Ramalho,2008,2008,Texas-El Paso,CUSA,33,768,65,152,65,151,0,1,64,109,64,91,155,12,18,9,44,124,194
12519,Aakim Saintil,2014,2014,South Alabama,Sun Belt,31,705,55,167,36,97,19,70,65,88,16,46,62,57,32,2,45,102,194
12520,Jonathan Scott,2019,2019,Chattanooga,Southern,32,893,64,144,33,66,31,78,35,56,24,88,112,37,21,4,36,81,194
12521,Marcus Skinner,2008,2008,Milwaukee,Horizon,26,546,84,144,83,143,1,1,25,46,65,88,153,14,10,22,20,56,194
12522,Jamie Stewart,2012,2013,Montana State,Big Sky,21,481,59,142,48,110,11,32,65,96,20,53,73,36,18,6,44,51,194
12523,Malik Stith,2010,2012,St. John's (NY),Big East,81,1004,69,201,61,160,8,41,48,70,25,44,69,83,33,2,52,101,194
12524,Sage Tolbert,2019,2019,Southeast Missouri State,OVC,31,628,72,158,69,150,3,8,47,86,55,101,156,8,15,18,63,96,194
12525,Jordan Wilkes,2008,2009,University of California,Pac-10,57,738,79,152,75,140,4,12,32,42,45,113,158,44,10,15,22,71,194
12526,Kevin Zhang,2019,2019,Tulane,AAC,30,674,70,198,44,110,26,88,28,37,12,61,73,24,11,12,33,33,194
12527,Billy Allen,2009,2011,Albany (NY),AEC,88,948,60,187,21,46,39,141,34,39,26,93,119,49,32,11,37,90,193
12528,Kevin Alter,2012,2015,Navy,Patriot,80,619,54,161,6,13,48,148,37,45,3,46,49,34,14,0,25,47,193
12529,Nick Bahe,2008,2008,Creighton,MVC,33,730,65,159,23,52,42,107,21,26,24,75,99,47,24,0,33,38,193
12530,Ousmane Barro,2008,2008,Marquette,Big East,35,694,73,135,73,135,0,0,47,71,72,120,192,10,21,41,38,92,193
12531,Jordan Bell,2017,2019,Total,Total,58,584,76,178,62,125,14,53,27,37,39,102,141,29,20,22,39,81,193
12532,Clint Bozner,2013,2014,UC-Davis,Big West,50,655,74,136,74,135,0,1,45,76,55,61,116,17,14,15,60,122,193
12533,Shelton Carter,2008,2008,Charleston Southern,Big South,22,508,66,144,44,89,22,55,39,56,36,79,115,37,15,11,40,49,193
12534,Marcus Coleman,2008,2009,Grambling,SWAC,42,778,80,166,80,166,0,0,33,53,46,82,128,27,23,15,52,104,193
12535,Khameron Davis,2018,2019,Pittsburgh,ACC,58,1107,64,161,29,61,35,100,30,43,14,134,148,40,36,21,48,75,193
12536,Emmanuel Egbuta,2019,2019,Tennessee State,OVC,28,512,72,135,72,135,0,0,49,90,45,91,136,5,20,15,33,99,193
12537,Ryan Gomes,2017,2018,Mount St. Mary's,NEC,64,553,87,148,87,147,0,1,19,42,32,57,89,9,11,23,29,96,193
12538,Egan Grafel,2008,2008,Northern Illinois,MAC,28,607,81,164,81,162,0,2,31,53,56,79,135,28,17,25,46,76,193
12539,Travis Lay,2008,2008,American,Patriot,33,689,69,151,68,147,1,4,54,79,50,83,133,22,8,3,40,39,193
12540,Jesse LoBue,2009,2010,UC-Riverside,Big West,48,574,69,165,29,75,40,90,15,19,22,70,92,17,8,4,27,44,193
12541,Samuli Nieminen,2017,2019,Stephen F. Austin,Southland,69,998,66,145,47,92,19,53,42,56,47,75,122,23,19,10,71,150,193
12542,Immanuel Quickley,2019,2019,Kentucky,SEC,37,683,55,148,25,61,30,87,53,64,2,63,65,44,16,1,33,44,193
12543,Les Simmons,2008,2010,Morehead State,OVC,48,553,67,154,59,123,8,31,51,70,50,62,112,12,23,4,55,85,193
12544,Ronald Steele,2009,2009,Alabama,SEC,15,490,56,153,19,56,37,97,44,51,8,43,51,56,14,2,36,22,193
12545,Therin Taylor,2008,2010,Cal State Northridge,Big West,76,717,60,155,58,134,2,21,71,105,49,90,139,26,30,13,63,101,193
12546,Chris Watson,2008,2008,Mississippi Valley State,SWAC,24,445,69,157,54,107,15,50,40,52,30,67,97,17,19,7,35,39,193
12547,Jarid Watson,2012,2015,Virginia Military Institute,Total,109,901,81,153,81,153,0,0,31,71,111,115,226,28,22,65,34,143,193
12548,Tyree White,2019,2019,Louisiana-Monroe,Sun Belt,35,668,68,126,49,78,19,48,38,59,42,65,107,24,17,27,24,102,193
12549,Blake Young,2008,2008,Kansas State,Big 12,33,941,65,185,38,100,27,85,36,60,47,70,117,61,32,1,43,93,193
12550,Matthew Cotton,2014,2017,Alabama A&M,SWAC,85,933,56,177,25,75,31,102,49,73,26,50,76,56,23,0,52,78,192
12551,Ty Dalton,2019,2019,Houston Baptist,Southland,24,489,69,135,56,99,13,36,41,55,33,62,95,44,17,2,35,42,192
12552,Latin Davis,2016,2017,Youngstown State,Horizon,63,795,68,180,50,126,18,54,38,54,28,90,118,72,31,1,49,62,192
12553,Maurice Dunlap,2015,2019,Total,Total,72,964,61,207,18,51,43,156,27,36,6,78,84,91,23,0,35,53,192
12554,Jarvis Gunter,2008,2008,Arkansas-Pine Bluff,SWAC,29,759,85,176,85,176,0,0,22,44,42,182,224,43,15,46,57,81,192
12555,Ryan Haggerty,2010,2013,Milwaukee,Horizon,112,1281,70,170,54,98,16,72,36,78,60,81,141,53,26,22,50,127,192
12556,Mike Henn,2019,2019,California Baptist,WAC,30,684,69,168,41,71,28,97,26,37,29,94,123,26,6,4,25,85,192
12557,Kyrie Irving,2011,2011,Duke,ACC,11,303,55,104,37,65,18,39,64,71,6,31,37,47,16,6,27,23,192
12558,Lorenzo Jenkins,2016,2019,Total,Total,43,643,67,171,27,74,40,97,18,28,23,71,94,13,10,7,28,47,192
12559,Aidas Kavaliauskas,2018,2019,Fairfield,MAAC,48,1038,69,154,44,83,25,71,29,41,8,87,95,164,57,1,86,88,192
12560,Matthew Lee,2011,2011,Bryant,NEC,29,404,70,203,30,78,40,125,12,16,9,24,33,27,13,2,35,31,192
12561,Elliott Pitts,2014,2016,Arizona,Pac-12,69,915,65,170,25,52,40,118,22,34,30,49,79,36,24,2,29,98,192
12562,Alex Richman,2009,2010,Prairie View,SWAC,57,529,64,164,8,14,56,150,8,12,5,33,38,20,8,1,32,47,192
12563,Marlon Rivera,2011,2011,Florida Gulf Coast,A-Sun,30,953,56,176,56,171,0,5,80,170,27,144,171,161,47,2,114,64,192
12564,Josh Samarco,2008,2008,Detroit Mercy,Horizon,30,557,70,192,28,68,42,124,10,10,8,26,34,13,13,5,28,32,192
12565,Jordan Shanklin,2012,2013,IUPUI,Summit,48,791,64,182,27,74,37,108,27,40,7,44,51,53,25,0,39,51,192
12566,Brandon Sperling,2009,2010,Fresno State,WAC,67,1196,58,173,49,119,9,54,67,102,20,129,149,101,39,12,85,87,192
12567,Byron Taylor,2008,2009,Florida A&M,MEAC,63,,66,181,46,110,20,71,40,53,16,73,89,147,57,0,82,93,192
12568,Jekore Tyler,2012,2013,Alabama-Birmingham,CUSA,39,479,70,184,56,136,14,48,38,59,25,43,68,40,20,4,62,35,192
12569,Gil Verner,2008,2008,Nicholls State,Southland,31,561,66,174,24,43,42,131,18,28,22,32,54,37,45,3,40,44,192
12570,Pat Welch,2018,2019,South Carolina Upstate,Total,58,739,65,169,8,15,57,154,5,8,12,42,54,38,24,6,18,54,192
12571,Jamari Wheeler,2018,2019,Penn State,Big Ten,71,1307,76,198,66,137,10,61,30,62,69,110,179,145,99,5,79,159,192
12572,Mostafa Abdel Latif,2013,2014,Sacred Heart,NEC,56,849,82,170,82,170,0,0,27,46,92,156,248,10,11,27,40,115,191
12573,Shelby Adams,2018,2019,Texas State,Sun Belt,61,665,70,143,58,104,12,39,39,68,30,57,87,19,26,2,30,57,191
12574,Austin Akers,2012,2013,Eastern Illinois,OVC,60,1495,73,210,52,133,21,77,24,39,13,92,105,186,39,2,68,80,191
12575,Chris Allen,2009,2010,Texas-San Antonio,Southland,41,627,75,177,64,142,11,35,30,45,23,45,68,34,17,13,56,56,191
12576,Joel Bosh,2008,2008,Alabama State,SWAC,29,697,63,160,39,85,24,75,41,57,51,77,128,22,13,21,29,63,191
12577,Millaun Brown,2013,2014,Louisiana-Monroe,Sun Belt,45,905,84,150,84,150,0,0,23,59,90,90,180,15,27,10,55,121,191
12578,Corey Claitt,2010,2010,Utah Valley,GWC,16,413,72,154,65,127,7,27,40,64,9,45,54,51,24,1,39,35,191
12579,Tahirou Diabate,2018,2018,Portland,WCC,30,593,80,142,79,138,1,4,30,57,43,82,125,4,19,24,34,73,191
12580,Reggie Gardner Jr,2019,2019,North Carolina Central,MEAC,33,567,64,190,24,60,40,130,23,34,12,19,31,45,10,3,38,41,191
12581,Kenny Paul Geno,2014,2017,Georgia,SEC,105,1240,70,172,45,92,25,80,26,42,49,131,180,74,32,22,32,133,191
12582,Shane Harris-Tunks,2010,2013,Colorado,Total,96,1067,76,160,76,159,0,1,39,81,48,127,175,30,31,27,101,165,191
12583,De'Andre Haskins,2009,2009,Valparaiso,Horizon,31,548,65,183,33,74,32,109,29,44,23,58,81,36,25,6,51,84,191
12584,Jericole Hellems,2019,2019,North Carolina State,ACC,36,492,71,184,49,115,22,69,27,36,34,57,91,24,13,10,36,66,191
12585,Curtis Holland III,2019,2019,High Point,Big South,25,656,66,172,36,83,30,89,29,37,12,52,64,31,21,7,40,51,191
12586,Jay Huff,2018,2019,Virginia,ACC,45,420,75,120,59,83,16,37,25,38,25,71,96,12,9,39,21,63,191
12587,Najja Hunter,2018,2018,Rice,CUSA,30,527,71,164,58,122,13,42,36,61,36,56,92,33,18,9,48,40,191
12588,Lasani Johnson,2016,2019,Total,Total,35,475,67,159,28,78,39,81,18,25,11,53,64,19,15,2,19,31,191
12589,Isaac Mbuyamba,2017,2019,Kennesaw State,A-Sun,64,1284,68,145,68,144,0,1,55,127,136,161,297,30,33,60,44,132,191
12590,Josh McCarver,2011,2012,Sacramento State,Big Sky,51,610,78,128,78,128,0,0,35,63,55,106,161,17,7,24,45,104,191
12591,Marcus Morgan,2008,2008,Cal State Fullerton,Big West,33,849,79,139,79,138,0,1,33,62,85,117,202,47,34,9,41,106,191
12592,Jason Pancoe,2010,2012,Army,Patriot,57,857,65,184,25,69,40,115,21,28,10,74,84,100,31,4,56,65,191
12593,Joe Pleasant,2019,2019,Abilene Christian,Southland,34,498,68,126,64,112,4,14,51,78,34,55,89,11,10,5,37,57,191
12594,Derek Roscoe,2017,2017,Jackson State,SWAC,32,551,76,188,69,151,7,37,32,53,37,91,128,20,10,28,49,91,191
12595,Jordan Shepherd,2017,2018,Oklahoma,Big 12,59,827,59,159,37,93,22,66,51,68,6,49,55,80,29,10,53,91,191
12596,Harold Stewart,2008,2009,North Texas,Sun Belt,63,911,61,147,61,147,0,0,69,111,90,108,198,21,19,27,59,153,191
12597,Stafford Trueheart,2017,2019,Hofstra,CAA,59,727,69,169,42,78,27,91,26,41,37,102,139,17,18,36,24,87,191
12598,Devontae Watson,2013,2016,Temple,Total,84,1009,84,183,84,183,0,0,23,47,72,176,248,9,20,76,32,138,191
12599,Cameron Allen,2018,2019,Loyola Marymount,WCC,38,638,68,194,47,126,21,68,33,50,10,39,49,64,14,5,46,52,190
12600,Terrell Brown,2013,2014,Central Arkansas,Southland,46,605,85,145,85,145,0,0,20,29,69,97,166,24,27,17,46,101,190
12601,Julian Chiera,2014,2014,Southeastern Louisiana,Southland,30,614,61,125,31,57,30,68,38,43,12,62,74,22,13,0,32,73,190
12602,Malik Clements,2016,2016,North Dakota State,Summit,30,490,69,191,39,88,30,103,22,36,15,52,67,13,14,1,27,27,190
12603,Quin Cooper,2011,2014,Total,Total,61,618,64,186,44,107,20,79,42,58,12,64,76,27,15,1,37,53,190
12604,Kyler Edwards,2019,2019,Texas Tech,Big 12,36,636,65,162,37,98,28,64,32,50,10,68,78,40,23,8,33,54,190
12605,Pina Guillaume,2010,2014,Total,Total,66,985,80,190,75,173,5,17,25,44,55,156,211,17,20,31,55,122,190
12606,Luke Hager,2013,2014,North Carolina-Wilmington,CAA,58,777,74,203,66,164,8,39,34,63,50,88,138,27,17,6,53,76,190
12607,Clayton Henry,2019,2019,New Mexico State,WAC,34,526,67,163,25,39,42,124,14,21,34,80,114,24,7,3,20,33,190
12608,Denzel Jackson,2008,2008,Maryland-Eastern Shore,MEAC,31,910,69,139,67,134,2,5,50,123,85,122,207,29,45,16,50,82,190
12609,Josh James,2014,2017,IUPUI,Summit,84,761,73,143,73,143,0,0,44,60,69,116,185,16,17,21,43,133,190
12610,Seneca Knight,2019,2019,San Jose State,MWC,31,622,63,197,35,106,28,91,36,66,16,61,77,36,12,3,33,43,190
12611,Olatunji Kosile,2012,2013,Maryland-Eastern Shore,MEAC,56,915,74,177,74,176,0,1,42,70,91,114,205,9,18,48,68,169,190
12612,Ethan Mackey,2013,2015,Maine,AEC,39,604,86,148,86,148,0,0,18,38,50,116,166,15,11,21,28,67,190
12613,Ryan McCurdy,2008,2008,Northern Arizona,Big Sky,29,506,70,150,69,148,1,2,49,73,36,93,129,9,11,16,45,65,190
12614,Nathan Mensah,2019,2019,San Diego State,MWC,34,644,72,133,72,133,0,0,46,65,80,107,187,20,9,39,22,94,190
12615,Zeke Moore,2017,2019,Total,Total,43,751,61,164,30,78,31,86,37,47,13,63,76,32,19,7,32,61,190
12616,Matt Morrison,2011,2014,Northern Iowa,MVC,93,740,65,166,31,84,34,82,26,29,3,55,58,54,21,0,45,69,190
12617,Chris Perkins,2008,2008,Purdue-Fort Wayne,Summit,31,612,78,164,72,139,6,25,28,34,19,44,63,32,24,4,33,46,190
12618,Vladimir Pinchuk,2018,2019,New Mexico,MWC,62,866,70,129,70,129,0,0,50,98,65,104,169,20,12,31,32,114,190
12619,Marquis Salmon,2016,2018,Total,Total,48,771,75,129,73,124,2,5,38,66,86,149,235,11,17,22,34,110,190
12620,Colbey Santos,2009,2010,New Hampshire,AEC,54,734,64,205,18,41,46,164,16,36,31,51,82,35,21,6,30,63,190
12621,Malachi Smith,2019,2019,Wright State,Horizon,35,530,67,154,61,127,6,27,50,61,37,63,100,59,28,4,34,54,190
12622,Emmanuel Tselentakis,2014,2016,NJIT,Total,93,1310,72,195,45,100,27,95,19,32,69,154,223,98,51,25,57,132,190
12623,Drew Washington,2008,2008,Louisiana Tech,WAC,30,980,63,176,42,109,21,67,43,60,14,52,66,53,40,6,35,66,190
12624,Yanni Wetzell,2019,2019,Vanderbilt,SEC,32,591,68,137,59,103,9,34,45,59,40,82,122,11,21,19,47,76,190
12625,Anthony Wilson,2017,2018,Kennesaw State,A-Sun,37,565,69,160,68,143,1,17,51,65,56,97,153,52,29,18,30,75,190
12626,Bassith Yessoufou,2008,2008,St. Francis (NY),NEC,29,557,65,137,65,137,0,0,60,98,63,89,152,7,23,5,42,84,190
12627,Michael Benkert,2016,2019,Belmont,OVC,87,1055,60,180,16,26,44,154,25,32,22,54,76,31,17,1,32,89,189
12628,Bol Bol,2019,2019,Oregon,Pac-12,9,268,74,132,61,107,13,25,28,37,19,67,86,9,7,24,18,15,189
12629,Ron Bracey,2012,2013,Stony Brook,AEC,47,516,68,178,46,103,22,75,31,41,39,61,100,12,8,5,35,30,189
12630,Anthony Crater,2009,2011,Total,Total,59,1588,64,190,33,62,31,128,30,51,13,98,111,188,48,3,106,103,189
12631,Taqwain Drummond,2018,2019,Coppin State,MEAC,47,974,59,214,34,105,25,109,46,62,16,120,136,35,26,4,57,97,189
12632,Ebube Ebube,2018,2019,Manhattan,MAAC,56,855,77,178,60,121,17,57,18,43,90,91,181,34,30,19,44,116,189
12633,Lorenzo Edwards,2017,2019,Saint Joseph's,A-10,49,674,65,180,34,67,31,113,28,37,37,104,141,20,16,35,21,82,189
12634,Garrett Fiddler,2008,2009,Yale,Ivy,48,745,75,152,75,152,0,0,39,63,50,85,135,29,11,27,49,91,189
12635,Cameron Fowler,2014,2016,Niagara,MAAC,84,1364,75,240,56,159,19,81,20,52,49,111,160,136,56,3,96,168,189
12636,Jordan Hickert,2012,2013,Eastern Washington,Big Sky,62,683,62,204,9,38,53,166,12,15,42,88,130,23,5,13,23,133,189
12637,Greg Johnson,2008,2009,Hofstra,CAA,59,1328,64,200,58,168,6,32,55,79,40,95,135,176,61,3,135,95,189
12638,Tamir Johnson,2008,2009,Central Connecticut State,NEC,56,802,72,147,72,147,0,0,45,85,73,99,172,14,18,12,44,92,189
12639,Brian Kreefer,2008,2009,Cornell,Ivy,54,662,81,140,78,131,3,9,24,43,48,76,124,53,14,6,50,66,189
12640,Vernon Lowndes Jr.,2018,2018,Maine,AEC,29,466,68,142,53,94,15,48,38,56,21,74,95,16,22,7,51,50,189
12641,Corderio Maclin,2012,2012,Tennessee-Martin,OVC,30,435,75,153,75,153,0,0,39,59,22,43,65,10,10,11,36,79,189
12642,Cooper Neese,2019,2019,Indiana State,MVC,23,552,59,147,30,70,29,77,42,51,10,64,74,24,21,1,34,34,189
12643,Erick Nsangou,2008,2008,Florida International,Sun Belt,29,586,75,160,68,139,7,21,32,50,32,47,79,49,26,0,65,53,189
12644,Vontay Ott,2018,2019,Northwestern State,Southland,58,644,75,192,53,113,22,79,17,31,39,92,131,23,20,5,51,70,189
12645,Lasha Parghalava,2009,2009,Hawaii,WAC,25,545,54,166,23,53,31,113,50,61,7,39,46,30,14,2,44,63,189
12646,Cameron Parker,2019,2019,Sacred Heart,NEC,31,886,53,127,36,81,17,46,66,95,11,103,114,213,26,2,119,39,189
12647,Deshon Parker,2019,2019,James Madison,CAA,33,959,62,160,29,77,33,83,32,54,19,56,75,100,37,6,38,61,189
12648,Isaiah Rhine,2009,2012,Missouri State,MVC,105,846,71,149,70,144,1,5,46,70,56,97,153,9,12,13,32,138,189
12649,Lawrence Smith,2010,2013,North Carolina A&T,MEAC,91,961,63,163,62,151,1,12,62,93,58,116,174,26,30,8,58,177,189
12650,Ryan Wright,2009,2010,Oklahoma,Big 12,62,810,62,131,62,130,0,1,65,106,68,127,195,9,14,22,43,118,189
12651,Ochai Agbaji,2019,2019,Kansas,Big 12,22,569,70,156,47,81,23,75,25,36,21,80,101,20,10,12,30,43,188
12652,Amir Allen,2019,2019,Milwaukee,Horizon,31,515,75,135,75,133,0,2,38,70,60,74,134,19,9,32,21,78,188
12653,Justin Billingslea,2008,2008,Georgia State,CAA,30,673,73,145,73,142,0,3,42,66,43,61,104,32,19,21,54,103,188
12654,Mark Blackmon,2014,2016,Maryland-Eastern Shore,MEAC,80,714,58,148,37,87,21,61,51,73,24,40,64,36,51,0,37,99,188
12655,Nazeer Bostick,2017,2018,Penn State,Big Ten,53,721,65,163,58,126,7,37,51,68,32,61,93,30,29,10,47,69,188
12656,Nigel Byam,2009,2010,St. Francis (NY),NEC,37,645,77,153,76,148,1,5,33,54,51,72,123,18,15,39,48,89,188
12657,Austin Carroll,2011,2014,Total,Total,83,872,62,181,15,41,47,140,17,29,10,75,85,58,17,6,56,87,188
12658,Samuel Dingba,2015,2019,Total,Total,93,979,67,138,67,137,0,1,54,95,98,132,230,14,25,52,47,156,188
12659,Josh Eleby,2013,2013,Prairie View,SWAC,32,447,87,163,87,163,0,0,14,33,35,43,78,5,11,24,41,86,188
12660,Reiley Ervin,2008,2008,Tennessee State,OVC,32,792,69,144,31,55,38,89,12,33,16,53,69,103,47,1,55,70,188
12661,Nick Evans,2009,2010,Southern Illinois,MVC,49,682,75,159,75,159,0,0,38,53,45,82,127,7,10,38,63,114,188
12662,Lorenzo Hunt,2017,2019,Mississippi Valley State,SWAC,80,829,71,190,63,162,8,28,38,70,39,83,122,27,22,10,39,94,188
12663,Chris Hyche,2008,2011,Jackson State,SWAC,58,550,79,201,58,133,21,68,9,38,28,43,71,15,18,6,47,47,188
12664,Chuka Iloegbu,2008,2009,Coppin State,MEAC,58,794,64,187,42,112,22,75,38,64,23,82,105,41,19,2,62,76,188
12665,Deonata Jethroe,2013,2013,Troy,Sun Belt,32,570,68,193,38,85,30,108,22,30,29,64,93,12,11,4,21,44,188
12666,Hurley Johnson,2013,2014,Texas-Rio Grande Valley,Total,57,667,65,171,43,88,22,83,36,67,15,43,58,29,19,0,42,65,188
12667,Mayan Kiir,2018,2019,Total,Total,45,507,58,129,54,106,4,23,68,112,45,71,116,17,18,20,59,102,188
12668,Tyson Koehler,2011,2013,Southern Utah,Total,76,802,76,161,76,157,0,4,36,51,53,81,134,43,13,13,40,84,188
12669,Jacob Kurtz,2012,2015,Florida,SEC,83,877,73,120,72,117,1,3,41,63,68,99,167,41,31,2,44,66,188
12670,Matt Kyle,2008,2008,Yale,Ivy,25,490,82,131,82,131,0,0,24,46,34,72,106,19,13,35,47,79,188
12671,Brandon Mahan,2019,2019,Texas A&M,SEC,32,719,62,157,19,45,43,112,21,34,20,71,91,23,19,8,23,55,188
12672,Rudy Meo,2009,2010,UC-Riverside,Big West,40,465,60,143,26,58,34,85,34,43,6,48,54,28,11,2,41,46,188
12673,Jack Nunge,2018,2018,Iowa,Big Ten,33,517,66,149,47,92,19,57,37,49,35,56,91,34,21,25,32,38,188
12674,Dominick Pickett,2018,2019,UC-Riverside,Big West,53,1012,70,180,37,84,33,96,15,17,36,100,136,95,31,4,59,80,188
12675,Dominique Raney,2014,2014,Canisius,MAAC,34,529,71,168,55,110,16,58,30,41,14,32,46,21,18,5,27,39,188
12676,Darius Richardson,2011,2013,Total,Total,33,606,68,207,27,67,41,140,11,14,18,62,80,28,12,3,28,43,188
12677,Pierre Sarr,2016,2018,Monmouth,MAAC,79,653,58,114,47,85,11,29,61,89,48,144,192,21,26,12,55,110,188
12678,Demetri Wheeler,2012,2013,Grambling,SWAC,44,1038,81,193,80,181,1,12,25,44,62,103,165,26,17,13,52,88,188
12679,Russell Wilson,2013,2014,Samford,Southern,65,1193,69,156,67,140,2,16,48,90,32,91,123,139,50,4,130,154,188
12680,Clive Allen,2017,2017,Robert Morris,NEC,33,578,64,173,45,110,19,63,40,56,7,37,44,58,18,18,63,85,187
12681,Stedman Allen,2015,2015,Wagner,NEC,29,563,65,162,65,160,0,2,57,83,62,65,127,6,24,13,34,67,187
12682,Mike Bardo,2008,2011,Akron,MAC,136,1429,73,147,73,147,0,0,41,89,107,150,257,35,25,59,51,239,187
12683,Joey Brooks,2010,2012,Notre Dame,Big East,80,636,59,146,47,109,12,37,57,103,28,69,97,35,24,3,41,72,187
12684,Jarell Byrd,2012,2013,Wofford,Southern,58,798,66,165,48,103,18,62,37,54,23,113,136,47,18,17,47,58,187
12685,Chris Coalmon,2018,2019,Robert Morris,NEC,60,804,71,144,47,83,24,61,21,30,33,68,101,30,19,7,48,99,187
12686,C.J. Davis,2016,2019,Columbia,Ivy,69,676,65,170,39,89,26,81,31,43,12,82,94,75,28,3,51,77,187
12687,Marlin Davis,2017,2018,Texas State,Sun Belt,52,906,71,185,59,128,12,57,33,66,8,68,76,110,29,2,61,59,187
12688,Duke Douglas,2015,2017,Denver,Summit,79,783,77,158,72,133,5,25,28,47,29,78,107,34,12,25,36,108,187
12689,Brady Ernst,2016,2019,Total,Total,66,788,74,117,74,117,0,0,39,78,58,129,187,34,17,25,43,90,187
12690,Rob Howard Jr.,2019,2019,Illinois-Chicago,Horizon,30,562,77,155,60,110,17,45,16,31,38,75,113,19,13,23,33,104,187
12691,Justin Jordan,2015,2018,Total,Total,60,907,68,177,45,105,23,72,28,42,10,86,96,59,20,2,54,61,187
12692,Brad Kelleher,2011,2011,Hofstra,CAA,25,706,62,166,28,65,34,101,29,38,6,47,53,83,14,1,38,50,187
12693,Simeon Lepichev,2018,2019,Florida Atlantic,CUSA,49,879,78,175,70,139,8,36,23,40,67,129,196,24,13,23,50,90,187
12694,Dinko Marshavelski,2010,2013,Northeastern,CAA,63,498,76,151,76,151,0,0,35,47,35,43,78,8,9,18,40,60,187
12695,Mubarak Muhammed,2019,2019,Louisiana Tech,CUSA,33,610,79,162,69,136,10,26,19,44,75,98,173,14,21,24,32,73,187
12696,Ghassan Nehme,2016,2017,Fairleigh Dickinson,NEC,44,549,63,180,19,64,44,116,17,21,10,71,81,33,19,2,36,87,187
12697,Osi Nwachukwu,2019,2019,Sacramento State,Big Sky,31,708,82,177,77,144,5,33,18,27,37,75,112,33,33,12,38,55,187
12698,Riley Payne,2014,2015,Abilene Christian,Southland,61,1022,72,154,72,154,0,0,43,72,56,76,132,32,22,4,45,153,187
12699,Roman Sorkin,2015,2018,Oregon,Pac-12,74,484,66,141,41,72,25,69,30,36,34,57,91,23,1,19,21,60,187
12700,Renard Suggs,2016,2018,Total,Total,42,502,66,186,33,77,33,109,22,35,10,56,66,35,7,4,34,39,187
12701,Jack White,2017,2019,Duke,ACC,73,936,62,162,32,51,30,111,33,39,58,163,221,34,30,45,34,80,187
12702,Robert Woodard,2019,2019,Mississippi State,SEC,34,596,73,156,61,112,12,44,29,50,47,92,139,25,18,17,22,38,187
12703,Ronald Wright,2012,2013,Prairie View,SWAC,62,993,83,229,81,214,2,15,19,55,32,112,144,99,44,6,69,101,187
12704,Tola Akomolafe,2012,2013,Florida International,Sun Belt,46,1052,68,168,54,109,14,59,36,51,55,126,181,33,42,14,54,126,186
12705,Ty Allen,2014,2014,Tennessee Tech,OVC,24,461,60,173,38,93,22,80,44,56,5,31,36,19,14,3,36,52,186
12706,Will Alston,2009,2010,Jacksonville,A-Sun,60,696,65,171,65,171,0,0,56,99,44,92,136,10,11,23,55,84,186
12707,Enoch Andoh,2009,2012,Bucknell,Patriot,87,679,67,154,67,154,0,0,52,75,60,109,169,4,17,4,63,105,186
12708,Keith Belfield,2013,2014,Furman,Southern,38,681,58,159,26,78,32,81,38,54,33,51,84,26,13,5,41,72,186
12709,Dwight Burke,2008,2009,Marquette,Big East,70,1087,64,106,64,106,0,0,58,113,100,129,229,14,18,25,37,175,186
12710,Dele Coker,2008,2011,St. John's (NY),Big East,109,973,78,182,78,182,0,0,30,66,79,130,209,19,24,75,67,188,186
12711,Chris Gadley,2009,2009,Canisius,MAAC,24,455,64,166,57,142,7,24,51,96,48,111,159,14,5,20,50,53,186
12712,Marcus Hammond,2019,2019,Niagara,MAAC,32,622,59,123,23,54,36,69,32,38,15,50,65,43,13,4,25,42,186
12713,Marcus Hinton,2008,2008,Eastern Washington,Big Sky,30,627,59,158,46,120,13,38,55,70,39,49,88,24,26,2,38,40,186
12714,Justin Maneri,2009,2012,Lehigh,Patriot,89,806,71,143,71,142,0,1,44,90,69,84,153,23,16,6,44,128,186
12715,John Manning,2012,2015,Saint Louis,A-10,97,972,71,152,70,147,1,5,43,74,33,97,130,25,17,71,47,133,186
12716,Sukhmail Mathon,2018,2019,Boston University,Patriot,64,893,85,174,83,165,2,9,14,33,61,150,211,54,14,21,72,103,186
12717,Chad Millard,2008,2010,Creighton,MVC,82,950,59,163,28,62,31,101,37,58,42,107,149,41,19,40,47,134,186
12718,Will Morning,2009,2010,McNeese State,Southland,36,515,78,144,78,143,0,1,30,73,72,67,139,14,20,10,35,87,186
12719,Josh Parrish,2017,2019,Total,Total,40,602,68,135,60,99,8,36,42,71,24,61,85,34,21,15,42,57,186
12720,Andrew Petcash,2018,2019,Boston University,Patriot,54,627,65,149,25,48,40,101,16,21,14,39,53,29,21,4,19,47,186
12721,Jose Placer,2019,2019,Maryland-Baltimore County,AEC,33,543,70,145,49,79,21,66,25,31,6,36,42,49,13,1,36,54,186
12722,Jevohn Shepherd,2008,2009,Michigan,Big Ten,61,645,72,166,63,118,9,48,33,64,41,48,89,40,20,7,35,62,186
12723,Issac Smith,2014,2015,Maryland-Eastern Shore,MEAC,54,913,57,211,36,132,21,79,51,75,11,59,70,100,31,1,81,47,186
12724,A.J. Stewart,2008,2011,Total,Total,60,519,75,149,73,136,2,13,34,56,49,82,131,24,18,39,58,79,186
12725,Sam Sussenguth,2009,2010,North Dakota State,Summit,56,812,72,115,71,113,1,2,41,50,56,116,172,21,12,36,34,84,186
12726,Jermaine Ukaegbu,2016,2019,Total,Total,80,918,75,118,75,117,0,1,36,73,80,168,248,35,17,49,56,163,186
12727,Osandai Vaughn,2015,2015,Youngstown State,Horizon,28,572,60,143,40,96,20,47,46,61,27,59,86,18,20,9,24,57,186
12728,Anthony White,2013,2014,St. Francis (NY),NEC,49,857,73,202,63,145,10,57,30,36,33,98,131,66,29,18,49,79,186
12729,Brandon Williams,2014,2015,Texas-Arlington,Sun Belt,62,761,77,133,77,130,0,3,32,60,61,137,198,8,20,46,31,93,186
12730,Dallas Blocker,2009,2010,Youngstown State,Horizon,45,769,77,150,76,146,1,4,30,56,66,81,147,50,39,27,42,140,185
12731,J.J. Davenport,2014,2015,Louisiana,Sun Belt,52,509,64,140,64,137,0,3,57,78,55,85,140,16,4,2,31,84,185
12732,Cheick Diakite,2008,2009,Virginia Tech,ACC,66,956,80,163,80,163,0,0,25,50,89,130,219,11,5,78,24,106,185
12733,Luke Granato,2008,2008,Sacred Heart,NEC,31,586,64,175,19,40,45,135,12,13,10,44,54,18,10,1,32,38,185
12734,Joe Hanel,2015,2018,DePaul,Big East,79,1109,77,127,77,126,0,1,31,61,80,108,188,32,18,15,45,153,185
12735,Tre King,2019,2019,Eastern Kentucky,OVC,31,574,67,145,63,127,4,18,47,69,55,82,137,25,25,17,38,92,185
12736,John Kiser,2017,2019,Valparaiso,Total,79,1154,62,138,46,80,16,58,45,59,60,171,231,59,30,15,33,106,185
12737,Cameron Lewis,2008,2009,Pennsylvania,Ivy,48,622,73,158,73,158,0,0,39,108,63,98,161,16,22,47,76,107,185
12738,Trey Lindsey,2012,2013,Louisiana-Monroe,Sun Belt,55,1010,63,183,41,113,22,70,37,53,31,89,120,71,26,3,50,153,185
12739,Josh McCoy,2009,2011,Cleveland State,Horizon,65,678,50,136,23,55,27,81,58,72,36,84,120,30,24,4,34,68,185
12740,Mileek McMillan,2018,2019,Valparaiso,MVC,62,581,59,147,33,71,26,76,41,55,20,71,91,18,8,11,55,115,185
12741,B.J. Miller,2011,2011,Jacksonville State,OVC,30,498,60,164,17,50,43,114,22,31,5,25,30,49,15,2,56,57,185
12742,Tim Owens,2011,2012,Troy,Sun Belt,54,838,69,116,69,116,0,0,47,80,91,97,188,10,14,68,38,124,185
12743,D.J. Porter,2018,2018,St. Francis (NY),NEC,31,519,69,155,59,108,10,47,37,47,45,104,149,32,31,14,29,75,185
12744,Kendell Ramlal,2014,2018,Total,Total,106,930,76,150,76,150,0,0,33,65,83,118,201,24,19,70,57,114,185
12745,Andy Smeathers,2012,2015,Total,Total,57,490,58,183,15,38,43,145,26,32,15,61,76,18,10,7,34,58,185
12746,T.J. Thomas,2017,2017,Drake,MVC,31,621,67,148,64,136,3,12,48,78,47,110,157,23,9,18,38,76,185
12747,Myles Thompson,2019,2019,Saint Francis (PA),NEC,33,498,69,164,56,111,13,53,34,52,40,72,112,13,9,6,27,52,185
12748,Kamil Williams,2016,2017,Savannah State,MEAC,41,436,55,179,13,32,42,147,33,50,8,47,55,18,18,1,26,56,185
12749,Nevin Zink,2019,2019,South Carolina Upstate,Big South,31,595,70,129,70,129,0,0,45,63,48,77,125,5,9,13,41,85,185
12750,YaYa Anderson,2016,2016,Radford,Big South,26,713,63,182,29,73,34,109,24,27,18,50,68,39,14,1,22,34,184
12751,Catalin Baciu,2009,2012,Clemson,ACC,75,494,79,145,79,145,0,0,26,52,55,72,127,7,14,23,36,63,184
12752,Ray Blackburn,2009,2009,St. Bonaventure,A-10,23,516,58,143,45,99,13,44,55,68,10,47,57,66,26,1,64,58,184
12753,Randy Brumant,2018,2019,Columbia,Ivy,35,639,73,148,63,106,10,42,28,40,48,101,149,27,19,22,28,86,184
12754,Lyndale Burleson,2008,2009,Nevada,WAC,57,1261,65,190,26,56,39,134,15,30,9,64,73,123,62,7,54,108,184
12755,Deshawn Corprew,2019,2019,Texas Tech,Big 12,35,492,75,133,55,84,20,49,14,21,36,86,122,16,13,10,27,54,184
12756,Kyle Cruze,2008,2008,Holy Cross,Patriot,29,795,60,171,32,82,28,89,36,46,28,77,105,62,46,1,66,68,184
12757,Jermaine Dailey,2008,2008,Illinois-Chicago,Horizon,33,694,76,121,76,121,0,0,32,53,59,92,151,8,19,29,31,56,184
12758,Darius Days,2019,2019,Louisiana State,SEC,35,510,66,136,40,68,26,68,26,35,60,80,140,13,27,11,17,94,184
12759,Jordan Foster,2013,2014,Western Illinois,Summit,61,876,59,165,38,98,21,67,45,66,5,64,69,80,21,1,77,84,184
12760,Matt Gramling,2013,2014,Army,Patriot,57,797,69,196,59,134,10,62,36,58,38,55,93,75,34,4,38,44,184
12761,Chris Grier,2011,2012,Charleston Southern,Big South,55,585,62,152,39,95,23,57,37,51,28,57,85,37,17,1,48,75,184
12762,Bryan Hall,2009,2011,Northern Illinois,MAC,72,1215,78,165,76,160,2,5,26,67,42,88,130,151,62,8,96,121,184
12763,Anfernee Hampton,2018,2019,Southern Mississippi,CUSA,48,498,63,162,46,104,17,58,41,53,22,56,78,13,10,7,18,38,184
12764,Gabriel Harris,2010,2013,Stanford,Total,86,825,61,183,46,132,15,51,47,66,28,70,98,50,31,4,53,86,184
12765,Keegan Hornbuckle,2010,2013,Total,Total,62,811,75,164,52,112,23,52,11,20,37,64,101,43,38,9,41,69,184
12766,Musa Jallow,2018,2019,Ohio State,Big Ten,68,988,67,164,44,84,23,80,27,40,46,101,147,50,34,13,58,92,184
12767,Willie Lago,2008,2010,Louisiana,Sun Belt,84,863,63,204,37,95,26,109,32,65,8,46,54,89,15,2,75,66,184
12768,Terrence Lewis,2018,2019,Iowa State,Big 12,48,499,63,178,34,80,29,98,29,38,27,31,58,12,12,9,26,49,184
12769,Shaquiell Mitchell,2013,2014,South Carolina State,MEAC,52,867,60,227,43,158,17,69,47,93,66,94,160,44,28,3,79,79,184
12770,Aidan Saunders,2019,2019,Oral Roberts,Summit,32,558,63,185,50,137,13,48,45,67,12,43,55,34,18,5,42,31,184
12771,Juan Pablo Silveira,2008,2008,Weber State,Big Sky,30,594,59,137,28,47,31,90,35,39,4,38,42,53,16,5,59,51,184
12772,Keith Spencer,2008,2008,Texas-San Antonio,Southland,28,742,82,140,82,140,0,0,20,59,72,92,164,15,28,6,35,96,184
12773,Carrington Ward,2015,2017,Total,Total,49,682,59,157,41,88,18,69,48,64,12,57,69,40,24,7,51,88,184
12774,Sterling Williams,2008,2009,Northwestern,Big Ten,58,750,72,161,62,124,10,37,30,58,27,69,96,42,37,12,26,59,184
12775,Olalekan Ajayi,2014,2016,Total,Total,82,1328,63,140,63,140,0,0,57,100,120,253,373,19,44,33,65,196,183
12776,Jared Bryant,2012,2016,Total,Total,71,689,66,120,66,120,0,0,51,87,63,103,166,15,11,4,45,120,183
12777,Reggie Chaney,2019,2019,Arkansas,SEC,34,555,83,150,83,150,0,0,17,33,40,78,118,25,21,45,46,82,183
12778,Jamel Ferguson,2008,2009,Manhattan,MAAC,48,664,70,178,53,117,17,61,26,71,28,81,109,68,29,10,54,76,183
12779,Russell Graham,2009,2010,New Hampshire,AEC,54,1063,58,181,49,129,9,52,58,96,26,111,137,154,35,2,71,94,183
12780,Tyrone Green,2008,2008,Southern Illinois,MVC,33,862,60,130,57,119,3,11,60,79,39,50,89,53,30,3,53,87,183
12781,Jason Henry,2009,2009,Arkansas,SEC,23,423,70,165,53,105,17,60,26,45,40,62,102,14,23,3,35,32,183
12782,Skylar Jones,2011,2013,Niagara,MAAC,48,681,64,209,38,110,26,99,29,45,38,58,96,10,20,10,33,95,183
12783,Ethan Kay,2018,2019,Presbyterian,Big South,50,447,61,182,4,9,57,173,4,5,6,31,37,14,20,1,4,11,183
12784,Avery Lomax,2015,2017,Prairie View,SWAC,80,1163,54,188,51,148,3,40,72,101,24,82,106,109,54,0,82,126,183
12785,Robert Lumpkins,2009,2011,Total,Total,56,635,65,185,42,96,23,89,30,39,29,69,98,21,18,15,32,81,183
12786,Devonte Maymon,2011,2011,Youngstown State,Horizon,20,475,61,167,32,87,29,80,32,51,9,11,20,33,14,0,38,34,183
12787,Josh McNair,2019,2019,Green Bay,Horizon,33,541,77,129,77,127,0,2,29,49,50,61,111,35,23,17,28,69,183
12788,Austin Meyer,2017,2018,Rice,CUSA,56,614,76,113,76,113,0,0,31,54,47,75,122,9,11,33,42,107,183
12789,Namdi Okonkwo,2016,2018,Total,Total,47,719,75,117,75,117,0,0,33,53,57,120,177,12,6,90,31,95,183
12790,Keith Rendleman,2010,2010,North Carolina-Wilmington,CAA,31,625,75,154,74,150,1,4,32,64,75,113,188,10,18,32,38,76,183
12791,Brendan Rumel,2017,2019,Portland State,Big Sky,54,443,72,127,72,126,0,1,39,50,47,56,103,5,6,14,30,69,183
12792,Jeff Ryan,2008,2011,Northwestern,Big Ten,61,987,70,138,65,121,5,17,38,69,30,98,128,76,35,15,56,96,183
12793,Jaylen Sims,2019,2019,North Carolina-Wilmington,CAA,32,605,56,139,27,56,29,83,42,58,32,64,96,28,12,8,24,47,183
12794,Elijah Thomas,2018,2019,Saint Mary's (CA),WCC,59,666,67,151,41,66,26,85,23,41,27,53,80,18,31,1,24,83,183
12795,Tyler Washington,2011,2014,Northwestern State,Southland,77,765,61,179,29,78,32,101,29,48,17,39,56,63,28,2,40,95,183
12796,Eric Williams,2010,2012,Niagara,MAAC,65,709,74,142,74,142,0,0,35,60,49,94,143,11,16,19,44,106,183
12797,Anthony Black,2018,2018,Little Rock,Sun Belt,26,543,71,169,38,75,33,94,7,11,10,46,56,42,25,0,21,40,182
12798,Mattia Da Campo,2017,2019,Seattle,WAC,73,914,61,110,47,79,14,31,46,72,86,110,196,55,20,1,54,97,182
12799,Ahmad Gilbert,2016,2019,Total,Total,62,591,66,207,31,86,35,121,15,28,18,66,84,36,29,9,39,62,182
12800,Tykei Greene,2019,2019,Manhattan,MAAC,32,629,61,193,40,109,21,84,39,68,29,77,106,16,16,2,58,51,182
12801,Josh Jefferson,2019,2019,Illinois State,MVC,21,490,58,146,17,44,41,102,25,32,6,39,45,34,16,4,19,25,182
12802,Jordan Johnson,2012,2013,Southern Utah,Total,62,1054,64,140,57,116,7,24,47,75,56,111,167,70,60,11,63,173,182
12803,Raheem Johnson,2015,2017,Buffalo,MAC,61,656,76,130,76,130,0,0,30,45,69,95,164,3,14,60,41,131,182
12804,D.J. Jones,2019,2019,Florida A&M,MEAC,31,719,81,208,81,201,0,7,20,37,31,90,121,23,22,36,34,96,182
12805,David Kummer,2008,2008,Denver,Sun Belt,16,587,59,128,36,57,23,71,41,48,9,65,74,26,19,11,33,30,182
12806,Jakub Kusmieruk,2009,2013,Total,Total,75,538,66,118,66,118,0,0,50,93,44,80,124,5,5,27,32,103,182
12807,Greg McCarthy,2008,2009,Holy Cross,Patriot,52,691,79,155,76,144,3,11,21,42,42,70,112,34,22,21,64,95,182
12808,Rod Mitchell,2008,2010,Savannah State,Ind,79,921,67,182,67,177,0,5,48,87,61,101,162,38,36,25,100,165,182
12809,Tyshawn Myles,2015,2018,Drexel,CAA,97,1076,69,149,69,149,0,0,44,89,126,146,272,14,16,48,39,199,182
12810,Terrance O'Donohue,2014,2017,College of Charleston,CAA,86,872,66,151,57,128,9,23,41,70,49,102,151,8,29,21,49,141,182
12811,Benson Osayande,2017,2018,Montana State,Big Sky,52,529,62,119,62,119,0,0,58,81,53,56,109,9,14,11,30,102,182
12812,Jaleel Queary,2014,2015,Total,Total,50,981,72,171,71,166,1,5,37,85,45,75,120,64,26,9,73,123,182
12813,Cameron Reed,2016,2017,New Orleans,Southland,44,640,57,177,11,38,46,139,22,28,11,29,40,29,11,7,33,66,182
12814,Anthony Roberts,2019,2019,Kent State,MAC,31,546,72,169,52,99,20,70,18,25,13,38,51,41,24,1,38,67,182
12815,Elbert Robinson,2015,2019,Total,Total,89,717,73,136,73,136,0,0,36,86,66,98,164,24,19,31,77,154,182
12816,Tyreek Scott-Grayson,2019,2019,Alabama-Birmingham,CUSA,34,583,62,153,38,82,24,71,34,44,16,65,81,39,19,10,45,52,182
12817,Zygis Sestokas,2008,2009,Hofstra,CAA,53,672,61,176,8,16,53,160,7,12,17,50,67,19,11,4,13,55,182
12818,Dylen Setzekorn,2013,2014,Citadel,Southern,42,463,63,154,39,88,24,66,32,45,28,41,69,12,18,5,33,55,182
12819,Will Simonton,2012,2016,Total,Total,96,977,75,183,74,180,1,3,31,59,72,110,182,25,21,44,54,184,182
12820,Curtis West,2008,2009,Samford,Total,34,950,61,140,44,74,17,66,43,72,31,70,101,81,36,1,41,64,182
12821,Jalen Williams,2017,2019,Furman,Southern,77,625,59,125,59,125,0,0,64,92,93,115,208,21,12,34,57,105,182
12822,Sean Alarcon,2008,2008,Florida Atlantic,Sun Belt,33,828,62,149,18,39,44,110,13,16,4,31,35,61,23,0,31,54,181
12823,Khaleem Bennett,2019,2019,Central Arkansas,Southland,29,574,69,153,65,137,4,16,39,78,32,59,91,26,19,9,59,70,181
12824,Tyree Bynum,2014,2017,Texas Southern,SWAC,85,858,64,181,27,66,37,115,16,25,10,41,51,26,16,0,30,37,181
12825,Kevan Creppy,2008,2009,Bethune-Cookman,MEAC,62,880,72,142,72,140,0,2,37,78,90,106,196,21,32,11,42,120,181
12826,Domineek Daniel,2010,2010,Sacramento State,Big Sky,30,490,69,175,56,131,13,44,30,47,24,73,97,27,46,21,60,82,181
12827,Tahirou Diabete,2019,2019,Portland,WCC,32,444,74,136,74,136,0,0,33,65,32,70,102,4,17,24,45,85,181
12828,Cheikh Diallo,2018,2019,American,Patriot,46,845,68,165,35,53,33,112,12,18,15,65,80,32,23,2,57,71,181
12829,Wendale Farrow,2008,2009,Eastern Michigan,MAC,58,990,66,149,62,138,4,11,45,78,73,133,206,30,17,15,21,93,181
12830,Dino Hair,2008,2009,Middle Tennessee,Sun Belt,63,743,60,147,57,125,3,22,58,84,36,64,100,25,16,26,52,121,181
12831,Sean Haluska,2008,2009,Iowa State,Big 12,62,996,62,184,34,83,28,101,29,38,3,62,65,51,19,15,28,90,181
12832,Bryan Harvey,2008,2008,Fresno State,WAC,17,525,60,172,24,59,36,113,25,31,10,75,85,27,22,6,23,34,181
12833,Aleksandar Isailovic,2013,2014,St. Francis (NY),NEC,55,888,61,202,18,43,43,159,16,20,16,67,83,25,34,10,28,68,181
12834,Reuben King,2015,2016,Charleston Southern,Big South,55,691,76,165,68,127,8,38,21,39,58,110,168,31,25,10,44,86,181
12835,Yemi Makanjuola,2016,2016,Southern Illinois-Edwardsville,OVC,28,491,63,132,63,130,0,2,55,90,56,99,155,17,9,11,54,95,181
12836,Blake Mishler,2008,2011,Total,Total,63,580,74,152,74,152,0,0,33,46,57,54,111,12,11,3,35,92,181
12837,Brandon Moore Jr,2019,2019,Nicholls State,Southland,21,533,73,168,61,130,12,38,23,32,41,106,147,39,25,9,43,51,181
12838,Kechan Myers,2008,2008,New Orleans,Sun Belt,32,538,64,167,48,123,16,44,37,48,15,43,58,58,16,0,40,59,181
12839,Michael Porrini,2008,2008,Western Carolina,Southern,16,506,68,190,53,136,15,54,30,48,39,44,83,53,31,6,60,42,181
12840,Logan Power,2016,2019,South Dakota,Summit,71,441,61,123,30,49,31,74,28,38,19,60,79,27,5,1,17,39,181
12841,Brandon Regis,2010,2014,McNeese State,Southland,99,670,65,211,46,122,19,89,32,56,24,45,69,47,34,6,54,62,181
12842,Fred Richardson,2013,2016,Total,Total,58,677,57,150,34,74,23,76,44,56,35,80,115,26,11,1,30,61,181
12843,Desi Sills,2019,2019,Arkansas,SEC,34,582,56,127,26,64,30,63,39,55,13,30,43,57,21,0,54,68,181
12844,Jason Smeathers,2009,2012,Total,Summit,65,742,56,162,27,63,29,99,40,54,23,71,94,47,18,14,39,80,181
12845,Jahlin Smith,2018,2019,Savannah State,MEAC,36,493,67,185,37,69,30,116,17,37,34,84,118,19,18,7,49,66,181
12846,Niko Stojilkovic,2012,2013,North Texas,Sun Belt,63,762,60,159,51,120,9,39,52,83,47,112,159,54,22,6,51,80,181
12847,Isaac Suffren,2019,2019,Lafayette,Patriot,30,520,59,146,49,102,10,44,53,75,18,70,88,34,24,6,38,47,181
12848,Oliver Wells,2012,2014,Central Arkansas,Southland,56,908,67,167,50,118,17,49,30,45,14,67,81,78,31,1,55,75,181
12849,Jeremiah Bailey,2019,2019,Pacific,WCC,31,630,59,156,24,68,35,88,27,37,17,76,93,14,23,4,39,69,180
12850,Atem Bior,2019,2019,Texas-San Antonio,CUSA,32,661,67,139,67,132,0,7,46,64,43,117,160,16,16,13,53,66,180
12851,AJ Farrar,2019,2019,Alabama State,SWAC,21,328,70,116,59,86,11,30,29,46,35,71,106,7,9,10,12,40,180
12852,Jamal Ferguson,2013,2016,Total,Total,64,629,73,162,72,158,1,4,33,51,21,51,72,32,22,6,42,69,180
12853,Bryan Gellineau,2017,2018,Norfolk State,MEAC,49,531,77,125,77,125,0,0,26,47,54,67,121,10,11,18,50,122,180
12854,Sean Hill,2015,2015,Chicago State,WAC,22,547,65,180,44,105,21,75,29,38,11,36,47,46,25,3,43,41,180
12855,Clyde Johnson,2008,2008,Idaho,WAC,27,614,70,165,49,105,21,60,19,35,37,52,89,25,23,20,29,58,180
12856,Travis Jorgenson,2014,2016,Georgia Tech,ACC,62,1059,67,209,41,118,26,91,20,30,6,67,73,168,35,3,81,40,180
12857,Duncan LeXander,2019,2019,Charleston Southern,Big South,34,562,65,174,27,63,38,111,12,24,47,67,114,23,23,3,37,60,180
12858,Vinny Lima,2008,2011,Northeastern,CAA,88,757,63,158,39,93,24,65,30,40,52,75,127,25,17,13,43,104,180
12859,Spencer Littleson,2017,2019,Total,Total,58,792,58,163,8,29,50,134,14,23,23,76,99,46,24,4,30,78,180
12860,Liam McCabe-Moran,2010,2012,Manhattan,MAAC,47,567,55,157,16,44,39,113,31,47,12,53,65,30,23,1,29,60,180
12861,Alan Metcalfe,2008,2008,Vanderbilt,SEC,34,394,66,140,54,113,12,27,36,48,26,51,77,8,9,8,34,60,180
12862,Will Miller,2017,2019,Virginia Military Institute,Southern,77,895,75,156,63,105,12,51,18,37,37,65,102,37,29,13,41,104,180
12863,J'mison Morgan,2009,2013,Total,Total,72,677,74,147,74,147,0,0,32,83,49,74,123,13,20,60,42,119,180
12864,Kevin Morris,2017,2019,South Alabama,Sun Belt,89,678,76,147,76,147,0,0,28,69,62,93,155,15,22,17,44,168,180
12865,Jaxon Myaer,2009,2010,Utah State,WAC,66,633,61,139,29,59,32,80,26,35,2,37,39,47,12,1,59,50,180
12866,Jahlil Nails,2016,2016,Central Connecticut State,NEC,27,535,55,140,21,53,34,87,36,46,9,45,54,12,8,1,28,35,180
12867,Jason Okrzesik,2008,2008,Northwestern,Big Ten,29,548,62,153,29,55,33,98,23,25,5,41,46,46,23,4,24,64,180
12868,Daniel Oliver,2008,2009,North Carolina-Greensboro,Southern,56,742,54,156,34,85,20,71,52,71,15,49,64,86,17,1,100,88,180
12869,James Porter,2008,2010,North Carolina A&T,MEAC,54,844,70,165,70,165,0,0,40,105,75,159,234,23,15,50,63,148,180
12870,Tim Pounds,2008,2008,Colgate,Patriot,31,621,71,156,61,136,10,20,28,40,28,36,64,24,15,5,42,62,180
12871,Jason Preston,2019,2019,Ohio,MAC,30,886,72,166,62,118,10,48,26,34,21,86,107,103,25,3,37,31,180
12872,Dashawn Richmond,2015,2015,Cal State Bakersfield,WAC,29,463,59,147,33,80,26,67,36,50,19,54,73,19,17,3,30,65,180
12873,Diamond Taylor,2011,2013,Southern Illinois,MVC,53,733,61,174,38,101,23,73,35,54,16,55,71,25,6,3,46,46,180
12874,Christian Terrell,2017,2019,UC-Santa Barbara,Big West,75,1216,72,200,64,138,8,62,28,50,47,151,198,105,42,14,68,111,180
12875,Trey Wade,2018,2018,Texas-El Paso,CUSA,25,444,77,160,59,108,18,52,8,24,29,75,104,9,10,23,18,40,180
12876,Bryce Wills,2019,2019,Stanford,Pac-12,30,753,66,155,58,125,8,30,40,72,23,84,107,60,29,17,65,56,180
12877,Frank Wiseler,2010,2011,Drake,MVC,45,891,58,159,33,91,25,68,39,51,7,52,59,108,25,1,65,83,180
12878,Nurudeen Adepoju,2008,2008,Southern Utah,Summit,28,528,62,179,36,87,26,92,29,47,26,50,76,46,17,3,44,51,179
12879,Zach Chionuma,2012,2016,Total,Total,81,576,66,199,38,94,28,105,19,38,14,53,67,6,17,0,27,45,179
12880,Dustin Clarke,2012,2016,Total,Total,60,714,64,209,35,90,29,119,22,30,38,91,129,39,20,3,29,34,179
12881,Austin Colbert,2014,2019,Total,Total,83,776,67,163,57,118,10,45,35,52,56,105,161,18,9,21,37,113,179
12882,Ethan Faulkner,2013,2013,Northern Kentucky,A-Sun,27,872,55,162,34,90,21,72,48,57,13,58,71,89,27,2,50,41,179
12883,Severin Gates,2008,2008,UC-Riverside,Big West,29,444,66,146,56,122,10,24,37,53,28,58,86,21,18,3,38,45,179
12884,Elijah Gonzales,2018,2018,Saint Peter's,MAAC,29,671,68,161,43,92,25,69,18,32,7,57,64,87,46,1,55,48,179
12885,Ejike Hart,2009,2010,New Orleans,Sun Belt,49,1016,63,159,63,159,0,0,53,92,74,157,231,25,18,6,69,154,179
12886,Khari Holloway,2016,2017,Portland State,Big Sky,52,577,54,138,31,73,23,65,48,55,9,38,47,44,16,0,31,46,179
12887,Antoine Hosley,2011,2013,Total,Total,42,536,70,185,47,111,23,74,16,28,5,32,37,25,18,0,38,37,179
12888,Alex Lomax,2019,2019,Memphis,AAC,35,696,60,164,53,130,7,34,52,71,31,69,100,88,35,4,60,60,179
12889,Pedro Maciel,2010,2010,Centenary (LA),Summit,28,631,59,151,31,71,28,80,33,45,5,47,52,84,32,2,55,70,179
12890,Todd McCoy,2008,2008,Indiana State,MVC,31,608,65,153,52,105,13,48,36,47,28,88,116,22,25,5,39,80,179
12891,Peter Moller,2015,2015,Liberty,Big South,25,630,67,159,46,94,21,65,24,35,7,51,58,31,11,0,45,21,179
12892,Max Montana,2018,2018,San Diego State,MWC,26,426,59,152,18,39,41,113,20,28,19,58,77,20,9,4,19,47,179
12893,Malcolm Moore,2012,2014,Total,Total,55,633,65,145,54,111,11,34,38,57,54,80,134,23,9,20,41,104,179
12894,Mike Okauru,2018,2019,Florida,SEC,69,609,64,146,39,75,25,71,26,43,8,48,56,32,26,3,23,65,179
12895,Bobby Planutis,2018,2018,Mount St. Mary's,NEC,32,759,55,116,22,49,33,67,36,40,24,102,126,22,15,20,40,79,179
12896,Cory Starkey,2012,2015,Bucknell,Patriot,63,828,74,150,74,150,0,0,31,50,65,156,221,46,15,13,52,73,179
12897,Donovan Theme-Love,2017,2019,Wofford,Southern,87,901,58,152,23,47,35,105,28,41,3,120,123,127,43,3,62,90,179
12898,Chris Walker,2014,2015,Florida,SEC,49,540,80,146,80,143,0,3,19,51,51,81,132,3,12,44,34,82,179
12899,Aleks Abrams,2015,2019,Total,Total,110,1150,63,158,63,158,0,0,52,84,175,195,370,20,14,52,51,158,178
12900,Daniel Akin,2018,2019,Maryland-Baltimore County,AEC,43,792,68,111,68,111,0,0,42,102,71,106,177,18,17,8,52,95,178
12901,Charoy Bentley,2008,2011,Saint Joseph's,A-10,96,840,64,191,35,85,29,106,21,42,10,58,68,63,23,0,68,75,178
12902,Jamie Boyer,2009,2009,Maryland-Eastern Shore,MEAC,29,661,64,174,25,70,39,104,11,19,16,40,56,30,30,2,40,61,178
12903,Caleb Chowbay,2014,2015,Belmont,OVC,64,735,62,158,36,80,26,78,28,33,7,53,60,67,17,4,60,70,178
12904,Kevin Dorsey,2016,2016,Minnesota,Big Ten,26,484,58,161,50,118,8,43,54,75,11,49,60,37,12,6,36,43,178
12905,Alan Flannigan,2012,2015,Lafayette,Patriot,86,928,65,164,58,140,7,24,41,56,42,119,161,38,22,7,50,128,178
12906,Austin Gillmann,2015,2017,Saint Louis,A-10,73,910,68,160,45,85,23,75,19,35,31,90,121,54,11,27,54,123,178
12907,Cameron Gottfried,2016,2019,Total,Total,56,966,66,149,40,74,26,75,20,29,38,124,162,77,31,14,52,82,178
12908,Michael Green,2019,2019,Mississippi Valley State,SWAC,27,472,66,192,35,103,31,89,15,26,4,37,41,24,12,2,17,27,178
12909,Davin Guinn,2013,2017,Total,Total,61,831,66,181,48,117,18,64,28,46,60,86,146,26,30,5,39,69,178
12910,Rod Henry-Hayes,2018,2019,Northern Illinois,MAC,58,904,65,153,28,52,37,101,11,16,24,52,76,45,22,4,24,99,178
12911,Fred Hinnenkamp,2011,2011,Houston Baptist,GWC,31,616,71,170,55,109,16,61,20,29,22,47,69,23,7,12,28,90,178
12912,Tayvon Jackson,2008,2011,Mount St. Mary's,NEC,106,1086,57,149,57,148,0,1,64,93,85,121,206,29,14,47,39,153,178
12913,Zep Jasper,2019,2019,College of Charleston,CAA,33,835,55,139,19,49,36,90,32,42,12,59,71,42,24,1,25,60,178
12914,Brandon Jawato,2013,2015,Hawaii,Big West,47,542,59,153,13,34,46,119,14,28,4,29,33,16,20,2,24,53,178
12915,Torre Johnson,2008,2008,Milwaukee,Horizon,10,302,68,135,65,122,3,13,39,46,32,48,80,9,15,18,25,21,178
12916,Chim Kadima,2011,2012,Loyola (IL),Horizon,53,864,59,177,38,100,21,77,39,62,19,50,69,34,15,2,49,65,178
12917,P.J. Keaton,2008,2009,Arkansas State,Sun Belt,56,737,65,178,31,76,34,102,14,18,7,40,47,39,13,9,41,50,178
12918,Mikey Manghum,2010,2013,Oral Roberts,Total,81,1237,54,132,10,21,44,111,26,32,14,60,74,99,22,6,52,81,178
12919,Isaiah Moll,2019,2019,Vermont,AEC,33,578,73,185,60,119,13,66,19,34,22,75,97,32,14,4,45,34,178
12920,Jamir Moultrie,2018,2019,La Salle,A-10,37,440,60,156,25,63,35,93,23,31,5,23,28,16,13,0,23,53,178
12921,Matt O'Reilly,2016,2019,Bucknell,Patriot,66,546,59,184,3,7,56,177,4,8,7,18,25,10,11,2,17,52,178
12922,William Pfister,2017,2018,Florida Atlantic,CUSA,61,1309,77,158,77,158,0,0,24,42,136,198,334,54,40,19,65,202,178
12923,Justus Stanback,2014,2015,IUPUI,Summit,63,758,80,185,75,163,5,22,13,22,27,78,105,16,24,13,52,109,178
12924,Jordan Stevens,2015,2015,Duquesne,A-10,20,375,69,186,47,106,22,80,18,26,6,26,32,53,11,2,36,13,178
12925,"Bryan Trimble, Jr.",2018,2019,St. John's (NY),Big East,65,1092,60,174,10,18,50,156,8,9,6,74,80,27,18,11,19,110,178
12926,Matthew Barrow,2008,2008,Lamar,Southland,20,457,67,163,36,59,31,104,12,18,14,42,56,38,24,2,20,50,177
12927,Justin Brown,2009,2010,Cal Poly,Big West,44,574,50,151,37,106,13,45,64,88,6,27,33,39,28,0,58,55,177
12928,Vincent Cordell,2009,2010,Cal State Northridge,Big West,50,693,64,148,49,99,15,49,34,49,44,85,129,18,18,9,36,106,177
12929,Tony Dennison,2009,2009,Hofstra,CAA,31,548,61,197,40,115,21,82,34,58,23,35,58,23,19,7,54,49,177
12930,Jaiveon Eaves,2017,2019,Total,Total,54,534,63,177,29,69,34,108,17,25,8,58,66,28,9,3,23,32,177
12931,Gabriel Gyamfi,2019,2019,Maryland-Eastern Shore,MEAC,32,783,65,108,62,100,3,8,44,61,62,101,163,31,13,11,50,78,177
12932,Darious Hall,2018,2019,Total,Total,36,519,64,128,51,96,13,32,36,64,32,78,110,16,18,8,39,72,177
12933,Andres Ibarguen,2019,2019,Texas-Arlington,Sun Belt,27,638,69,112,69,111,0,1,39,67,82,99,181,17,14,19,42,65,177
12934,Hunter Janacek,2017,2017,Lafayette,Patriot,30,545,54,156,13,35,41,121,28,31,9,48,57,24,12,0,24,33,177
12935,Davon Jones,2010,2013,Jackson State,SWAC,71,724,80,179,80,179,0,0,17,51,41,94,135,14,13,28,55,122,177
12936,Jon Kreft,2011,2012,Florida State,ACC,60,605,67,143,67,143,0,0,43,72,48,91,139,15,14,32,66,99,177
12937,Mike McLain,2008,2010,Air Force,MWC,61,875,66,157,51,97,15,60,30,67,33,101,134,58,26,5,75,115,177
12938,Jordan Miller,2019,2019,George Mason,A-10,17,504,71,116,65,98,6,18,29,47,64,56,120,11,14,13,19,41,177
12939,Jay Reynolds,2011,2012,Presbyterian,Big South,56,901,68,110,68,110,0,0,41,56,45,60,105,8,13,15,41,92,177
12940,Johntavious Rucker,2008,2010,Georgia Southern,Southern,54,828,68,161,64,137,4,24,37,75,61,107,168,77,75,5,66,104,177
12941,Connor Schroeder,2016,2016,Citadel,Southern,30,305,63,175,25,45,38,130,13,21,22,53,75,15,8,2,8,32,177
12942,Jalen Seegars,2018,2019,North Carolina-Asheville,Big South,48,831,54,138,33,76,21,62,48,71,37,83,120,28,25,31,59,98,177
12943,DaJuan Smith,2015,2016,UC-Santa Barbara,Big West,62,786,71,166,67,149,4,17,31,51,34,91,125,67,24,4,42,48,177
12944,Jeremy Smith,2008,2009,Texas-Arlington,Southland,60,975,60,161,46,118,14,43,43,61,18,56,74,145,40,2,116,87,177
12945,Matz Stockman,2015,2019,Total,Total,72,528,72,131,72,131,0,0,33,64,48,79,127,22,9,38,28,87,177
12946,Brad Unger,2008,2008,Harvard,Ivy,22,465,63,141,45,84,18,57,33,39,13,75,88,20,9,3,26,37,177
12947,Andre Washington,2017,2019,Total,Total,52,773,69,123,69,122,0,1,39,69,91,111,202,16,10,12,41,97,177
12948,Sam Watson,2010,2013,Chattanooga,Southern,86,1014,64,131,58,115,6,16,43,83,62,145,207,41,15,19,65,154,177
12949,Dominick Welch,2019,2019,St. Bonaventure,A-10,26,696,62,162,20,47,42,115,11,22,29,81,110,33,14,12,33,40,177
12950,Lewis Witcher,2008,2010,Virginia Tech,ACC,95,947,76,150,76,150,0,0,25,52,72,77,149,9,15,29,34,115,177
12951,Jordan Abdur-Ra'oof,2015,2018,Cornell,Ivy,68,779,65,194,39,100,26,94,20,39,29,85,114,28,29,12,30,92,176
12952,Noe Anabir,2018,2019,Youngstown State,Horizon,54,674,75,127,75,127,0,0,26,47,60,75,135,34,14,26,50,119,176
12953,Shaquille Barber,2010,2012,South Carolina State,MEAC,41,715,70,187,63,150,7,37,29,49,29,55,84,29,15,8,57,62,176
12954,Christian Behrens,2012,2015,University of California,Pac-12,70,772,69,145,69,145,0,0,38,72,47,104,151,13,9,15,28,114,176
12955,Lamont Berzat,2018,2019,New Orleans,Southland,48,746,60,156,33,64,27,92,29,43,7,46,53,89,53,0,51,70,176
12956,Aaron Carver,2017,2019,Old Dominion,CUSA,93,1533,69,185,68,172,1,13,37,80,142,228,370,53,39,48,59,144,176
12957,Taeshon Cherry,2019,2019,Arizona State,Pac-12,30,523,63,161,23,45,40,116,10,14,14,64,78,10,17,7,15,69,176
12958,Joe Dickens,2008,2008,Delaware State,MEAC,26,627,64,161,59,134,5,27,43,57,21,53,74,42,17,5,23,41,176
12959,Chris Edwards,2009,2010,Jacksonville,A-Sun,63,769,62,186,38,109,24,77,28,43,33,60,93,54,26,4,69,66,176
12960,Auston Evans,2016,2019,Lafayette,Patriot,72,868,70,168,67,138,3,30,33,80,18,74,92,41,44,17,67,101,176
12961,Devin Foster,2015,2016,Penn State,Big Ten,50,831,62,128,50,100,12,28,40,67,35,77,112,47,16,2,40,83,176
12962,Grant Jerrett,2013,2013,Arizona,Pac-12,34,606,63,154,31,75,32,79,18,22,37,85,122,18,16,33,19,44,176
12963,Terry Johnson,2010,2012,Total,Total,52,598,57,155,47,114,10,41,52,73,9,45,54,44,27,1,43,52,176
12964,Patrick Kirksey,2014,2015,South Carolina State,MEAC,60,875,62,152,62,151,0,1,52,146,60,128,188,19,31,5,47,83,176
12965,Nikola Knezevic,2008,2010,University of California,Pac-10,84,1020,54,156,34,69,20,87,48,70,16,43,59,94,37,1,70,87,176
12966,Ray Miller,2009,2010,Cal State Fullerton,Big West,44,656,72,117,72,117,0,0,32,60,68,60,128,10,13,33,36,95,176
12967,Emanuel Neto,2008,2008,Stony Brook,AEC,28,758,69,144,69,144,0,0,38,60,70,125,195,9,8,38,57,93,176
12968,Clifton Powell,2017,2018,UC-Santa Barbara,Big West,35,575,69,196,50,140,19,56,19,38,20,50,70,39,15,3,47,58,176
12969,Felix Rivera-Vega,2016,2017,Northern Arizona,Big Sky,40,526,65,143,43,82,22,61,24,52,48,95,143,13,13,2,30,65,176
12970,Danny Rubin,2011,2014,Boston College,ACC,90,832,58,159,8,31,50,128,10,15,19,58,77,26,13,7,27,63,176
12971,Shaun Stewart,2013,2015,Total,Total,44,627,62,179,28,62,34,117,18,26,17,55,72,40,12,4,29,45,176
12972,Tramar Sutherland,2011,2012,Little Rock,Sun Belt,65,709,56,142,52,123,4,19,60,100,63,52,115,28,25,1,30,74,176
12973,Philippe Tchekane Bofia,2008,2008,Maine,AEC,29,519,63,174,44,117,19,57,31,38,23,73,96,25,13,12,45,94,176
12974,Antoine Watson,2010,2010,Florida International,Sun Belt,17,519,57,166,35,83,22,83,40,53,9,51,60,56,24,2,51,50,176
12975,Breyhon Watson,2008,2008,Cleveland State,Horizon,34,854,68,159,51,97,17,62,23,44,13,54,67,46,17,8,44,44,176
12976,Trevion Williams,2019,2019,Purdue,Big Ten,34,349,78,144,77,141,1,3,19,37,61,76,137,18,12,15,19,65,176
12977,Martins Abele,2011,2013,Total,Total,49,561,69,137,69,137,0,0,37,64,65,104,169,7,11,41,66,89,175
12978,Thomas Akyazili,2016,2017,Colorado,Pac-12,63,841,60,191,42,111,18,80,37,59,11,71,82,92,27,11,57,117,175
12979,Jermaine Bishop,2008,2009,Northern Arizona,Big Sky,49,979,66,146,43,85,23,61,20,34,34,81,115,116,70,4,55,71,175
12980,Orlando Brown,2011,2012,Cal State Fullerton,Big West,53,705,56,126,36,73,20,53,43,60,31,82,113,28,15,5,49,80,175
12981,Charlie Burgess,2008,2008,Texas Tech,Big 12,31,687,61,154,50,102,11,52,42,65,23,59,82,63,16,1,45,65,175
12982,Jared Chatham,2018,2019,Central Arkansas,Southland,51,458,65,143,58,115,7,28,38,54,29,68,97,19,11,9,28,56,175
12983,Chidozie Chukwumah,2008,2008,Chicago State,Ind,28,605,76,135,76,135,0,0,23,41,52,79,131,15,9,68,35,76,175
12984,Chris Crockett,2009,2012,Columbia,Ivy,47,455,56,157,8,27,48,130,15,21,5,24,29,29,10,2,34,44,175
12985,Edis Dervisevic,2011,2012,Long Beach State,Big West,56,907,74,147,70,127,4,20,23,52,45,103,148,68,16,24,62,138,175
12986,Jeff Jordan,2008,2012,Total,Total,107,1205,65,162,55,126,10,36,35,60,24,59,83,129,39,5,73,66,175
12987,Javier Lacunza,2013,2016,Florida Atlantic,Total,74,698,58,157,29,63,29,94,30,39,36,70,106,9,11,2,32,91,175
12988,Mikhail Linskens,2008,2009,Wyoming,MWC,51,725,74,163,64,128,10,35,17,38,45,109,154,19,14,39,44,97,175
12989,Ilija Milutinovic,2009,2011,Oakland,Summit,79,555,60,124,47,98,13,26,42,61,34,84,118,24,8,18,37,106,175
12990,Casey Neimeyer,2008,2009,Pacific,Big West,60,550,66,146,46,92,20,54,23,36,25,61,86,13,9,2,23,84,175
12991,Ty Perry,2019,2019,Fordham,A-10,31,426,58,166,19,54,39,112,20,23,10,50,60,14,7,1,17,19,175
12992,Andrew Ramirez,2017,2018,Hartford,AEC,60,723,57,151,39,87,18,64,43,67,15,59,74,54,39,0,59,53,175
12993,J.D. Tisdale,2014,2016,Bowling Green State,MAC,82,980,60,174,57,145,3,29,52,98,39,97,136,67,47,14,95,136,175
12994,Raphelle Turner,2008,2008,Louisiana-Monroe,Sun Belt,29,480,59,102,59,102,0,0,57,79,41,90,131,1,14,29,41,72,175
12995,Arminas Urbutis,2008,2009,Hofstra,CAA,51,739,61,146,61,145,0,1,53,73,77,126,203,5,13,14,49,100,175
12996,Jon Ziri,2008,2008,Loyola Marymount,WCC,30,563,63,177,50,120,13,57,36,58,37,105,142,50,54,10,69,65,175
12997,Miles Asafo-Adjei,2010,2013,Cornell,Ivy,90,1255,63,178,56,144,7,34,41,84,32,68,100,142,32,1,75,127,174
12998,Bob Belivacqua,2008,2009,Canisius,MAAC,44,738,55,162,12,30,43,132,21,28,15,36,51,42,28,4,41,46,174
12999,Kris Brown,2010,2013,Norfolk State,MEAC,74,776,64,172,44,105,20,67,26,50,32,56,88,44,30,8,53,88,174
13000,Pierre Brown,2008,2010,Mount St. Mary's,NEC,68,631,65,149,44,102,21,47,23,36,24,68,92,33,7,5,56,50,174
13001,Troy Cage,2008,2011,Total,Total,53,531,58,177,37,100,21,77,37,58,37,80,117,35,21,9,51,37,174
13002,Jonathan Cruz,2010,2010,Quinnipiac,NEC,33,664,77,151,77,149,0,2,20,39,59,90,149,22,13,9,49,82,174
13003,Gene Davis,2018,2019,Alabama State,SWAC,47,831,56,158,35,86,21,72,41,48,14,60,74,99,15,1,95,78,174
13004,Indiana Faithfull,2013,2014,Wofford,Southern,52,1097,57,167,37,101,20,66,40,50,9,116,125,150,39,9,87,104,174
13005,Andrew Fishler,2016,2017,Mercer,Southern,61,505,69,134,69,134,0,0,36,65,38,76,114,7,3,46,25,69,174
13006,Emmanuel Gaiter,2008,2009,Tennessee State,OVC,32,500,66,134,65,127,1,7,41,62,26,31,57,16,11,1,33,21,174
13007,Christian Gore,2012,2015,Total,Total,60,760,46,135,23,70,23,65,59,85,18,79,97,43,21,3,41,68,174
13008,Kurt Graeber,2008,2009,Dartmouth,Ivy,50,765,73,164,73,164,0,0,28,82,72,97,169,15,12,25,59,100,174
13009,Henry Harris,2008,2009,Belmont,A-Sun,60,806,55,156,36,87,19,69,45,73,42,55,97,53,42,3,61,87,174
13010,Cavit Havsa,2017,2018,Fordham,A-10,49,1013,68,148,51,83,17,65,21,29,17,59,76,118,41,6,62,62,174
13011,Schnider Herard,2017,2018,Mississippi State,SEC,43,683,60,117,60,117,0,0,54,110,69,113,182,7,3,16,59,80,174
13012,Joe Kuligoski,2014,2017,Total,OVC,89,933,63,159,44,84,19,75,29,47,64,119,183,50,21,14,35,127,174
13013,Emmitt Matthews Jr.,2019,2019,West Virginia,Big 12,32,527,61,149,47,91,14,58,38,47,48,51,99,20,16,7,28,28,174
13014,Riley Maye,2011,2014,Norfolk State,MEAC,68,558,74,141,65,122,9,19,17,29,19,36,55,14,5,13,30,95,174
13015,Jason Ridenhour,2008,2009,North Carolina-Asheville,Big South,45,708,68,153,47,92,21,61,17,41,40,76,116,34,29,12,57,78,174
13016,Tom Schalk,2012,2015,William & Mary,CAA,86,848,70,129,68,118,2,11,32,47,64,100,164,41,17,34,40,107,174
13017,Boris Siakam,2008,2008,Western Kentucky,Sun Belt,36,658,55,102,54,95,1,7,63,90,66,73,139,20,13,4,51,72,174
13018,KeDorian Sullivan,2012,2012,Alcorn State,SWAC,31,633,68,140,67,136,1,4,37,62,43,92,135,11,16,20,27,90,174
13019,Josh Swan,2012,2013,Southern Illinois,MVC,43,771,59,160,55,133,4,27,52,97,30,76,106,36,26,4,52,70,174
13020,Antonio Topps,2008,2011,Texas A&M-Corpus Christi,Southland,84,755,58,197,12,35,46,162,12,15,15,33,48,33,14,1,35,62,174
13021,Kris Wooten,2019,2019,Elon,CAA,32,649,64,173,21,46,43,127,3,6,10,44,54,38,9,5,25,23,174
13022,Hameir Wright,2018,2019,Washington,Pac-12,65,1064,60,191,36,96,24,95,30,56,38,126,164,49,31,82,58,156,174
13023,Keenen Anderson,2013,2015,Eastern Illinois,OVC,80,815,67,118,67,118,0,0,39,86,74,70,144,18,23,28,49,124,173
13024,Tony Anderson,2008,2009,Furman,Southern,59,1064,60,209,41,103,19,106,34,51,14,67,81,142,16,0,92,93,173
13025,Justin Ayers,2010,2011,Nicholls State,Southland,52,708,63,157,43,89,20,68,27,43,28,44,72,34,25,2,28,102,173
13026,Marcus Bradley,2012,2015,Total,Total,48,399,75,177,70,150,5,27,18,38,25,46,71,8,5,18,20,73,173
13027,Antonio Cowart Jr,2019,2019,Ohio,MAC,31,812,64,173,34,69,30,104,15,22,20,84,104,53,25,4,60,62,173
13028,Ty Greer,2017,2017,Hofstra,CAA,31,549,63,158,45,104,18,54,29,45,45,84,129,27,13,7,39,53,173
13029,Kyle Jackson,2008,2009,Saint Francis (PA),NEC,47,654,58,121,43,87,15,34,42,51,30,67,97,33,25,7,46,80,173
13030,Tavon King,2019,2019,North Alabama,A-Sun,32,563,54,134,39,79,15,55,50,76,9,24,33,29,19,3,36,65,173
13031,Jermaine Lawrence,2014,2015,Total,Total,47,667,69,183,67,167,2,16,33,68,43,68,111,15,16,32,57,92,173
13032,Stephen Lennox,2016,2017,Idaho State,Big Sky,58,735,52,131,37,77,15,54,54,76,27,111,138,19,9,16,34,86,173
13033,Tobias Mahone,2008,2009,Bethune-Cookman,MEAC,43,600,66,155,34,62,32,93,9,20,41,89,130,7,22,5,27,73,173
13034,Pat McNamara,2016,2019,Total,Total,72,651,59,151,10,25,49,126,6,11,8,34,42,29,21,2,21,31,173
13035,Aaron Nettles,2018,2019,Seattle,WAC,61,611,54,123,12,20,42,103,23,31,6,33,39,21,22,0,23,60,173
13036,Jordan Smith,2014,2014,South Carolina State,MEAC,29,419,59,178,22,52,37,126,18,21,8,23,31,13,6,1,24,24,173
13037,Zech Smith,2014,2015,Total,Total,43,817,72,134,72,134,0,0,29,63,112,125,237,4,10,56,38,81,173
13038,Damir Suljagic,2008,2009,Texas Tech,Big 12,49,666,74,139,74,139,0,0,25,44,34,100,134,24,15,16,42,88,173
13039,Ilias Theodorou,2015,2017,Pacific,WCC,49,483,62,143,28,57,34,86,15,26,27,61,88,16,5,10,34,62,173
13040,Marvin Williams,2008,2008,Murray State,OVC,31,565,68,131,66,124,2,7,35,52,54,101,155,19,15,19,35,71,173
13041,Cedrick Alley Jr,2018,2019,Houston,AAC,39,677,56,163,25,45,31,118,29,38,36,74,110,27,17,9,26,45,172
13042,Karl Anderson,2008,2008,Quinnipiac,NEC,24,537,71,124,71,124,0,0,30,53,56,73,129,22,19,13,41,87,172
13043,Bak Bak,2010,2013,University of California,Total,89,638,68,149,68,143,0,6,36,51,48,109,157,4,17,17,38,73,172
13044,Chris Baldwin,2017,2019,Total,Total,54,651,71,163,55,112,16,51,14,23,52,124,176,22,11,25,42,97,172
13045,Peter Boehm,2009,2009,Harvard,Ivy,28,670,56,155,12,32,44,123,16,19,8,44,52,32,12,2,35,64,172
13046,Robert Boezeman,2015,2016,UC-Riverside,Big West,58,680,61,139,34,71,27,68,23,38,34,72,106,13,11,12,35,95,172
13047,David Bottenberg,2017,2019,South Carolina State,MEAC,84,789,56,144,54,129,2,15,58,77,53,77,130,22,9,12,30,115,172
13048,Aramie Brooks,2009,2010,Northwestern State,Southland,55,540,70,158,70,157,0,1,32,73,52,77,129,20,23,18,40,60,172
13049,Curtis Brown,2008,2009,Savannah State,Ind,36,420,66,171,48,107,18,64,22,34,20,36,56,19,28,3,42,52,172
13050,John Cannon,2012,2016,Total,Total,77,480,73,140,73,138,0,2,26,34,37,70,107,7,7,29,30,54,172
13051,Preston David,2008,2011,McNeese State,Southland,86,834,71,143,71,143,0,0,30,60,68,100,168,11,24,66,38,146,172
13052,Jabari Edwards,2008,2012,George Washington,A-10,92,1206,76,154,76,154,0,0,20,55,109,149,258,23,25,114,45,154,172
13053,Adrian Forbes,2011,2012,Auburn,SEC,57,860,65,136,65,136,0,0,42,73,74,88,162,8,16,34,47,134,172
13054,Louis Garrett,2013,2013,San Jose State,WAC,25,512,60,170,38,94,22,76,30,42,23,35,58,22,18,5,34,39,172
13055,Brian Gettinger,2008,2008,Missouri-Kansas City,Summit,31,571,56,161,16,54,40,107,20,31,34,49,83,30,13,21,29,87,172
13056,Raymond Hicks,2008,2008,Miami (FL),ACC,34,598,67,141,63,126,4,15,34,45,49,62,111,24,18,11,36,80,172
13057,Payton Hulsey,2016,2016,College of Charleston,CAA,31,891,71,155,69,144,2,11,28,53,45,131,176,103,55,5,45,79,172
13058,Brandon Hutton,2018,2019,Northwestern State,Southland,55,778,61,188,53,154,8,34,42,73,46,60,106,31,37,22,86,126,172
13059,Jay Johnson,2015,2015,Marshall,CUSA,32,508,61,179,31,68,30,111,20,45,37,80,117,18,14,9,34,72,172
13060,Wesley Jones,2008,2009,Total,Total,20,485,66,148,50,102,16,46,24,33,28,90,118,19,14,2,25,43,172
13061,Lance Kearse,2008,2009,Virginia Commonwealth,CAA,42,439,58,120,33,70,25,50,31,44,30,42,72,12,17,7,30,64,172
13062,Sean McCarthy,2010,2013,NJIT,GWC,79,925,74,179,74,179,0,0,24,61,94,191,285,15,11,64,68,158,172
13063,Donte Medder,2010,2012,Tulsa,CUSA,41,478,50,128,17,36,33,92,39,59,2,32,34,37,19,1,51,65,172
13064,Jon Mesghna,2013,2013,Maine,AEC,26,655,55,140,14,33,41,107,21,33,11,73,84,30,10,1,30,50,172
13065,Mark Parker,2011,2013,Longwood,Total,56,444,59,133,10,28,49,105,5,10,6,39,45,16,13,5,25,22,172
13066,Jalen Richard,2014,2015,Santa Clara,WCC,62,802,57,160,39,91,18,69,40,62,22,97,119,58,25,3,46,72,172
13067,Jose Rivera,2011,2011,Pacific,Big West,31,711,55,140,6,17,49,123,13,17,7,36,43,54,10,1,28,30,172
13068,Josue Salaam,2016,2017,Bethune-Cookman,MEAC,48,576,60,170,16,41,44,129,8,12,18,59,77,22,14,3,16,56,172
13069,Ajare Sanni,2019,2019,Pacific,WCC,20,413,58,155,29,81,29,74,27,38,4,24,28,23,13,1,18,19,172
13070,Jeff Smith,2008,2011,Chattanooga,Southern,84,585,59,163,37,82,22,81,32,62,18,49,67,23,6,4,50,79,172
13071,Josh Smith,2013,2016,Clemson,ACC,104,882,65,154,62,143,3,11,39,64,69,145,214,11,15,14,48,101,172
13072,Chris Vogt,2018,2019,Northern Kentucky,Horizon,48,492,70,121,70,121,0,0,32,84,47,91,138,23,12,46,38,95,172
13073,Patrick Zeck,2017,2018,Gardner-Webb,Big South,46,734,67,114,63,102,4,12,34,45,53,108,161,21,21,23,24,107,172
13074,Chris Alvarez,2008,2009,Northeastern,CAA,59,1141,56,146,52,126,4,20,55,85,63,133,196,67,57,26,70,141,171
13075,Taj Benning,2018,2019,Fairfield,MAAC,53,897,57,158,37,97,20,61,37,49,22,83,105,68,22,8,52,87,171
13076,Sean Berry,2010,2010,Maryland-Eastern Shore,MEAC,29,507,60,145,60,145,0,0,51,90,56,108,164,7,10,15,49,88,171
13077,Elisha Boone,2015,2016,Saint Peter's,MAAC,52,629,74,156,71,145,3,11,20,54,50,104,154,24,13,18,44,61,171
13078,Arturs Bremers,2015,2016,North Carolina A&T,MEAC,48,763,52,166,2,12,50,154,17,19,13,47,60,34,11,1,36,42,171
13079,Kamil Chapman,2018,2019,Longwood,Big South,47,527,49,166,16,43,33,123,40,49,3,45,48,21,21,0,37,56,171
13080,Jared Cunningham,2010,2010,Cleveland State,Horizon,33,487,61,162,36,86,25,76,24,32,22,64,86,14,14,12,22,69,171
13081,Amedeo Della Valle,2013,2014,Ohio State,Big Ten,48,501,54,153,20,53,34,100,29,46,22,58,80,10,11,14,27,40,171
13082,Mladen Djordjevic,2016,2018,San Francisco,WCC,70,941,63,160,36,79,27,81,18,43,6,92,98,95,33,4,62,99,171
13083,Spencer Eliason,2016,2018,North Dakota State,Summit,62,740,73,136,73,136,0,0,25,54,68,79,147,25,12,13,38,109,171
13084,Michael Giovacchini,2008,2008,Dartmouth,Ivy,28,655,54,146,26,64,28,82,35,48,5,47,52,59,12,1,27,43,171
13085,John Ross Glover,2013,2016,Total,Total,62,488,62,155,51,122,11,33,36,55,38,46,84,21,9,5,42,46,171
13086,Quentin Jackson,2017,2019,Total,Total,40,547,65,166,57,127,8,39,33,51,8,50,58,38,26,11,39,66,171
13087,Herdie Lawrence,2012,2013,Austin Peay,OVC,57,715,54,166,30,63,24,103,39,60,12,45,57,75,27,6,102,91,171
13088,Elijah Mays,2016,2017,Florida A&M,MEAC,29,652,62,173,45,110,17,63,30,43,14,48,62,90,27,1,34,57,171
13089,Ivan Peljusic,2008,2011,Northwestern,Big Ten,80,674,70,166,58,125,12,41,19,41,39,91,130,62,18,15,53,71,171
13090,Jacob Perry,2016,2016,Alabama A&M,SWAC,27,431,49,126,30,58,19,68,54,77,8,21,29,43,8,0,35,52,171
13091,Matija Poscic,2008,2009,DePaul,Big East,59,912,66,139,64,126,2,13,37,52,58,112,170,21,9,30,43,127,171
13092,Everest Schmidt,2008,2008,Lafayette,Patriot,30,575,68,146,68,144,0,2,35,65,61,52,113,27,28,18,53,82,171
13093,Darren Smith,2008,2011,Pennsylvania,Ivy,42,670,56,183,21,60,35,123,24,32,8,33,41,30,13,2,48,63,171
13094,Austin Sparks,2015,2018,South Dakota,Summit,93,795,67,108,67,108,0,0,37,54,52,70,122,19,9,16,49,106,171
13095,Cam Thoroughman,2008,2011,West Virginia,Big East,117,1315,57,130,57,126,0,4,57,105,135,135,270,120,37,17,75,225,171
13096,Andrew Van Nest,2010,2013,Total,Total,64,622,61,160,36,71,25,89,24,30,24,74,98,21,11,17,36,95,171
13097,Dallas Walton,2018,2018,Colorado,Pac-12,30,557,70,152,65,139,5,13,26,37,27,75,102,21,7,34,28,59,171
13098,Ralph Watts,2011,2012,Albany (NY),AEC,61,969,58,156,37,93,21,63,34,61,29,82,111,80,22,6,60,73,171
13099,Onyekawtuke Abiakam,2008,2010,Texas Southern,SWAC,58,820,74,149,74,149,0,0,22,47,63,125,188,15,18,64,40,105,170
13100,Ivan Benkovic,2013,2015,Charlotte,Total,57,569,52,138,4,14,48,124,18,28,11,39,50,17,11,3,19,74,170
13101,Jordan Brooks,2008,2010,Hampton,MEAC,75,1147,53,205,36,118,17,87,47,86,31,87,118,168,70,0,110,87,170
13102,Brawley Chisholm,2009,2010,Ball State,MAC,50,688,55,161,29,72,26,89,34,40,2,49,51,55,12,1,45,46,170
13103,Eric Cobb,2016,2019,Total,Total,71,655,73,143,70,137,3,6,21,67,74,132,206,23,9,9,56,95,170
13104,Tony Dukes,2011,2011,South Carolina Upstate,A-Sun,30,613,58,189,22,72,36,117,18,33,19,35,54,26,12,2,45,61,170
13105,Luke Engelken,2010,2011,Gardner-Webb,Big South,43,656,62,187,25,47,37,140,9,13,26,65,91,41,25,9,53,66,170
13106,Jaylon Floyd,2012,2015,Arkansas-Pine Bluff,SWAC,117,1085,67,138,65,129,2,9,34,65,62,110,172,14,25,20,60,142,170
13107,De'Shaune Griffin,2008,2008,Iona,MAAC,32,723,58,175,26,72,32,103,22,38,17,59,76,72,31,1,65,51,170
13108,Jonas Harper,2019,2019,Boston University,Patriot,33,502,63,132,29,59,34,73,10,13,12,35,47,17,22,4,30,48,170
13109,Damian Henderson,2008,2009,Texas Southern,SWAC,51,556,75,133,70,118,5,15,15,31,30,41,71,15,19,5,42,49,170
13110,Marlon Louzeiro,2011,2012,Little Rock,Sun Belt,61,638,68,135,65,130,3,5,31,57,42,80,122,13,11,9,32,105,170
13111,Kevin Loyd,2009,2010,Grambling,SWAC,52,1107,62,166,44,101,18,65,28,38,18,106,124,106,32,1,72,66,170
13112,Aaron Martin,2012,2012,South Carolina State,MEAC,30,622,44,164,17,59,27,105,55,78,30,86,116,29,19,7,41,53,170
13113,Caleb McConnell,2019,2019,Rutgers,Big Ten,31,481,54,130,34,74,20,56,42,53,16,63,79,32,26,4,37,41,170
13114,Dera Nd-Ezuma,2010,2013,Rider,MAAC,96,753,73,149,73,148,0,1,24,42,48,78,126,20,20,51,50,125,170
13115,Nedim Pajevic,2008,2008,UC-Santa Barbara,Big West,32,596,66,143,63,125,3,18,35,42,35,85,120,57,17,12,47,69,170
13116,Walter Sharpe,2008,2008,Alabama-Birmingham,CUSA,12,299,68,130,68,127,0,3,34,65,22,60,82,20,14,22,34,36,170
13117,Miles Simelton,2014,2015,Lehigh,Patriot,62,747,63,167,42,99,21,68,23,31,9,44,53,60,28,5,49,63,170
13118,Johnny Stephene,2009,2010,Liberty,Big South,55,636,52,118,39,80,13,38,53,76,22,38,60,60,19,0,64,55,170
13119,Andrew Taylor,2009,2011,Xavier,A-10,75,705,65,109,64,106,1,3,39,59,52,74,126,22,20,10,27,134,170
13120,Maurice Taylor,2016,2017,Niagara,MAAC,65,829,63,125,60,118,3,7,41,86,91,144,235,11,20,18,67,138,170
13121,Justin Watts,2009,2012,North Carolina,ACC,122,815,63,171,51,129,12,42,32,70,58,96,154,49,19,16,50,73,170
13122,Aaron Wheeler,2019,2019,Purdue,Big Ten,36,495,60,134,29,49,31,85,19,31,34,75,109,15,21,17,24,64,170
13123,Raymond Bethea Jr.,2019,2019,Howard,MEAC,33,393,58,156,27,67,31,89,22,34,10,28,38,28,18,3,22,36,169
13124,Christian Beyer,2013,2015,Virginia Tech,ACC,76,835,69,126,64,108,5,18,26,44,67,142,209,25,18,7,38,71,169
13125,Delundre Dixon,2016,2017,Chicago State,WAC,50,850,55,144,41,86,14,58,45,68,24,64,88,59,24,6,53,81,169
13126,Eyimofe Edukugho,2014,2016,Sacred Heart,NEC,44,473,69,140,69,140,0,0,31,65,42,59,101,11,10,17,46,90,169
13127,Nick Holmes,2008,2008,Yale,Ivy,27,669,55,151,22,59,33,92,26,34,18,67,85,51,25,8,37,59,169
13128,Dau Jok,2011,2014,Pennsylvania,Ivy,81,668,51,166,11,26,40,140,27,34,24,80,104,17,5,3,20,76,169
13129,Sam Mitchell,2008,2009,Tulsa,CUSA,75,991,56,106,56,106,0,0,57,87,78,112,190,16,16,13,63,147,169
13130,Lamont Morgan,2009,2010,Brigham Young,MWC,59,772,60,119,37,72,23,47,26,41,11,50,61,97,22,2,63,52,169
13131,Nelson Phillips,2019,2019,Georgia State,Sun Belt,33,431,65,119,59,102,6,17,33,55,48,61,109,16,24,5,25,27,169
13132,Satchel Pierce,2015,2018,Total,Total,75,725,62,134,62,133,0,1,45,71,60,79,139,23,12,32,67,146,169
13133,Jeff Powers,2011,2014,University of California,Total,75,498,56,141,19,47,37,94,20,28,11,25,36,19,2,0,20,36,169
13134,Hunter Rhodes,2017,2018,Northern Iowa,MVC,44,667,50,135,19,51,31,84,38,42,3,57,60,48,16,1,12,48,169
13135,Rico Sanders,2011,2014,Total,Total,49,557,60,176,25,63,35,113,14,18,5,23,28,20,25,3,21,53,169
13136,Barry Smith,2011,2014,Total,Total,35,581,58,147,53,129,5,18,48,71,42,59,101,20,18,11,38,51,169
13137,Justin Steers,2019,2019,Coppin State,MEAC,28,370,63,119,58,99,5,20,38,66,44,44,88,11,17,25,30,64,169
13138,Matt Szalachowski,2008,2009,Lehigh,Patriot,52,989,61,138,38,68,23,70,24,35,11,62,73,56,17,2,41,74,169
13139,Mike Walker,2008,2008,Penn State,Big Ten,31,511,59,154,17,34,42,120,9,17,5,12,17,34,7,3,14,21,169
13140,Donte Watson,2017,2018,North Carolina A&T,MEAC,32,484,65,134,45,74,20,60,19,23,7,71,78,27,13,3,32,27,169
13141,Matt Wheaton,2008,2008,Tulane,CUSA,32,774,47,128,23,60,24,68,51,67,22,69,91,48,15,12,47,72,169
13142,Justin Williams,2017,2019,George Washington,A-10,59,695,68,132,61,110,7,22,26,36,57,90,147,21,24,11,15,52,169
13143,Tyler Wood,2011,2014,Texas-San Antonio,Total,102,945,56,152,26,51,30,101,27,43,44,84,128,34,22,19,36,98,169
13144,Najeal Young,2016,2016,Illinois-Chicago,Horizon,27,622,67,150,67,147,0,3,35,57,50,120,170,23,21,4,41,50,169
13145,Girod Adams,2009,2009,Stephen F. Austin,Southland,32,630,53,142,25,60,28,82,34,44,5,44,49,51,22,4,45,64,168
13146,Wheeler Baker,2015,2015,Albany (NY),AEC,30,417,56,143,21,50,35,93,21,29,5,37,42,11,10,3,27,39,168
13147,Danny Brown,2008,2008,Saint Louis,A-10,24,485,54,112,29,61,25,51,35,48,17,52,69,30,7,8,18,40,168
13148,Willis Brownlee,2011,2011,Alcorn State,SWAC,28,536,56,138,46,109,10,29,46,73,19,61,80,28,23,7,46,37,168
13149,Alex Davis,2009,2009,Tennessee Tech,OVC,28,463,67,184,48,122,19,62,15,25,21,52,73,9,12,14,29,37,168
13150,Mike Davis,2015,2015,Alcorn State,SWAC,26,632,60,151,49,122,11,29,37,47,22,35,57,42,29,1,37,39,168
13151,Dimitri Floras,2015,2016,Quinnipiac,MAAC,55,701,55,211,24,100,31,111,27,41,34,53,87,78,24,0,48,78,168
13152,Vincent Garrett,2013,2014,Total,Total,36,425,60,147,44,112,16,35,32,43,25,52,77,35,8,11,31,57,168
13153,Clayton Graham,2012,2014,Colgate,Patriot,68,768,66,105,66,105,0,0,36,53,52,105,157,45,13,16,33,116,168
13154,Jerrel Green,2008,2008,Morgan State,MEAC,30,858,43,148,36,102,7,46,75,122,13,47,60,112,35,1,67,67,168
13155,Van Green,2011,2015,Total,Total,69,762,61,157,42,94,19,63,27,41,26,89,115,27,27,15,42,55,168
13156,Michael Hurt,2017,2019,Minnesota,Big Ten,85,974,58,136,46,88,12,48,40,57,28,99,127,43,13,17,38,64,168
13157,Enrique Mason,2011,2012,Texas-Rio Grande Valley,GWC,53,676,65,155,65,155,0,0,38,56,51,88,139,16,15,23,37,124,168
13158,Justyn Mutts,2018,2018,High Point,Big South,28,568,71,132,71,131,0,1,26,46,38,74,112,39,30,32,42,86,168
13159,RJ Nembhard,2018,2019,Texas Christian,Big 12,42,653,56,162,33,80,23,82,33,56,7,76,83,36,19,15,50,45,168
13160,Josh Nicholas,2018,2018,St. Francis (NY),NEC,31,597,58,148,29,72,29,76,23,38,23,43,66,26,27,11,29,77,168
13161,Ben Shungu,2018,2019,Vermont,AEC,55,754,57,106,41,76,16,30,38,59,26,91,117,52,23,6,43,83,168
13162,Terry Tidwell,2010,2014,Total,Total,44,565,70,125,70,124,0,1,28,60,42,77,119,10,12,13,52,81,168
13163,Kenneth Willingham,2008,2008,North Texas,Sun Belt,19,368,56,120,24,47,32,73,24,29,5,24,29,32,13,0,24,15,168
13164,A.J. Banks,2019,2019,Wyoming,MWC,32,761,57,113,46,79,11,34,42,57,10,82,92,49,30,13,51,44,167
13165,Jamal Bieniemy,2019,2019,Oklahoma,Big 12,34,861,63,161,36,94,27,67,14,22,11,71,82,119,47,6,47,62,167
13166,Isaiah Burke,2019,2019,Morgan State,MEAC,18,357,54,140,27,67,27,73,32,46,7,16,23,11,18,1,26,29,167
13167,Quron Davis,2014,2016,Chicago State,WAC,60,762,63,142,63,142,0,0,41,76,63,98,161,17,11,30,46,122,167
13168,Jabari Deshields,2008,2011,Alabama A&M,SWAC,83,949,51,179,39,135,12,44,53,90,31,74,105,113,60,6,135,116,167
13169,Koh Flippin,2016,2018,UC-Riverside,Big West,49,558,51,140,18,46,33,94,32,45,17,47,64,44,45,8,24,65,167
13170,Marcus Hammonds,2009,2010,Texas A&M-Corpus Christi,Southland,64,865,63,145,43,91,20,54,21,39,38,102,140,45,26,12,60,80,167
13171,C.J. Lee,2008,2009,Michigan,Big Ten,67,938,56,149,24,52,32,97,23,34,21,90,111,99,43,0,44,110,167
13172,Brandon Martin,2019,2019,South Carolina Upstate,Big South,30,422,68,132,67,124,1,8,30,43,36,39,75,12,17,10,26,31,167
13173,Gabriel Moton,2011,2012,Boston College,ACC,63,958,61,152,35,69,26,83,19,34,19,73,92,63,30,4,58,107,167
13174,Ludovic Ndaye,2011,2014,Cleveland State,Horizon,94,880,67,161,63,143,4,18,29,54,57,96,153,11,20,39,32,166,167
13175,Jalen Ragland,2012,2014,Texas-El Paso,CUSA,52,666,53,196,21,70,32,126,29,33,7,28,35,26,9,3,19,26,167
13176,Fabio Ribero,2011,2012,Louisiana-Monroe,Sun Belt,51,840,68,163,67,161,1,2,30,62,52,97,149,12,14,10,57,98,167
13177,David Singleton,2019,2019,UCLA,Pac-12,32,559,53,118,18,43,35,75,26,38,3,36,39,33,17,5,12,33,167
13178,Keeslee Stewart,2012,2013,Jackson State,SWAC,55,792,60,215,32,123,28,92,19,34,20,48,68,57,23,2,65,70,167
13179,Seventh Woods,2017,2019,North Carolina,ACC,94,815,57,164,51,139,6,25,47,74,11,91,102,140,57,7,105,88,167
13180,Johnathan Ball,2008,2008,Dartmouth,Ivy,25,572,68,138,68,136,0,2,30,50,36,93,129,44,28,8,47,79,166
13181,Adam Barnes,2010,2013,Belmont,Total,111,665,61,118,54,103,7,15,37,57,28,53,81,48,22,5,37,60,166
13182,Brandon Brown,2008,2009,Idaho,WAC,37,520,66,160,60,133,6,27,28,39,31,34,65,26,13,2,55,60,166
13183,Garrett Butcher,2009,2012,Butler,Horizon,122,857,67,188,55,145,12,43,20,35,58,77,135,19,14,4,29,112,166
13184,Chad Calcaterra,2012,2015,Total,Total,64,620,66,121,66,121,0,0,34,61,42,65,107,5,7,18,31,82,166
13185,John Crnogorac,2018,2019,Texas-Rio Grande Valley,WAC,63,579,70,157,65,140,5,17,21,33,41,76,117,8,13,34,40,83,166
13186,Michael Fakuade,2009,2010,Northern Illinois,MAC,50,571,59,129,56,118,3,11,45,90,73,77,150,18,12,48,38,97,166
13187,Trevon Faulkner,2019,2019,Northern Kentucky,Horizon,35,715,68,115,59,89,9,26,21,37,40,49,89,39,17,12,33,84,166
13188,Nahshon George,2015,2016,Idaho,Big Sky,47,589,61,142,61,141,0,1,44,67,63,113,176,16,15,5,68,110,166
13189,Brennan Gillis,2016,2017,Northern Kentucky,Horizon,64,571,60,133,47,100,13,33,33,52,46,63,109,28,15,16,55,102,166
13190,Johnny Griffin,2014,2015,Chicago State,WAC,62,916,61,130,60,116,1,14,43,76,69,95,164,20,47,31,25,129,166
13191,Jairus Hamilton,2019,2019,Boston College,ACC,30,625,59,147,39,80,20,67,28,43,34,86,120,23,8,5,51,60,166
13192,Kendale Hampton,2019,2019,Youngstown State,Horizon,28,325,55,138,17,37,38,101,18,24,12,41,53,15,10,2,11,27,166
13193,Richard Henderson,2018,2019,Austin Peay,OVC,59,511,68,130,68,130,0,0,30,66,43,73,116,12,13,21,34,68,166
13194,Chris Kemp,2014,2015,Montana,Big Sky,57,553,70,118,70,118,0,0,26,49,44,65,109,6,12,9,35,99,166
13195,Nolan Long,2014,2015,Wagner,NEC,49,487,64,114,64,114,0,0,38,54,55,93,148,1,8,23,30,102,166
13196,Wyatt Lowell,2019,2019,Utah Valley,WAC,35,547,59,140,18,32,41,108,7,10,12,82,94,17,15,6,31,70,166
13197,J.R. Lynch,2016,2016,Hartford,AEC,32,620,55,128,32,60,23,68,33,44,6,43,49,34,24,1,26,74,166
13198,Mathis Monninghoff,2011,2012,Gonzaga,WCC,53,535,55,134,10,24,45,110,11,16,16,42,58,19,5,4,18,41,166
13199,Sammy Obetoh,2009,2011,Total,Total,37,520,61,168,59,154,2,14,42,118,41,71,112,15,12,13,56,37,166
13200,Cody Riley,2019,2019,UCLA,Pac-12,30,524,63,133,57,113,6,20,34,65,27,97,124,20,8,13,43,69,166
13201,Dontelius Ross,2018,2019,Jackson State,SWAC,32,943,44,169,16,49,28,120,50,64,12,71,83,98,27,3,67,77,166
13202,Charles Ruise Jr.,2016,2017,Purdue-Fort Wayne,Summit,56,481,64,166,51,109,13,57,25,35,13,60,73,27,9,3,24,61,166
13203,Linden Smith-Hyde,2012,2013,Nicholls State,Southland,49,849,60,160,31,63,29,97,17,28,36,60,96,25,18,4,35,61,166
13204,Garrett Sturtz,2019,2019,Drake,MVC,31,565,57,107,50,84,7,23,45,56,15,65,80,33,23,4,32,49,166
13205,Chris Atkinson,2016,2017,Canisius,MAAC,55,734,51,184,18,59,33,125,30,40,3,54,57,87,35,1,38,74,165
13206,Julian Betko,2008,2008,Butler,Horizon,34,747,54,144,10,30,44,114,13,22,23,58,81,34,27,3,29,70,165
13207,Nik Brown,2013,2013,Longwood,Big South,17,475,56,167,47,120,9,47,44,64,11,39,50,62,20,2,67,49,165
13208,Chris Collinsworth,2008,2012,Brigham Young,Total,46,716,58,153,51,111,7,42,42,78,63,157,220,32,13,15,43,72,165
13209,Gemaal Davis,2018,2018,Mississippi Valley State,SWAC,31,416,55,152,47,129,8,23,47,67,28,47,75,15,12,1,24,25,165
13210,Cheickna Dembele,2017,2019,Nevada-Las Vegas,MWC,62,787,60,134,60,134,0,0,45,92,85,94,179,18,10,51,64,96,165
13211,Josh Elbaum,2011,2014,Vermont,AEC,125,1322,60,122,59,115,1,7,44,89,39,104,143,123,88,5,97,127,165
13212,Charlie Enquist,2009,2012,Washington State,Total,86,791,59,99,59,99,0,0,47,65,54,110,164,13,17,27,28,92,165
13213,Trevor Ferguson,2008,2009,North Carolina State,ACC,36,608,54,137,17,37,37,100,20,26,8,39,47,36,12,5,26,46,165
13214,Bryce Husak,2008,2008,Saint Louis,A-10,30,545,68,136,64,126,4,10,25,42,38,90,128,16,2,32,47,73,165
13215,Tevin Jackson,2016,2016,McNeese State,Southland,29,512,67,163,56,126,11,37,20,31,24,74,98,45,16,6,43,56,165
13216,Antwann Jones,2019,2019,Memphis,AAC,35,582,56,132,41,88,15,44,38,45,18,86,104,64,23,14,51,59,165
13217,Justin Jones,2018,2018,South Carolina State,MEAC,32,469,59,169,29,74,30,95,17,30,13,38,51,19,12,1,30,20,165
13218,Will Joyce,2016,2017,Southern Utah,Big Sky,53,554,68,126,68,124,0,2,29,56,66,84,150,9,17,19,26,90,165
13219,Brendan Kilpatrick,2013,2015,Vermont,AEC,52,596,58,140,45,92,13,48,36,58,25,53,78,23,14,12,40,78,165
13220,Jordan Loyd,2012,2013,Furman,Southern,28,588,55,150,41,96,14,54,41,62,20,78,98,51,15,4,46,61,165
13221,Elijah McCadden,2019,2019,Georgia Southern,Sun Belt,32,700,67,136,61,109,6,27,25,46,12,70,82,39,23,5,65,71,165
13222,Trevor Noonan,2009,2011,Total,Total,50,659,58,164,34,84,24,80,25,38,29,76,105,65,15,23,56,111,165
13223,Ugo Obineke,2019,2019,Kennesaw State,A-Sun,28,450,72,175,69,154,3,21,18,31,28,27,55,13,7,5,28,42,165
13224,Keanau Post,2014,2015,Missouri,SEC,60,667,70,119,70,119,0,0,25,51,60,99,159,4,10,17,37,106,165
13225,Chris Quayle,2018,2019,North Dakota State,Summit,64,913,58,148,25,55,33,93,16,21,13,101,114,54,14,6,36,62,165
13226,Lonnie Rivera,2016,2019,Total,Total,47,649,58,138,42,90,16,48,33,41,17,66,83,21,10,5,42,59,165
13227,Nygal Russell,2019,2019,Southeast Missouri State,OVC,31,499,53,147,37,94,16,53,43,62,13,69,82,44,13,2,40,60,165
13228,Candido Sa,2017,2018,Rutgers,Big Ten,64,825,64,156,58,132,6,24,31,69,79,111,190,12,21,42,48,99,165
13229,Len Springs,2014,2015,Northern Arizona,Big Sky,70,1102,66,146,66,145,0,1,33,57,135,168,303,12,12,130,55,153,165
13230,Jase Townsend,2019,2019,Denver,Summit,26,493,59,162,29,75,30,87,17,23,4,49,53,31,8,0,20,37,165
13231,Kevin Woods,2010,2012,Utah Valley,GWC,74,862,65,145,62,137,3,8,32,45,12,86,98,95,22,4,75,81,165
13232,Waverly Austin,2013,2014,Oregon,Pac-12,66,712,63,144,63,144,0,0,38,67,68,98,166,15,22,55,48,121,164
13233,Trevor Charles,2011,2013,Total,Total,40,414,64,114,64,114,0,0,36,68,45,52,97,8,3,21,46,93,164
13234,Alonzo Edwards,2009,2012,Total,Total,75,574,59,119,55,112,4,7,42,74,48,77,125,13,9,11,51,134,164
13235,Stephen Evans,2008,2009,Tennessee State,OVC,49,615,70,164,70,163,0,1,24,53,44,91,135,12,8,27,40,92,164
13236,Phil Friesen,2008,2008,Montana State,Big Sky,30,715,49,119,28,65,21,54,45,61,21,68,89,64,16,2,47,65,164
13237,Matt Hein,2017,2019,Illinois State,MVC,64,1005,50,173,20,65,30,108,34,55,13,85,98,60,40,5,66,120,164
13238,Angelo Hernandez,2008,2008,North Carolina A&T,MEAC,31,631,69,126,68,120,1,6,25,55,36,83,119,45,41,3,67,63,164
13239,Erik Kinney,2013,2014,Cal State Bakersfield,Total,55,765,49,139,49,130,0,9,66,100,60,93,153,30,21,24,58,100,164
13240,Reggie Kissoonlal,2015,2017,Northwestern State,Southland,50,423,50,151,17,43,33,108,31,42,17,52,69,14,11,25,36,97,164
13241,Scott Mammel,2014,2017,Army,Patriot,71,629,53,140,14,41,39,99,19,23,12,34,46,46,19,1,32,61,164
13242,Chris Martin,2019,2019,Presbyterian,Big South,33,565,54,124,43,86,11,38,45,66,29,84,113,39,21,0,29,61,164
13243,Kabir Mohammed,2019,2019,Missouri State,MVC,31,464,56,130,53,115,3,15,49,81,51,70,121,13,13,8,19,57,164
13244,Jose Morales,2017,2019,Princeton,Ivy,53,621,56,161,41,101,15,60,37,47,10,46,56,55,46,3,45,74,164
13245,Marcus Neely,2013,2017,Total,Total,79,1043,65,188,64,163,1,25,33,55,53,123,176,48,24,21,41,96,164
13246,Xavier Owens,2012,2013,Mount St. Mary's,NEC,46,665,64,165,49,109,15,56,21,50,31,67,98,18,22,9,42,91,164
13247,Michael Porter,2010,2013,Total,Total,38,580,66,127,61,110,5,17,27,42,50,57,107,25,19,1,31,90,164
13248,Nate Rohrer,2016,2018,Vermont,AEC,74,835,63,114,57,90,6,24,32,49,39,70,109,39,22,11,17,76,164
13249,Jared Samuelson,2017,2017,Montana,Big Sky,32,367,65,114,64,111,1,3,33,49,30,46,76,11,10,11,21,55,164
13250,Fran Urli,2010,2010,Albany (NY),AEC,30,556,53,107,50,102,3,5,55,78,49,44,93,14,7,0,29,66,164
13251,Solomon Uyaelunmo,2019,2019,Towson,CAA,32,510,65,111,64,109,1,2,33,60,50,73,123,9,11,4,29,53,164
13252,Adam Viet,2008,2008,Northern Iowa,MVC,29,606,50,111,7,14,43,97,21,26,2,42,44,28,10,1,16,37,164
13253,Darrell Williams,2011,2011,Oklahoma State,Big 12,23,483,61,129,61,126,0,3,42,62,63,105,168,20,13,13,32,68,164
13254,Rashad Andrews,2015,2018,Southern,SWAC,62,651,57,142,37,81,20,61,29,49,20,75,95,21,15,7,35,75,163
13255,Michael Bethea Jr.,2016,2016,Grambling,SWAC,31,589,52,174,19,45,33,129,26,32,12,51,63,20,26,3,24,39,163
13256,Jonathan Brick,2008,2009,Citadel,Southern,61,718,53,144,33,87,20,57,37,57,17,38,55,66,29,1,58,87,163
13257,Danny Brown,2008,2009,San Diego,WCC,62,677,57,158,16,37,41,121,8,13,14,29,43,25,18,5,35,67,163
13258,Khalil Brown,2013,2014,Monmouth,Total,47,555,55,131,42,84,13,47,40,59,29,29,58,14,9,13,37,51,163
13259,Lance Brown,2010,2010,Fordham,A-10,25,554,67,163,57,139,10,24,19,35,44,55,99,19,13,3,33,43,163
13260,Dwayne Day,2008,2008,South Carolina,SEC,32,710,62,167,36,62,26,105,13,20,37,82,119,25,19,5,27,65,163
13261,Davon Dillard,2016,2018,Oklahoma State,Big 12,35,381,60,113,46,82,14,31,29,42,36,53,89,14,15,4,32,45,163
13262,Edgar Garibay,2010,2013,Total,Total,43,648,63,148,63,148,0,0,37,53,54,94,148,25,18,25,40,85,163
13263,David Golladay,2011,2011,Mount St. Mary's,NEC,31,713,61,160,60,152,1,8,40,53,29,72,101,40,22,7,52,63,163
13264,Vance Hall,2011,2012,Wright State,Horizon,55,860,50,117,18,41,32,76,31,39,10,59,69,32,27,3,26,54,163
13265,DeAndre Hersey,2010,2012,South Alabama,Sun Belt,76,718,62,140,59,131,3,9,36,50,59,88,147,22,13,35,44,82,163
13266,Zach Kinsley,2009,2012,Total,Total,64,742,55,167,27,85,28,82,25,35,23,37,60,24,15,9,39,71,163
13267,A.J. Lapray,2014,2018,Total,Total,44,592,56,156,15,43,41,113,10,14,7,62,69,22,21,5,34,60,163
13268,Davis Martens,2010,2013,Siena,MAAC,75,647,62,166,60,149,2,17,37,70,49,89,138,15,10,20,44,55,163
13269,Mike McGuirl,2018,2019,Kansas State,Big 12,46,722,57,159,34,73,23,86,26,39,22,47,69,53,28,3,29,66,163
13270,Eric Moore,2009,2009,Fairleigh Dickinson,NEC,27,692,55,183,32,79,23,104,30,42,19,48,67,43,25,2,40,33,163
13271,Mychal Mulder,2016,2017,Kentucky,SEC,56,428,56,149,19,41,37,108,14,15,25,50,75,20,9,6,13,33,163
13272,Juan Munoz,2019,2019,Longwood,Big South,28,400,51,122,13,34,38,88,23,27,2,33,35,29,14,0,29,36,163
13273,Juan Palacios,2008,2008,Louisville,Big East,27,478,58,131,42,80,16,51,31,44,32,71,103,32,21,5,26,41,163
13274,DeJuan Pursley,2008,2010,Fairleigh Dickinson,NEC,50,814,70,145,70,145,0,0,23,61,45,109,154,20,9,41,65,108,163
13275,Tyler Stewart,2018,2019,Binghamton,AEC,29,402,60,148,44,98,16,50,27,39,15,46,61,14,13,12,30,42,163
13276,Oumar Sylla,2008,2008,Richmond,A-10,31,604,58,144,44,97,14,47,33,54,21,71,92,34,33,6,36,55,163
13277,Benjamin Uloko,2019,2019,Houston Baptist,Southland,30,385,66,116,64,114,2,2,29,48,35,54,89,7,7,9,25,62,163
13278,Eric Vierneisel,2008,2008,University of California,Pac-10,32,767,50,136,25,52,25,84,38,52,16,66,82,72,18,9,38,90,163
13279,G.J. Vilarino,2010,2012,Total,Total,53,645,54,142,47,111,7,31,48,80,5,57,62,41,20,0,46,42,163
13280,Aaron Weidenaar,2017,2019,Central Arkansas,Southland,80,636,54,181,13,31,41,150,14,20,17,52,69,27,10,7,27,97,163
13281,Mike Auger,2015,2016,Pennsylvania,Ivy,37,527,59,105,58,102,1,3,43,60,35,90,125,12,8,2,46,85,162
13282,Gordon Ball,2012,2014,Texas State,Total,54,486,70,132,70,127,0,5,22,35,47,104,151,23,14,3,43,95,162
13283,Marco Banegas-Flores,2012,2014,Northeastern,CAA,77,908,51,151,42,120,9,31,51,83,15,59,74,79,44,4,86,74,162
13284,Gaby Bermudez,2008,2011,Samford,Total,103,1323,55,150,40,86,15,64,37,62,9,70,79,109,35,1,115,122,162
13285,Craig Brown,2014,2015,Total,Total,63,801,53,201,38,138,15,63,41,61,53,82,135,18,11,8,42,106,162
13286,Ricky Davison,2010,2010,Little Rock,Sun Belt,28,414,49,118,13,48,36,70,28,35,8,29,37,23,17,2,27,31,162
13287,Matt Fullenwider,2008,2008,Texas State,Southland,28,377,59,131,33,77,26,54,18,25,28,43,71,14,12,2,28,61,162
13288,Marvin Gentry,2008,2008,Cincinnati,Big East,27,552,53,132,26,55,27,77,29,36,24,44,68,26,15,2,27,54,162
13289,Kevin Hicks,2018,2019,Sacramento State,Big Sky,40,567,51,151,18,38,33,113,27,30,10,37,47,17,8,0,12,42,162
13290,Deonte' Jones,2013,2013,Texas State,WAC,31,500,58,123,19,37,39,86,7,8,13,35,48,18,5,1,9,35,162
13291,JaQualis Matlock,2019,2019,Eastern Illinois,OVC,31,702,66,155,57,132,9,23,21,42,58,91,149,42,25,19,25,82,162
13292,DeAndre McIntyre,2014,2015,Arkansas-Pine Bluff,SWAC,43,769,60,148,47,98,13,50,29,47,26,71,97,23,34,7,56,74,162
13293,Brandon Newman,2018,2019,Louisiana-Monroe,Sun Belt,62,697,52,105,33,62,19,43,39,51,7,75,82,82,30,6,38,58,162
13294,Hershey Robinson,2014,2014,Prairie View,SWAC,33,600,59,149,27,58,32,91,12,20,40,43,83,18,11,6,30,60,162
13295,Will Robinson,2019,2019,McNeese State,Southland,27,468,48,123,39,98,9,25,57,71,26,67,93,22,8,1,31,45,162
13296,Nick Shepherd,2012,2015,Total,Total,97,1052,57,123,57,123,0,0,48,81,65,83,148,12,14,80,35,149,162
13297,Derek Sloan,2015,2018,Cleveland State,Horizon,88,762,59,123,59,119,0,4,44,81,52,88,140,24,27,30,42,166,162
13298,Kenneth White,2008,2008,Florida International,Sun Belt,16,361,47,121,21,53,26,68,42,51,8,19,27,30,8,1,43,36,162
13299,Zach Bohannon,2010,2014,Total,Total,70,541,57,110,40,64,17,46,30,50,25,64,89,36,20,8,32,77,161
13300,Austin Brown,2009,2010,Montana State,Big Sky,59,391,57,155,37,77,20,78,27,51,40,66,106,27,11,25,34,63,161
13301,Mike Davis,2008,2009,Seton Hall,Big East,61,612,59,127,59,125,0,2,43,63,59,87,146,10,13,58,24,173,161
13302,Pat Dembley,2019,2019,Boise State,MWC,30,506,57,172,31,73,26,99,21,31,9,51,60,45,28,0,61,57,161
13303,Ted Detmer,2008,2008,Lafayette,Patriot,30,572,49,106,49,106,0,0,63,101,39,75,114,38,44,25,67,97,161
13304,Robert Heyer,2015,2015,Boise State,MWC,34,704,54,103,32,50,22,53,31,36,43,64,107,24,14,7,24,63,161
13305,Oleg Kovalov,2010,2011,Purdue-Fort Wayne,Summit,47,437,49,123,22,52,27,71,36,51,23,35,58,14,3,9,36,78,161
13306,Johnny Lee,2008,2010,Total,Total,69,1023,47,154,18,48,29,106,38,54,20,75,95,150,45,4,92,94,161
13307,Richard Lott,2008,2008,Alabama State,SWAC,25,476,61,138,59,134,2,4,37,63,46,64,110,13,10,12,23,47,161
13308,Patrick Lucas-Perry,2012,2014,Pennsylvania,Ivy,47,557,53,134,14,39,39,95,16,20,19,31,50,25,17,1,14,52,161
13309,Darcy Malone,2014,2017,Total,Total,95,852,55,120,47,89,8,31,43,69,59,94,153,31,11,31,55,168,161
13310,Jimmy Marshall,2014,2017,Northeastern,CAA,90,687,54,155,20,42,34,113,19,28,16,76,92,27,21,4,29,53,161
13311,Roger Moute a Bidias,2014,2017,University of California,Pac-12,97,914,45,147,28,87,17,60,54,79,41,88,129,29,9,18,41,105,161
13312,Thanasi Panagiotakopoulos,2008,2008,Northern Colorado,Big Sky,20,522,48,123,19,46,29,77,36,46,7,30,37,49,28,0,64,50,161
13313,Drew Peterson,2019,2019,Rice,CUSA,32,632,51,150,26,66,25,84,34,45,19,87,106,49,13,3,35,43,161
13314,Shane Randall,2014,2016,Maryland-Eastern Shore,MEAC,77,779,52,121,50,112,2,9,55,67,49,74,123,15,13,12,55,145,161
13315,Justin Ray,2010,2011,Texas Southern,SWAC,32,543,52,142,23,43,29,99,28,36,6,23,29,23,26,0,32,30,161
13316,Carl Richburg,2008,2009,Miami (OH),MAC,57,734,52,145,33,61,19,84,38,52,8,57,65,96,28,2,75,73,161
13317,DeAndrae Ross,2008,2011,Total,Sun Belt,59,674,62,178,39,102,23,76,14,22,9,36,45,49,13,1,38,56,161
13318,Matthew Temple,2016,2017,Texas Tech,Big 12,57,571,62,126,51,101,11,25,26,42,33,46,79,30,7,15,40,120,161
13319,Anthony Thompson,2009,2012,Bradley,MVC,85,834,65,138,65,138,0,0,31,60,44,110,154,9,9,65,38,92,161
13320,Adam Traore,2018,2018,Coppin State,MEAC,25,550,47,132,40,99,7,33,60,76,33,107,140,31,8,6,52,84,161
13321,Davion Turner,2018,2018,Texas-Arlington,Sun Belt,30,448,52,108,22,40,30,68,27,37,23,63,86,18,7,15,22,37,161
13322,Jiday Ugbaja,2015,2018,Sacramento State,Big Sky,65,516,56,137,44,98,12,39,37,52,16,45,61,47,20,0,38,88,161
13323,Samson Usilo,2017,2019,Manhattan,MAAC,54,737,63,162,60,143,3,19,32,80,47,115,162,19,30,15,59,80,161
13324,James Valladares,2008,2011,New Hampshire,AEC,92,1028,64,183,47,116,17,67,16,28,64,66,130,17,11,28,31,140,161
13325,Milton Washington,2012,2015,Army,Patriot,43,473,58,115,54,107,4,8,41,58,10,60,70,57,19,3,57,44,161
13326,Ernest Watson,2013,2013,Northern Kentucky,A-Sun,26,714,68,183,56,138,12,45,13,22,48,93,141,33,27,18,16,56,161
13327,Marcus Williams,2011,2011,Sam Houston State,Southland,22,515,53,144,38,89,15,55,40,59,9,39,48,73,33,1,57,49,161
13328,Vince Williams,2019,2019,Virginia Commonwealth,A-10,33,512,50,109,44,84,6,25,55,80,34,75,109,34,34,13,48,66,161
13329,Tyler Bergantino,2013,2016,Massachusetts,A-10,113,1136,73,114,73,113,0,1,14,41,77,136,213,18,18,42,21,172,160
13330,Austin Burgett,2013,2016,Notre Dame,Total,83,709,58,123,42,57,16,66,28,38,23,81,104,29,20,21,31,98,160
13331,Xavier Castaneda,2019,2019,South Florida,AAC,37,704,46,137,29,85,17,52,51,74,18,39,57,65,19,1,59,55,160
13332,Kihei Clark,2019,2019,Virginia,ACC,36,950,51,148,24,65,27,83,31,38,14,71,85,90,27,0,37,48,160
13333,Connor Devine,2014,2016,South Dakota State,Summit,77,646,57,102,57,102,0,0,46,91,62,84,146,15,11,55,26,118,160
13334,Matt DeWolf,2018,2019,Brown,Ivy,54,734,60,107,60,107,0,0,40,69,65,134,199,40,24,10,55,88,160
13335,Brandon Knapper,2019,2019,West Virginia,Big 12,32,441,51,145,26,66,25,79,33,43,4,50,54,46,16,0,50,53,160
13336,J.J. Matthews,2019,2019,Arkansas State,Sun Belt,27,378,60,117,60,117,0,0,40,61,40,46,86,10,8,15,39,69,160
13337,Ugo Mmonu,2014,2017,Total,Total,63,626,52,121,47,101,5,20,51,72,59,91,150,5,13,26,52,119,160
13338,Chalmers Rogers,2011,2012,South Carolina Upstate,A-Sun,64,851,63,170,37,83,26,87,8,20,38,67,105,30,25,8,25,85,160
13339,Jahmiah Simmons,2017,2017,Arkansas State,Sun Belt,25,462,57,106,57,104,0,2,46,69,44,80,124,6,9,21,26,85,160
13340,Gokhan Sirin,2010,2011,Charlotte,A-10,51,461,52,136,7,27,45,109,11,16,14,39,53,9,5,5,25,41,160
13341,Jeron Smith,2008,2008,Howard,MEAC,23,449,60,125,52,106,8,19,32,59,18,34,52,23,33,9,39,37,160
13342,Lanny Smith,2008,2008,Houston,CUSA,29,591,41,134,28,72,13,62,65,78,3,41,44,108,21,0,53,49,160
13343,Antwone Snead,2010,2010,Purdue-Fort Wayne,Summit,29,646,57,113,57,112,0,1,46,74,62,129,191,34,16,10,39,86,160
13344,Kyle Taber,2008,2009,Indiana,Big Ten,53,1003,68,126,66,121,2,5,22,32,78,136,214,37,33,15,36,77,160
13345,Christopher Thomas,2016,2017,Alabama A&M,SWAC,37,647,62,149,45,81,17,68,19,30,34,58,92,19,7,7,25,53,160
13346,Geno West,2018,2019,Idaho,Big Sky,37,542,53,139,30,64,23,75,31,40,5,43,48,51,21,0,44,40,160
13347,Devan Bailey,2010,2011,Central Connecticut State,NEC,61,1522,65,187,56,148,9,39,20,34,17,99,116,153,48,16,101,150,159
13348,William Boyer-Richard,2019,2019,Western Michigan,MAC,32,621,49,108,12,33,37,75,24,31,3,33,36,30,11,3,38,57,159
13349,Na'Quan Council,2017,2017,Manhattan,MAAC,32,417,46,158,21,58,25,100,42,54,17,32,49,18,30,0,27,38,159
13350,Sami Eleraky,2015,2017,Pacific,WCC,60,756,58,127,58,127,0,0,43,102,61,108,169,16,8,37,51,126,159
13351,David Gibbs,2009,2010,Massachusetts,A-10,51,939,58,180,33,92,25,88,18,29,19,63,82,88,41,6,43,56,159
13352,Nathan Harries,2014,2017,Colgate,Patriot,43,616,61,142,42,89,19,53,18,27,8,52,60,38,11,3,25,66,159
13353,Darius Henderson,2019,2019,Massachusetts-Lowell,AEC,31,353,65,129,55,98,10,31,19,23,11,71,82,19,10,14,38,66,159
13354,Ricardo Lynch,2019,2019,Stetson,A-Sun,30,366,50,147,32,72,18,75,41,54,17,42,59,11,12,5,23,36,159
13355,Denaell McDaniel,2013,2013,Alabama State,SWAC,26,699,51,138,31,81,20,57,37,64,13,71,84,85,16,6,60,55,159
13356,Kennedy McKinney,2017,2018,Arkansas-Pine Bluff,SWAC,49,666,63,157,60,132,3,25,30,43,36,45,81,45,50,4,74,61,159
13357,Deverin Muff,2011,2015,Eastern Kentucky,OVC,107,814,60,123,60,123,0,0,39,65,56,54,110,14,31,38,37,133,159
13358,Nana Opoku,2019,2019,Mount St. Mary's,NEC,30,698,53,126,42,77,11,49,42,57,34,78,112,14,9,47,46,65,159
13359,Emmanuel Owootoah,2014,2015,Fresno State,MWC,60,991,47,136,21,53,26,83,39,55,13,52,65,83,58,2,61,88,159
13360,Marquis Rankin,2012,2013,Virginia Tech,ACC,53,877,57,154,34,88,23,66,22,37,14,40,54,53,27,4,60,102,159
13361,Camron Reedus,2018,2018,Little Rock,Sun Belt,22,410,49,118,17,35,32,83,29,35,6,33,39,13,14,1,31,37,159
13362,Zach Reichle,2018,2019,Oregon State,Pac-12,61,855,45,148,9,39,36,109,33,44,25,78,103,59,25,1,54,89,159
13363,Jay Smith,2009,2010,Eastern Illinois,OVC,60,443,55,157,18,32,37,125,12,15,6,43,49,12,6,1,19,9,159
13364,Charles Tucker,2015,2015,Tennessee State,OVC,31,668,43,107,29,65,14,42,59,74,4,36,40,71,13,0,54,49,159
13365,Matt Walls,2008,2008,Marshall,CUSA,22,563,51,168,15,39,36,129,21,30,13,46,59,25,8,2,21,48,159
13366,Austin Weiher,2015,2018,Southern Illinois,MVC,69,556,61,132,47,91,14,41,23,37,23,48,71,13,17,1,30,70,159
13367,Isaiah Wilkins,2019,2019,Virginia Tech,ACC,34,487,57,117,35,63,22,54,23,31,31,47,78,20,18,2,20,37,159
13368,Stavian Allen,2017,2018,Norfolk State,MEAC,55,547,61,144,50,103,11,41,25,41,39,98,137,16,16,25,38,78,158
13369,Costa Anderson,2017,2018,Albany (NY),AEC,57,535,53,140,18,39,35,101,17,19,8,35,43,39,15,0,15,19,158
13370,Chris Buchanan,2009,2010,Illinois-Chicago,Horizon,45,539,53,145,28,59,25,86,27,43,16,37,53,15,23,2,34,60,158
13371,J.D. Davis,2009,2010,Texas-Arlington,Southland,55,780,64,134,64,131,0,3,30,54,56,64,120,20,20,11,45,129,158
13372,Aaron England,2010,2010,Utah Valley,GWC,30,491,54,131,27,62,27,69,23,24,6,38,44,21,10,4,25,26,158
13373,Yaradyah Evans,2018,2019,St. Francis (NY),NEC,48,769,60,167,42,85,18,82,20,34,41,152,193,29,32,21,53,98,158
13374,R.J. Eytle-Rock,2019,2019,Maryland-Baltimore County,AEC,31,757,55,136,41,92,14,44,34,43,10,73,83,56,24,7,36,51,158
13375,Francis Ezeiru,2013,2014,Maryland-Eastern Shore,MEAC,34,664,63,136,63,136,0,0,32,78,71,107,178,3,10,23,41,92,158
13376,LaBradford Franklin,2011,2013,San Diego State,MWC,55,593,47,112,37,73,10,39,54,64,8,65,73,83,16,2,67,53,158
13377,Nick Gorski,2014,2017,Loyola (MD),Patriot,100,784,60,159,55,136,5,23,33,45,41,73,114,20,10,14,48,98,158
13378,Maurice Hubbard,2009,2011,Ball State,MAC,62,884,74,183,74,183,0,0,10,39,55,126,181,38,33,10,58,136,158
13379,Zach Jones,2011,2013,Utah Valley,GWC,63,595,65,138,65,135,0,3,28,46,44,66,110,21,13,19,22,74,158
13380,Antione Lister,2019,2019,Prairie View,SWAC,33,459,51,95,27,37,24,58,32,40,11,30,41,10,10,6,20,42,158
13381,Jayden Martinez,2019,2019,New Hampshire,AEC,20,393,60,138,40,76,20,62,18,26,16,86,102,16,5,15,24,44,158
13382,George Matthews,2012,2016,Total,Total,54,466,60,160,41,74,19,86,19,28,36,71,107,13,18,14,44,57,158
13383,Marque Maultsby,2019,2019,New Hampshire,AEC,27,568,61,191,44,131,17,60,19,24,16,61,77,46,20,4,46,65,158
13384,Shelby Moats,2012,2015,Vanderbilt,SEC,87,957,59,154,39,78,20,76,20,45,59,105,164,38,19,7,52,124,158
13385,Terion Moss,2019,2019,Maine,AEC,29,775,52,165,22,54,30,111,24,45,20,54,74,50,39,0,34,55,158
13386,Jahmel Myers,2019,2019,New Orleans,Southland,32,562,55,120,51,111,4,9,44,54,38,61,99,29,17,11,32,84,158
13387,Akuwovo Ogheneyole,2019,2019,Howard,MEAC,34,669,60,125,60,121,0,4,38,57,78,101,179,9,14,25,33,100,158
13388,Jason Perry-Murray,2018,2018,Grambling,SWAC,28,528,66,108,66,108,0,0,26,44,64,72,136,4,13,26,32,83,158
13389,Cameron Smith,2016,2019,Total,Total,58,701,59,104,59,104,0,0,40,62,39,113,152,14,19,32,35,95,158
13390,Spencer Turner,2012,2015,Belmont,Total,81,463,53,143,8,15,45,128,7,12,13,31,44,33,7,0,20,27,158
13391,Terrell Williams,2008,2010,La Salle,A-10,70,762,63,139,63,137,0,2,32,75,55,97,152,36,22,12,63,102,158
13392,Kalif Wright,2015,2016,Miami (OH),MAC,52,495,68,158,67,157,1,1,21,39,29,62,91,2,8,3,25,83,158
13393,Devin Wyatt,2015,2018,Total,Total,60,742,58,123,58,121,0,2,42,79,53,69,122,6,15,83,27,131,158
13394,Marquis Young,2009,2010,Chicago State,Total,36,388,67,120,67,120,0,0,24,40,58,61,119,11,4,18,34,73,158
13395,Dee Barnes,2019,2019,Mount St. Mary's,NEC,27,437,57,135,28,55,29,80,14,32,12,30,42,9,9,11,28,55,157
13396,Colby Batiste,2009,2011,Louisiana,Sun Belt,69,890,62,120,62,120,0,0,33,58,76,117,193,11,9,59,50,165,157
13397,Connor Brooks,2014,2015,Stephen F. Austin,Southland,63,631,57,133,41,83,16,50,27,39,25,36,61,55,25,3,43,58,157
13398,Joe Burton,2015,2016,Oklahoma State,Big 12,39,409,52,121,26,51,26,70,27,46,12,36,48,19,7,2,21,42,157
13399,Cam Delaney,2015,2017,Total,Total,42,490,51,129,23,50,28,79,27,39,11,64,75,30,29,2,20,54,157
13400,Corey Douglas,2017,2019,Total,Total,42,625,65,114,63,109,2,5,25,47,64,87,151,14,14,59,37,101,157
13401,Bill Eaddy,2008,2010,Drake,MVC,80,680,50,120,16,36,34,84,23,32,12,51,63,20,12,1,24,112,157
13402,Ben Elias,2008,2008,New Orleans,Sun Belt,31,545,68,122,68,122,0,0,21,29,43,80,123,4,7,16,43,98,157
13403,Greg Elliott,2018,2018,Marquette,Big East,35,639,54,107,43,77,11,30,38,48,23,58,81,48,30,24,30,67,157
13404,Rob Eppinger,2009,2009,Illinois-Chicago,Horizon,29,540,65,147,65,146,0,1,27,39,51,63,114,10,6,13,40,52,157
13405,Kregg Jones,2011,2015,Cal State Bakersfield,Total,79,690,65,124,65,124,0,0,27,63,36,78,114,5,8,37,40,105,157
13406,Miller Kopp,2019,2019,Northwestern,Big Ten,32,545,60,162,37,90,23,72,14,20,15,54,69,36,13,13,36,52,157
13407,Connor McCaffery,2018,2019,Iowa,Big Ten,38,685,37,100,30,69,7,31,76,101,12,41,53,109,25,3,47,63,157
13408,Mitch McDonald,2008,2011,Army,Patriot,65,862,57,136,56,129,1,7,42,64,4,80,84,127,53,2,104,117,157
13409,Kyle Meyer,2014,2017,Total,Total,76,1024,60,141,56,112,4,29,33,55,92,125,217,37,22,34,47,144,157
13410,James Pegues,2014,2014,Abilene Christian,Southland,31,445,55,125,54,119,1,6,46,56,32,69,101,16,22,3,46,71,157
13411,Anthony Strickland,2012,2014,Eastern Michigan,MAC,85,934,56,135,56,133,0,2,45,67,64,83,147,28,35,8,40,92,157
13412,Clive Vaughan,2015,2017,Morgan State,MEAC,52,457,58,173,28,61,30,112,11,23,17,34,51,8,9,1,24,44,157
13413,Dawin Whiten,2008,2008,Cal Poly,Big West,19,506,52,171,20,65,32,106,21,24,8,33,41,32,23,3,36,44,157
13414,Keith Wilkinson,2008,2009,Southern California,Pac-10,61,981,56,139,38,82,18,57,27,48,52,108,160,44,11,16,32,98,157
13415,Herve Banogle,2008,2009,Manhattan,MAAC,46,735,60,109,60,109,0,0,36,65,68,111,179,11,22,15,55,108,156
13416,Donnell Beverly,2008,2011,Connecticut,Big East,109,820,53,131,39,100,14,31,36,49,38,83,121,110,32,6,69,60,156
13417,Jonathan Breeden,2010,2011,Siena,MAAC,47,449,48,135,36,101,12,34,48,64,8,26,34,58,19,2,46,31,156
13418,Kajon Brown,2016,2019,Total,Total,48,661,58,144,42,87,16,57,24,38,38,54,92,36,22,3,38,49,156
13419,Devon Carter,2013,2017,Lehigh,Patriot,89,712,56,154,36,88,20,66,24,33,22,54,76,35,25,2,27,43,156
13420,Jason Carter,2011,2015,Total,Total,41,471,57,158,43,107,14,51,28,52,18,63,81,5,17,12,45,79,156
13421,Chip Cartwright,2008,2008,Central Florida,CUSA,31,655,53,123,48,101,5,22,45,60,13,70,83,107,32,7,60,59,156
13422,Garrett Collins,2015,2018,North Carolina-Greensboro,Southern,73,413,51,115,14,19,37,96,17,18,17,45,62,10,12,7,11,32,156
13423,Jason Davis,2008,2008,Sacramento State,Big Sky,21,408,55,99,55,99,0,0,46,95,38,53,91,11,24,4,19,51,156
13424,Antonio Haymon,2010,2010,Marshall,CUSA,32,441,56,119,51,102,5,17,39,55,22,60,82,32,15,16,19,44,156
13425,Arell Hennings,2017,2018,UC-Davis,Big West,60,567,48,123,27,68,21,55,39,46,10,29,39,73,20,0,47,46,156
13426,Adokiye Iyaye,2019,2019,Texas-San Antonio,CUSA,32,586,54,111,43,68,11,43,37,49,17,29,46,24,15,2,17,43,156
13427,Zuri James,2011,2011,Georgia Southern,Southern,30,671,50,140,15,46,35,94,21,25,8,31,39,33,19,0,35,44,156
13428,Joe Kammerer,2011,2014,Idaho,WAC,101,1095,71,144,71,142,0,2,14,27,55,87,142,19,7,18,48,125,156
13429,Robbie Lemons,2011,2014,Stanford,Total,80,742,55,147,23,54,32,93,14,24,19,50,69,24,20,1,17,55,156
13430,Pawel Malesa,2008,2008,Canisius,MAAC,28,333,47,132,8,23,39,109,23,27,15,29,44,2,6,3,8,43,156
13431,Malik Miller,2019,2019,Morgan State,MEAC,28,437,59,130,56,117,3,13,35,56,49,54,103,25,28,9,41,58,156
13432,Josh Nicholas,2013,2014,Alcorn State,SWAC,57,749,63,130,63,129,0,1,30,54,50,143,193,13,15,61,41,141,156
13433,Chris Palombizio,2017,2018,Oakland,Horizon,62,627,49,155,26,69,23,86,35,56,30,72,102,18,15,4,15,46,156
13434,Drew Richards,2008,2008,Missouri State,MVC,25,483,65,112,65,112,0,0,26,71,47,65,112,19,7,41,32,75,156
13435,Jimmy Sherburne,2010,2014,Princeton,Ivy,74,795,51,139,34,85,17,54,37,51,11,88,99,69,16,5,55,90,156
13436,Aaron Short,2013,2014,Pacific,Total,34,583,54,116,25,59,29,57,19,21,28,86,114,37,25,7,32,71,156
13437,Tim Snyder,2011,2011,Florida Gulf Coast,A-Sun,25,452,54,122,54,115,0,7,48,83,31,63,94,11,10,6,43,74,156
13438,Tyrelle Blair,2008,2008,Boston College,ACC,31,703,48,125,48,125,0,0,59,86,54,95,149,21,10,105,49,83,155
13439,Davon Bolton,2019,2019,Northern Arizona,Big Sky,31,450,50,144,33,67,17,77,38,55,4,39,43,33,7,0,39,39,155
13440,Dan Boudler,2008,2011,Youngstown State,Horizon,92,1015,67,132,67,132,0,0,21,35,83,127,210,31,33,25,32,98,155
13441,Brian Carey,2016,2018,Texas Southern,SWAC,53,860,43,136,27,87,16,49,53,76,8,57,65,86,27,0,69,62,155
13442,Tyler Carter,2017,2018,Alcorn State,SWAC,62,660,48,135,40,98,8,37,51,70,52,85,137,30,23,2,46,120,155
13443,Zach Chappell,2019,2019,San Jose State,MWC,29,511,47,144,29,79,18,65,43,58,7,44,51,65,20,1,38,41,155
13444,Tre Clark,2017,2019,Furman,Southern,55,626,61,145,51,104,10,41,23,58,38,77,115,53,34,16,62,58,155
13445,Tyler Clement,2015,2018,Creighton,Big East,105,722,54,131,26,48,28,83,19,31,8,74,82,89,22,3,57,93,155
13446,Assane Diop,2015,2017,Austin Peay,OVC,72,656,58,157,46,107,12,50,27,47,33,97,130,25,4,20,46,118,155
13447,Trevon Flores,2010,2012,James Madison,CAA,55,749,67,152,65,131,2,21,19,29,47,85,132,29,15,47,23,81,155
13448,Sammy Friday,2017,2019,Siena,MAAC,60,431,55,114,55,114,0,0,45,76,51,52,103,6,7,9,23,60,155
13449,Colin Gruber,2012,2015,Total,Total,64,649,53,175,30,90,23,85,26,29,23,59,82,22,24,15,34,62,155
13450,Ryden Hines,2014,2016,Iona,MAAC,77,756,56,110,33,52,23,58,20,36,47,95,142,23,14,9,18,102,155
13451,Milos Jovic,2017,2019,Miami (OH),MAC,56,721,60,130,38,78,22,52,13,34,11,50,61,42,22,8,66,60,155
13452,Marc Mack,2012,2013,Bethune-Cookman,MEAC,63,852,63,184,62,177,1,7,28,54,73,72,145,15,15,8,54,135,155
13453,Joshua Meier,2015,2015,Chicago State,WAC,31,642,59,159,58,158,1,1,36,58,66,58,124,19,19,17,58,77,155
13454,Robert Montgomery,2017,2017,St. Francis (NY),NEC,30,559,59,138,57,132,2,6,35,60,51,86,137,14,11,32,53,97,155
13455,Justin Moore,2017,2018,Georgia Tech,ACC,42,748,62,155,59,141,3,14,28,55,15,52,67,91,19,4,65,69,155
13456,Ugochukwu Njoku,2013,2014,Detroit Mercy,Horizon,64,867,63,130,63,129,0,1,29,74,96,137,233,18,41,67,36,126,155
13457,Joshua Oswald,2014,2015,Miami (OH),MAC,43,590,61,157,48,97,13,60,20,26,35,68,103,22,15,10,28,56,155
13458,Alvardo Parker,2008,2008,Texas Christian,MWC,30,573,69,125,69,125,0,0,17,38,58,80,138,22,13,31,29,65,155
13459,Avibakuro Preh,2013,2014,Idaho State,Big Sky,58,1183,64,93,64,93,0,0,27,48,72,128,200,19,29,69,40,162,155
13460,Blake Simpson,2015,2018,Coppin State,MEAC,97,1415,43,134,43,131,0,3,69,118,127,173,300,24,20,48,62,241,155
13461,Jarrett Stokes,2013,2013,Morehead State,OVC,32,505,49,156,20,53,29,103,28,32,6,25,31,37,13,0,27,57,155
13462,Clarence Williams,2016,2017,East Carolina,AAC,43,635,64,151,57,128,7,23,20,28,41,95,136,19,21,14,62,74,155
13463,Jeremy Wilson,2008,2010,Navy,Patriot,51,516,60,104,60,104,0,0,35,50,46,44,90,8,9,20,44,105,155
13464,Calvin Wishart,2019,2019,Georgia Southern,Sun Belt,30,541,47,132,13,33,34,99,27,40,8,45,53,40,27,1,42,64,155
13465,Raschard Boatner,2008,2012,Total,Total,47,559,57,167,27,63,30,104,10,17,9,44,53,36,15,0,41,34,154
13466,Tracy Burnett,2017,2018,Alabama A&M,SWAC,35,538,66,150,66,149,0,1,22,39,29,54,83,11,5,6,37,39,154
13467,Davion Buster,2019,2019,Lamar,Southland,19,297,55,120,20,34,35,86,9,12,2,29,31,24,11,1,18,15,154
13468,Nick Carter,2008,2008,Stony Brook,AEC,25,401,48,164,28,94,20,70,38,57,24,22,46,17,18,3,27,66,154
13469,Will DiIorio,2011,2014,Washington State,Total,100,943,55,119,47,96,8,23,36,75,65,84,149,34,30,1,39,102,154
13470,Matej Drgon,2018,2019,Northern Colorado,Big Sky,42,339,56,134,21,44,35,90,7,12,13,47,60,8,3,5,22,41,154
13471,Jimmie Duplessis,2012,2015,Total,Total,48,652,54,150,42,107,12,43,34,64,10,47,57,75,18,1,74,72,154
13472,Ben Eblen,2010,2014,Total,Total,125,1433,66,186,62,154,4,32,18,48,26,114,140,151,60,10,87,154,154
13473,Aldonis Foote,2016,2017,Middle Tennessee,CUSA,60,508,62,139,57,123,5,16,25,45,35,68,103,32,18,2,30,89,154
13474,Andrew Funk,2019,2019,Bucknell,Patriot,33,473,57,140,23,42,34,98,6,9,6,44,50,24,9,1,20,22,154
13475,Robert Gilchrist,2013,2014,Florida State,ACC,61,683,68,153,64,136,4,17,14,39,33,62,95,10,15,26,48,64,154
13476,Mike Hart,2010,2013,Gonzaga,WCC,112,1217,51,114,33,65,18,49,34,50,119,158,277,68,64,16,30,149,154
13477,J'Von McCormick,2019,2019,Auburn,SEC,38,457,61,115,51,96,10,19,22,37,15,22,37,51,31,3,28,36,154
13478,Aric Miller,2010,2011,Bethune-Cookman,MEAC,56,662,56,129,49,106,7,23,35,66,22,46,68,35,18,6,44,63,154
13479,Jermaine Myers,2013,2014,Fordham,A-10,56,914,47,136,29,68,18,68,42,55,10,59,69,96,29,4,64,79,154
13480,Kyryl Natyazhko,2010,2012,Arizona,Total,91,859,61,143,55,128,6,15,26,37,60,118,178,18,11,18,44,147,154
13481,Drew Naymick,2008,2008,Michigan State,Big Ten,36,764,65,100,65,99,0,1,24,31,44,105,149,14,11,60,25,90,154
13482,Daouda Ndiaye,2016,2018,Illinois State,MVC,58,861,60,124,60,124,0,0,34,61,66,139,205,13,16,81,32,102,154
13483,Ehimen Orukpe,2011,2013,Wichita State,MVC,86,887,59,125,59,125,0,0,36,84,74,183,257,16,20,90,81,127,154
13484,Mychal Parker,2011,2012,Maryland,ACC,45,655,52,120,44,88,8,32,42,73,38,75,113,38,16,10,49,56,154
13485,Trumaine Pearson,2008,2009,Georgia Southern,Southern,41,499,55,118,45,92,10,26,34,55,31,68,99,8,12,15,36,32,154
13486,Marco Smith,2018,2018,Missouri-Kansas City,WAC,31,516,59,130,47,91,12,39,24,35,14,57,71,29,29,13,29,49,154
13487,Shawn Smith,2014,2014,Texas A&M,SEC,27,600,51,156,39,100,12,56,40,60,16,70,86,35,14,5,23,33,154
13488,Danny Upchurch,2015,2016,Charleston Southern,Big South,60,705,46,176,15,46,31,130,31,50,8,52,60,78,20,2,65,69,154
13489,Neveij Walters,2013,2013,Idaho State,Big Sky,30,568,65,130,65,130,0,0,24,50,39,69,108,7,21,32,36,68,154
13490,J.C. Ward,2010,2012,East Tennessee State,A-Sun,76,1054,54,113,44,90,10,23,36,64,72,121,193,23,17,7,35,152,154
13491,Willie Wiley,2016,2017,Evansville,MVC,42,484,61,133,61,132,0,1,32,55,36,62,98,11,19,14,31,62,154
13492,Ethan Alvano,2015,2016,Eastern Michigan,MAC,49,584,36,141,27,82,9,59,72,90,11,44,55,67,39,2,35,44,153
13493,Kieondre Arkwright,2011,2012,Texas-Rio Grande Valley,GWC,50,514,51,139,26,68,25,71,26,42,9,32,41,41,17,2,50,36,153
13494,Dionte Champion,2018,2018,New Orleans,Southland,30,515,51,98,47,77,4,21,47,67,27,55,82,21,25,9,26,62,153
13495,Kareem Cooper,2009,2009,Texas-El Paso,CUSA,21,386,56,106,52,97,4,9,37,64,37,51,88,9,4,7,34,64,153
13496,Tim Crossin,2008,2009,Towson,CAA,48,548,48,126,13,30,35,96,22,30,11,46,57,24,32,2,23,18,153
13497,Allan Dempster,2013,2014,Bethune-Cookman,MEAC,48,502,62,124,62,124,0,0,29,52,54,51,105,4,16,10,23,100,153
13498,Sam Dolan,2008,2008,Mercer,A-Sun,26,521,62,130,62,130,0,0,29,51,47,67,114,21,7,25,34,52,153
13499,Stephen Domingo,2013,2017,Total,Total,100,935,52,202,25,68,27,134,22,54,37,99,136,46,19,22,21,97,153
13500,Connor Ferrell,2017,2017,Wagner,NEC,28,575,49,139,29,62,20,77,35,50,16,51,67,23,9,4,23,58,153
13501,Rich Flemming,2009,2009,Maryland-Baltimore County,AEC,23,501,62,137,62,134,0,3,29,50,32,71,103,11,15,12,30,60,153
13502,Frank Henery-Ala,2009,2010,Kent State,MAC,59,843,52,129,38,85,14,44,35,46,65,89,154,22,47,12,18,73,153
13503,Andre Mattison,2010,2013,Florida Atlantic,Sun Belt,98,806,52,109,52,109,0,0,49,81,65,97,162,7,22,33,40,91,153
13504,Matthew Mayer,2019,2019,Baylor,Big 12,33,388,51,154,31,89,20,65,31,47,24,42,66,26,17,8,25,34,153
13505,Kevon Moore,2011,2011,Niagara,MAAC,32,718,50,155,38,86,12,69,41,64,21,75,96,39,30,4,59,64,153
13506,Elijah Muhammad,2009,2009,Tennessee Tech,OVC,30,610,50,149,39,103,11,46,42,52,41,58,99,83,39,2,40,60,153
13507,Johannes Nielsen,2017,2017,Kennesaw State,A-Sun,27,514,60,111,60,109,0,2,33,43,26,57,83,23,11,8,35,81,153
13508,Charles Okwandu,2009,2011,Connecticut,Big East,81,907,70,148,70,148,0,0,13,30,72,99,171,26,17,67,59,153,153
13509,Austin Pehl,2010,2013,Northern Iowa,MVC,93,693,62,144,62,144,0,0,29,46,38,143,181,15,14,11,45,110,153
13510,Arnold Richmond,2016,2016,Grambling,SWAC,31,420,47,123,40,87,7,36,52,77,9,26,35,35,19,2,57,42,153
13511,Josh Sheets,2008,2010,North Carolina-Wilmington,CAA,66,730,52,157,13,46,39,111,10,18,10,35,45,22,9,0,24,77,153
13512,Fred Thatch Jr,2019,2019,Saint Louis,A-10,36,698,51,142,33,75,18,67,33,54,42,54,96,30,28,12,29,85,153
13513,Devin Thornton,2016,2017,Southern Illinois-Edwardsville,OVC,50,513,50,127,31,78,19,49,34,51,27,57,84,25,17,4,29,66,153
13514,Fred Washington,2008,2008,Stanford,Pac-10,35,817,55,116,54,111,1,5,42,81,45,100,145,79,22,11,50,70,153
13515,Joseph Williams-Powell,2017,2017,Coastal Carolina,Sun Belt,32,409,56,120,48,98,8,22,33,50,28,59,87,11,7,3,39,63,153
13516,Aleksandar Zecevic,2019,2019,Florida Atlantic,CUSA,32,392,69,125,66,114,3,11,12,19,35,82,117,11,8,12,32,44,153
13517,Aubrey Ball,2014,2014,Central Arkansas,Southland,28,347,48,127,15,48,33,79,23,34,5,29,34,19,9,0,18,20,152
13518,Kahari Beaufort,2017,2018,Tennessee-Martin,OVC,47,487,54,136,35,74,19,62,25,36,16,52,68,20,19,4,35,59,152
13519,Lawrence Brown,2013,2016,Mercer,Total,83,627,60,114,59,112,1,2,31,46,53,73,126,14,17,18,25,78,152
13520,Arlando Cook,2017,2018,Arkansas,SEC,64,697,61,138,61,138,0,0,30,53,42,90,132,23,18,16,33,82,152
13521,Zack Crimmins,2008,2011,Columbia,Ivy,72,583,65,162,65,161,0,1,22,43,45,104,149,11,9,24,33,124,152
13522,Patrick Emilien,2019,2019,Western Michigan,MAC,32,680,48,138,22,49,26,89,30,53,44,82,126,25,13,13,39,33,152
13523,Phabian Glasco,2014,2014,Central Arkansas,Southland,29,608,64,111,64,110,0,1,24,53,44,66,110,20,17,56,21,73,152
13524,Ben Grace,2014,2017,Maryland-Baltimore County,AEC,70,647,45,116,5,15,40,101,22,26,4,45,49,31,15,0,27,45,152
13525,Kealen Ives,2016,2016,Rider,MAAC,32,583,47,147,24,81,23,66,35,45,7,49,56,62,23,1,41,54,152
13526,Robin Jorch,2016,2018,Boise State,MWC,80,645,55,95,55,93,0,2,42,71,68,49,117,5,10,9,38,150,152
13527,Sacha Killeya-Jones,2017,2018,Kentucky,SEC,48,563,62,106,62,105,0,1,28,54,55,75,130,10,8,29,30,91,152
13528,Arman Marks,2012,2013,James Madison,CAA,40,541,49,135,24,61,25,74,29,41,28,66,94,20,30,1,29,60,152
13529,John Moonshower,2008,2009,Army,Patriot,36,448,59,155,39,100,20,55,14,20,5,49,54,31,14,13,36,42,152
13530,Emeka Okafor,2009,2011,Total,Total,52,671,56,130,56,130,0,0,40,73,67,111,178,7,21,20,57,127,152
13531,Julius Perkins,2008,2008,Campbell,A-Sun,30,637,45,104,45,102,0,2,62,118,13,42,55,94,36,6,94,86,152
13532,Harvey Perry,2009,2010,Colorado State,MWC,43,615,49,168,28,96,21,72,33,50,40,87,127,41,22,11,50,91,152
13533,Dont'e Reynolds,2016,2016,San Francisco,WCC,30,705,53,101,53,98,0,3,46,72,73,128,201,23,21,25,45,97,152
13534,Sam Schwietz,2016,2019,Maryland-Baltimore County,AEC,79,843,64,102,64,101,0,1,24,58,71,113,184,31,22,45,33,164,152
13535,Patrick Simon,2011,2012,Washington State,Total,52,416,55,145,21,38,34,107,8,13,11,57,68,10,4,2,7,46,152
13536,Anthony Smith,2018,2019,Murray State,OVC,37,554,44,83,43,81,1,2,63,91,64,73,137,13,19,26,43,107,152
13537,Jace Tavita,2009,2013,Total,Total,92,1644,54,165,21,59,33,106,11,29,22,114,136,262,35,9,139,176,152
13538,Tyler Thalken,2010,2012,Denver,Sun Belt,49,739,47,94,20,34,27,60,31,38,8,35,43,29,8,3,27,89,152
13539,Kostas Antetokounmpo,2018,2018,Dayton,A-10,29,438,58,101,56,86,2,15,33,64,24,59,83,13,7,31,39,66,151
13540,Jordan Caruso,2019,2019,Incarnate Word,Southland,31,665,52,114,41,80,11,34,36,49,12,64,76,54,21,3,65,59,151
13541,Trey Carver,2017,2019,Hampton,Total,77,767,54,151,51,137,3,14,40,69,58,79,137,18,13,4,25,56,151
13542,Evan Cole,2018,2019,Georgia Tech,ACC,42,554,55,123,45,81,10,42,31,52,28,78,106,21,16,15,36,72,151
13543,Manny Dixon,2019,2019,Saint Peter's,MAAC,26,677,51,120,33,67,18,53,31,35,20,44,64,13,20,5,27,67,151
13544,Ifeanyi Ehirim,2008,2009,Robert Morris,NEC,59,652,57,112,57,111,0,1,37,58,46,59,105,22,27,17,32,87,151
13545,Matt Estep,2008,2009,Wofford,Southern,51,522,52,138,16,39,36,99,11,14,6,35,41,24,9,1,28,36,151
13546,Jeremiah Ferguson,2017,2018,Youngstown State,Horizon,52,522,53,152,37,104,16,48,29,48,4,34,38,51,26,1,43,53,151
13547,Tarrence Garrison,2008,2010,Prairie View,SWAC,75,736,64,160,64,159,0,1,23,41,47,122,169,17,15,62,49,73,151
13548,Dee Giger,2010,2014,Harvard,Ivy,58,449,51,142,30,67,21,75,28,37,17,31,48,16,25,2,41,48,151
13549,Shamar Givance,2019,2019,Evansville,MVC,32,545,45,129,31,84,14,45,47,63,20,67,87,75,17,1,42,67,151
13550,Christian Griggs-Williams,2014,2016,Total,Total,58,651,57,128,44,101,13,27,24,44,43,81,124,10,9,6,33,57,151
13551,Darrious Hamilton,2015,2016,Utah Valley,WAC,50,462,60,122,60,122,0,0,31,47,28,55,83,7,6,18,32,77,151
13552,John Harrar,2018,2019,Penn State,Big Ten,59,707,56,102,56,101,0,1,39,67,87,84,171,18,21,10,24,111,151
13553,John Hayward-Mayhew,2009,2012,Total,Total,64,610,48,137,40,117,8,20,47,68,43,56,99,8,7,6,38,99,151
13554,Jordan Howell,2008,2008,Tennessee,SEC,35,623,45,138,7,19,38,119,23,35,13,39,52,76,18,3,34,58,151
13555,Braden Koelliker,2017,2017,Colorado State,MWC,36,681,45,122,35,78,10,44,51,63,66,80,146,32,12,8,24,66,151
13556,Rory Lawrence,2008,2008,McNeese State,Southland,29,739,54,140,35,80,19,60,24,35,34,71,105,67,37,4,60,49,151
13557,Kievyn Lila-St. Rose,2012,2015,Norfolk State,MEAC,74,630,56,173,35,92,21,81,18,29,41,64,105,17,11,5,44,61,151
13558,Luke Loewe,2018,2019,William & Mary,CAA,58,890,62,140,53,102,9,38,18,40,18,56,74,71,17,7,44,74,151
13559,Nik Mains,2019,2019,Northern Arizona,Big Sky,31,478,54,109,39,60,15,49,28,40,15,43,58,10,14,11,16,46,151
13560,Omari Minor,2011,2014,Tennessee-Martin,OVC,90,1418,52,150,48,132,4,18,43,64,26,73,99,136,63,7,104,176,151
13561,Dominique O'Connor,2011,2012,San Francisco,WCC,26,512,52,128,48,110,4,18,43,57,5,28,33,51,31,1,49,37,151
13562,Keanu Pinder,2017,2018,Arizona,Pac-12,67,755,55,92,54,88,1,4,40,67,47,120,167,14,25,38,42,131,151
13563,Malik Pugh,2015,2017,Total,Total,55,461,55,127,44,85,11,42,30,58,8,27,35,58,17,2,54,42,151
13564,Cameron Satterwhite,2017,2018,Loyola (IL),MVC,65,750,52,138,37,79,15,59,32,47,7,89,96,49,20,8,54,62,151
13565,Jared Sherfield,2019,2019,Tennessee Tech,OVC,31,510,51,118,36,61,15,57,34,45,18,59,77,33,34,0,20,43,151
13566,Naiel Smith,2014,2016,Total,Total,66,1106,58,170,39,103,19,67,16,35,7,122,129,134,64,6,90,148,151
13567,Tyler Webb,2009,2010,Appalachian State,Southern,60,697,56,117,36,67,20,50,19,31,30,79,109,15,16,12,43,88,151
13568,D'Angelo Allen,2015,2016,Missouri,SEC,53,721,60,136,50,112,10,24,20,41,50,91,141,29,15,13,27,80,150
13569,Alex Blair,2008,2008,Fresno State,WAC,32,638,60,122,60,113,0,9,30,52,50,99,149,8,6,25,37,88,150
13570,David Brewster,2009,2010,Towson,CAA,32,510,51,160,31,80,20,80,28,43,20,43,63,17,15,6,31,49,150
13571,Eric Brooks,2009,2009,Arkansas-Pine Bluff,SWAC,23,512,49,137,38,101,11,36,41,59,19,36,55,42,41,0,35,48,150
13572,Alain Chigha,2014,2018,Quinnipiac,MAAC,96,914,55,141,41,88,14,53,26,53,60,94,154,21,46,7,38,165,150
13573,Maurice Clady,2008,2009,Long Beach State,Big West,60,1026,41,132,22,72,19,60,49,67,13,76,89,115,29,2,98,76,150
13574,Cortez Conners,2015,2015,Cal State Bakersfield,WAC,32,498,52,141,24,62,28,79,18,19,12,35,47,26,20,1,25,50,150
13575,Hunter Crist,2018,2019,Green Bay,Horizon,57,649,50,122,26,55,24,67,26,43,19,58,77,61,25,3,57,100,150
13576,Harrison Curry,2018,2019,Total,Total,20,354,57,133,55,113,2,20,34,51,30,59,89,2,12,12,20,36,150
13577,Chris Davis,2011,2012,Jacksonville,A-Sun,59,762,47,144,31,88,16,56,40,63,31,51,82,36,22,8,53,91,150
13578,Robin Duncan,2019,2019,Vermont,AEC,34,809,48,125,42,90,6,35,48,64,36,88,124,84,23,6,47,59,150
13579,Andre Gustavson,2019,2019,Richmond,A-10,31,680,57,121,41,74,16,47,20,32,24,47,71,46,33,10,26,76,150
13580,Austin Harper,2012,2013,Eastern Michigan,MAC,60,651,52,139,44,101,8,38,38,50,12,45,57,84,18,1,62,42,150
13581,Irshaad Hunte,2019,2019,Texas A&M-Corpus Christi,Southland,32,363,56,114,55,106,1,8,37,59,29,71,100,4,6,21,30,48,150
13582,Raffi Mantilla,2008,2011,Yale,Ivy,69,664,52,142,23,46,29,96,17,37,26,50,76,34,16,3,36,44,150
13583,Justin McCall,2018,2019,Cal State Bakersfield,WAC,55,599,55,115,53,107,2,8,38,62,50,60,110,19,20,18,29,54,150
13584,Negus McKenna,2008,2008,Western Carolina,Southern,30,424,53,106,22,36,31,70,13,19,36,59,95,16,11,10,23,30,150
13585,Austin Pauga,2016,2017,Northern Illinois,MAC,50,578,52,126,10,17,42,109,4,6,16,22,38,20,20,3,12,35,150
13586,Damarius Smith,2012,2012,Lipscomb,A-Sun,29,644,59,130,56,117,3,13,29,58,31,38,69,98,32,5,71,46,150
13587,Montel Smith,2009,2010,North Carolina-Greensboro,Southern,56,693,43,140,35,93,8,47,56,80,19,57,76,58,24,0,62,84,150
13588,Joshua Spiers,2015,2016,Loyola Marymount,WCC,43,481,49,121,12,26,37,95,15,19,12,38,50,23,12,4,21,46,150
13589,Jason Vegotsky,2008,2009,Bucknell,Patriot,45,550,43,146,8,25,35,121,29,34,12,53,65,31,12,1,31,50,150
13590,Brian Waters,2008,2008,Elon,Southern,32,849,51,141,40,90,11,51,37,50,19,96,115,58,26,1,39,73,150
13591,Jeremy Adams,2012,2013,Colorado,Pac-12,61,635,45,128,32,88,13,40,46,73,26,59,85,14,15,2,43,77,149
13592,Ben Altit,2012,2012,Bryant,NEC,30,587,61,156,49,108,12,48,15,22,29,50,79,14,8,37,51,70,149
13593,Alex Barcello,2018,2019,Arizona,Pac-12,51,490,51,130,29,56,22,74,25,29,5,43,48,34,13,0,18,64,149
13594,Sammy Barnes-Thompkins,2016,2016,Boston College,ACC,27,457,53,137,22,58,31,79,12,21,6,37,43,18,16,5,25,58,149
13595,Robbie Berwick,2015,2019,Total,Total,68,662,49,157,22,59,27,98,24,38,16,43,59,53,20,2,34,73,149
13596,Blake Brumwell,2012,2015,Montana State,Big Sky,99,911,65,121,65,121,0,0,19,43,76,114,190,16,6,5,44,127,149
13597,Brandon Burnett,2013,2016,Indiana State,MVC,81,619,48,139,33,69,15,70,38,49,30,72,102,22,12,4,44,82,149
13598,Jesse Byrd,2009,2009,UC-Santa Barbara,Big West,23,404,60,106,60,106,0,0,29,47,60,65,125,15,12,0,21,38,149
13599,Dorian Cason,2012,2015,Total,Total,34,587,48,123,37,82,11,41,42,66,44,92,136,9,14,21,35,82,149
13600,Kashawn Charles,2019,2019,Eastern Illinois,OVC,31,323,54,111,24,45,30,66,11,16,4,31,35,16,15,1,18,23,149
13601,Yann Charles,2011,2011,Robert Morris,NEC,32,657,62,150,61,145,1,5,24,46,33,54,87,12,13,9,41,82,149
13602,Gus Clardy,2008,2011,Pepperdine,WCC,87,963,62,115,62,113,0,2,25,42,98,99,197,24,25,12,25,155,149
13603,Tarrance Crump,2008,2008,Purdue,Big Ten,33,515,54,133,50,106,4,27,37,50,17,22,39,38,19,0,56,44,149
13604,Kye de Laveaga,2015,2018,Northern Arizona,Big Sky,62,633,45,145,2,14,43,131,16,21,5,31,36,33,17,2,27,60,149
13605,Tony Dobbinson,2015,2015,Northwestern State,Southland,27,365,52,139,19,48,33,91,12,18,12,26,38,19,8,2,36,22,149
13606,Daeshon Francis,2015,2015,Green Bay,Horizon,33,447,54,87,53,85,1,2,40,62,35,35,70,25,11,9,20,49,149
13607,Demetrius Houston,2015,2018,Total,Total,39,578,55,159,52,142,3,17,36,66,29,81,110,20,24,12,61,64,149
13608,Garrett Jefferson,2012,2013,Hawaii,Total,63,656,46,119,45,105,1,14,56,114,18,51,69,42,42,10,49,83,149
13609,Caleb Johnson,2013,2014,Missouri-Kansas City,Total,48,595,50,112,32,74,18,38,31,44,15,49,64,15,15,17,26,74,149
13610,Myles Johnson,2019,2019,Rutgers,Big Ten,31,546,66,119,66,119,0,0,17,42,79,99,178,34,23,23,35,83,149
13611,Darren Mastropaolo,2008,2008,Bucknell,Patriot,19,463,56,94,56,94,0,0,37,57,32,50,82,20,8,2,38,57,149
13612,Chris McCullough,2015,2015,Syracuse,ACC,16,450,54,113,53,112,1,1,40,71,36,74,110,18,27,33,35,41,149
13613,Nick Mcfarlin,2008,2012,Total,Total,78,605,58,120,56,114,2,6,31,44,42,73,115,20,9,5,42,102,149
13614,Dion Prewster,2011,2011,Stephen F. Austin,Southland,29,501,50,112,32,66,18,46,31,42,38,51,89,35,8,7,34,46,149
13615,Pieter Prinsolo,2011,2014,Marist,MAAC,106,932,54,141,39,94,15,47,26,39,66,108,174,6,14,46,39,142,149
13616,Cooper Robb,2019,2019,Charlotte,CUSA,22,645,53,138,27,61,26,77,17,31,12,73,85,43,23,10,39,65,149
13617,David Simmons,2018,2018,Middle Tennessee,CUSA,32,573,54,103,48,84,6,19,35,55,26,57,83,51,17,3,37,78,149
13618,Josh Tabb,2008,2009,Tennessee,SEC,61,827,59,118,41,70,18,48,13,30,33,69,102,87,43,6,48,77,149
13619,Brody Van Brocklin,2008,2008,Weber State,Big Sky,30,797,48,129,13,37,35,92,18,24,7,52,59,59,28,2,29,54,149
13620,Devin Vassell,2019,2019,Florida State,ACC,33,353,52,119,26,57,26,62,19,28,13,38,51,21,18,10,12,30,149
13621,Lucas Walker,2008,2009,Saint Mary's (CA),WCC,50,471,55,119,40,65,15,54,24,40,33,67,100,17,26,14,24,68,149
13622,Josh Williams,2008,2009,Troy,Sun Belt,53,553,49,122,27,66,22,56,29,38,14,56,70,59,34,1,48,57,149
13623,Jeameril Wilson,2019,2019,Lehigh,Patriot,31,509,52,95,43,77,9,18,36,45,21,61,82,23,12,11,36,63,149
13624,Shakwon Barrett,2018,2019,Tulane,AAC,38,700,50,147,37,96,13,51,35,58,12,45,57,81,21,3,76,56,148
13625,Demarcus Bryant,2015,2015,Savannah State,MEAC,29,464,52,161,15,38,37,123,7,8,8,17,25,10,6,1,30,36,148
13626,Maizen Fausett,2019,2019,Southern Utah,Big Sky,33,433,50,121,39,78,11,43,37,58,41,66,107,12,10,17,17,60,148
13627,Lonnie Funderburke,2009,2010,Tennessee State,OVC,60,830,51,111,51,111,0,0,46,78,56,98,154,13,16,15,51,143,148
13628,Jim Griffin,2008,2009,Samford,Total,62,1059,46,114,39,79,7,35,49,72,42,100,142,94,31,4,55,114,148
13629,Tim Harrison,2017,2019,Rice,CUSA,70,538,56,135,42,73,14,62,22,34,26,74,100,11,9,16,41,81,148
13630,Steven Hill,2008,2008,Arkansas,SEC,35,570,59,87,59,87,0,0,30,51,42,60,102,9,19,74,35,86,148
13631,Isaac Humphries,2016,2017,Kentucky,SEC,61,525,61,129,61,129,0,0,26,40,71,91,162,11,10,34,26,104,148
13632,Marvin Jean,2013,2013,Utah State,WAC,31,684,50,139,19,47,31,92,17,24,20,65,85,56,20,13,44,38,148
13633,Clay Johnson,2011,2012,Arkansas-Pine Bluff,SWAC,57,1065,52,106,50,89,2,17,42,66,24,81,105,82,50,7,90,105,148
13634,Elijah Lee,2017,2018,Pepperdine,WCC,42,736,45,125,27,81,18,44,40,58,9,63,72,90,34,3,71,55,148
13635,Luke Loehr,2018,2019,Navy,Patriot,32,463,58,118,49,85,9,33,23,34,37,58,95,16,5,3,26,55,148
13636,Jules Moor,2019,2019,Stony Brook,AEC,33,419,52,126,42,102,10,24,34,48,27,55,82,21,34,10,33,68,148
13637,Daniel Moore,2009,2012,Indiana,Big Ten,107,1006,44,103,35,75,9,28,51,72,19,67,86,119,56,0,101,127,148
13638,Ike Nweke,2019,2019,Columbia,Ivy,28,367,55,112,55,112,0,0,38,60,47,53,100,8,7,4,28,47,148
13639,Terrence Parker,2018,2018,Tennessee-Martin,OVC,31,524,60,108,60,108,0,0,28,46,48,102,150,18,14,15,46,79,148
13640,Jervae Robinson,2019,2019,Washington State,Pac-12,32,578,57,152,38,86,19,66,15,22,6,39,45,60,14,1,40,52,148
13641,Asown Sayles,2008,2011,Ohio,MAC,71,928,54,151,43,102,11,49,29,44,56,123,179,35,29,10,32,90,148
13642,Leo Svete,2015,2016,IUPUI,Summit,37,476,48,161,15,39,33,122,19,28,3,29,32,9,7,1,23,40,148
13643,Allen Tate,2012,2013,Seattle,Total,47,695,61,167,57,138,4,29,22,40,54,81,135,34,49,3,56,84,148
13644,Devin Thomas,2018,2019,Indiana State,MVC,42,535,44,117,32,76,12,41,48,64,36,87,123,21,10,15,49,58,148
13645,Josh Warren,2013,2014,Troy,Sun Belt,64,826,63,122,63,121,0,1,22,44,100,145,245,11,18,35,27,131,148
13646,Gabe Watson,2019,2019,Southern Mississippi,CUSA,33,467,55,141,29,54,26,87,12,18,17,46,63,36,7,3,28,33,148
13647,Tanner Wozniak,2012,2015,Total,Total,72,597,47,153,14,38,33,115,21,27,8,27,35,16,8,1,37,43,148
13648,Kanu Aja,2015,2016,East Carolina,AAC,59,636,62,139,62,139,0,0,23,59,55,79,134,13,6,9,34,87,147
13649,Allen Betrand,2019,2019,Towson,CAA,32,573,55,155,40,102,15,53,22,30,20,49,69,26,15,4,29,53,147
13650,Izaiah Brockington,2018,2018,St. Bonaventure,A-10,34,396,52,118,30,65,22,53,21,39,8,34,42,30,14,5,14,27,147
13651,Eli Brooks,2018,2019,Michigan,Big Ten,68,787,56,161,32,72,24,89,11,17,11,68,79,70,23,6,30,38,147
13652,DJ Bryant,2017,2019,Texas-Arlington,Sun Belt,95,1136,43,120,26,49,17,71,44,55,12,80,92,130,62,2,76,119,147
13653,Dominic Early,2012,2014,Furman,Southern,41,488,50,147,30,65,20,82,27,42,24,54,78,17,13,5,15,44,147
13654,Sam Griesel,2019,2019,North Dakota State,Summit,24,613,57,123,49,91,8,32,25,43,24,67,91,35,13,2,31,36,147
13655,Patrick Hendley,2012,2014,Savannah State,MEAC,79,579,55,144,40,100,15,44,22,33,18,36,54,28,27,13,46,53,147
13656,Luidgy Laporal,2019,2019,Saint Francis (PA),NEC,33,475,62,130,62,130,0,0,23,38,56,55,111,7,5,6,37,68,147
13657,Chris Lester,2018,2019,New Hampshire,AEC,30,546,60,134,45,91,15,43,12,24,59,67,126,33,15,3,27,57,147
13658,Ben Martin,2010,2012,Nicholls State,Southland,42,980,45,138,7,18,38,120,19,25,14,60,74,54,42,3,26,74,147
13659,Maljhum McCrea,2016,2017,Texas State,Sun Belt,41,473,65,145,65,141,0,4,17,43,46,67,113,13,4,18,36,87,147
13660,Lucas Moormann,2009,2009,North Dakota State,Summit,33,669,66,123,65,118,1,5,14,32,55,78,133,22,31,19,19,87,147
13661,Marek Nelson,2018,2019,Western Kentucky,CUSA,56,597,54,115,46,93,8,22,31,55,29,64,93,16,19,16,38,74,147
13662,Trey Patterson,2015,2016,Houston Baptist,Southland,52,573,54,93,53,80,1,13,38,80,12,35,47,55,28,2,56,80,147
13663,Adam Roe,2016,2017,Army,Patriot,42,371,48,128,15,38,33,90,18,29,20,30,50,13,14,2,21,39,147
13664,Jordan Scott,2011,2012,College of Charleston,Southern,54,531,52,137,23,47,29,90,14,17,6,31,37,24,25,9,35,44,147
13665,Carson Smith,2016,2018,South Carolina Upstate,A-Sun,48,609,61,127,50,86,11,41,14,19,35,62,97,43,16,4,29,80,147
13666,Brian Thomas,2018,2019,Florida Gulf Coast,A-Sun,41,593,63,94,63,94,0,0,21,48,51,104,155,8,12,50,34,54,147
13667,Kenny Tribbett,2008,2010,Drexel,CAA,69,680,54,121,54,121,0,0,39,57,61,91,152,5,10,16,60,117,147
13668,Daddy Ugbede,2013,2014,Drake,MVC,44,400,52,94,52,94,0,0,43,63,30,57,87,5,8,1,27,71,147
13669,Royce Williams,2013,2014,Weber State,Big Sky,58,552,52,112,27,55,25,57,18,27,6,50,56,37,8,4,32,59,147
13670,Drew Wilson,2013,2015,Total,Total,68,857,67,116,67,115,0,1,13,62,93,116,209,18,29,34,31,119,147
13671,Tremell Adams,2011,2011,Lamar,Southland,20,260,47,116,17,37,30,79,22,26,19,21,40,12,10,0,23,25,146
13672,Fardaws Aimaq,2019,2019,Mercer,Southern,29,431,62,120,61,119,1,1,21,50,65,88,153,7,6,22,40,71,146
13673,Tony Anderson II,2016,2016,Southeast Missouri State,OVC,29,426,49,120,42,100,7,20,41,55,23,39,62,8,11,6,32,21,146
13674,Tyler Baker,2008,2010,Liberty,Big South,31,387,49,110,37,70,12,40,36,46,28,51,79,18,12,6,30,61,146
13675,Jalin Barnes,2016,2016,Sam Houston State,Southland,34,642,55,148,35,88,20,60,16,25,7,80,87,61,27,5,49,77,146
13676,Thomas Bookman,2008,2008,South Carolina State,MEAC,31,546,50,145,19,45,31,100,15,25,15,41,56,33,21,1,38,32,146
13677,David Buchanon,2009,2009,Florida A&M,MEAC,31,,49,117,22,52,27,65,21,27,6,19,25,43,16,0,39,48,146
13678,Mike Buckley,2009,2009,Coppin State,MEAC,21,381,55,135,33,71,22,64,14,23,16,36,52,10,10,1,24,33,146
13679,Torin Childs-Harris,2014,2015,Morgan State,MEAC,34,470,47,146,36,89,11,57,41,60,18,33,51,12,24,2,28,54,146
13680,David Copeland,2012,2013,Grambling,SWAC,40,985,46,122,42,103,4,19,50,75,13,93,106,101,25,0,87,90,146
13681,Paul Cummins,2008,2008,Lafayette,Patriot,27,366,51,127,15,23,36,104,8,13,9,32,41,24,12,0,20,27,146
13682,Chad Donley,2013,2015,Total,Total,62,453,47,137,11,26,36,111,16,26,9,32,41,25,15,1,18,44,146
13683,Jonathan Gunderson,2008,2008,Santa Clara,WCC,30,581,48,106,10,12,38,94,12,12,4,33,37,38,8,1,24,25,146
13684,Jermaine Harris,2019,2019,Rhode Island,A-10,33,569,49,110,49,99,0,11,48,63,32,62,94,12,15,10,44,93,146
13685,Arkeem Joseph,2015,2015,Tennessee-Martin,OVC,30,466,69,132,69,132,0,0,8,27,42,42,84,6,1,4,31,52,146
13686,Ian Markolf,2009,2014,Total,Total,27,498,61,135,61,135,0,0,24,59,49,106,155,41,7,29,51,62,146
13687,Ernest Maul,2008,2008,Florida A&M,MEAC,32,,48,147,15,54,33,93,17,30,16,34,50,52,27,0,61,55,146
13688,Jordan McKenzie,2018,2019,Stony Brook,AEC,61,895,58,161,48,102,10,59,20,29,11,67,78,107,30,3,48,87,146
13689,Tre O'Neal,2016,2017,Nicholls State,Southland,52,796,44,133,30,80,14,53,44,71,16,43,59,66,26,1,67,53,146
13690,Jeff Otchere,2019,2019,Stony Brook,AEC,33,594,55,98,55,98,0,0,36,55,54,86,140,16,8,76,38,99,146
13691,Damari Parris,2017,2019,Total,Total,45,549,52,162,35,97,17,65,25,30,12,31,43,54,18,1,34,36,146
13692,Marko Petrovic,2011,2011,San Francisco,WCC,25,436,49,114,22,37,27,77,21,29,7,40,47,26,10,2,28,51,146
13693,Oskar Reinfelds,2013,2015,Total,Total,36,541,50,132,31,75,19,57,27,51,15,44,59,48,18,0,47,53,146
13694,Mohamed Sherif,2018,2018,Alabama A&M,SWAC,22,555,60,143,60,142,0,1,26,78,36,53,89,17,4,9,50,66,146
13695,Germaine Sparkes,2010,2010,North Florida,A-Sun,31,601,47,126,25,59,22,67,30,42,7,68,75,30,25,5,39,66,146
13696,Lance Stemler,2008,2008,Indiana,Big Ten,33,680,52,129,23,40,29,89,13,17,31,68,99,21,26,7,8,78,146
13697,Jamual Warren,2008,2008,Cincinnati,Big East,26,839,59,153,48,111,11,42,17,29,24,99,123,105,40,1,49,52,146
13698,Joey Woods,2008,2008,Bethune-Cookman,MEAC,32,889,55,114,49,97,6,17,30,48,20,47,67,76,34,3,82,70,146
13699,Mobolaji Ajayi,2008,2009,South Florida,Big East,47,694,62,136,62,136,0,0,21,46,97,97,194,10,13,21,47,119,145
13700,Jabril Bailey,2009,2009,Campbell,A-Sun,29,378,51,136,38,86,13,50,30,41,16,31,47,16,19,10,30,22,145
13701,Dan Biber,2009,2009,Dartmouth,Ivy,25,385,53,134,31,76,22,58,17,24,20,45,65,12,4,4,28,32,145
13702,Shunn Buchanan,2018,2019,New Mexico State,WAC,69,1067,41,158,22,88,19,70,44,65,11,104,115,143,33,3,72,98,145
13703,Tray Buchanan,2018,2018,North Dakota,Big Sky,31,372,45,130,20,51,25,79,30,38,7,25,32,21,27,0,26,45,145
13704,Ron Coleman,2008,2008,Michigan,Big Ten,30,682,54,143,31,70,23,73,14,22,34,63,97,39,7,4,31,22,145
13705,J.J. Cravatta,2013,2014,Northern Illinois,MAC,57,513,39,136,7,26,32,110,35,49,22,32,54,12,17,1,21,37,145
13706,Kris Douse,2008,2010,Delaware State,MEAC,50,546,57,142,49,117,8,25,23,53,21,56,79,15,12,10,61,73,145
13707,Zach Fields,2010,2013,Ball State,MAC,71,604,64,127,64,127,0,0,17,32,38,58,96,11,10,12,48,91,145
13708,Jerran Foster,2015,2016,Florida A&M,MEAC,56,858,49,177,22,80,27,97,20,41,6,55,61,64,20,2,69,59,145
13709,Kevin Francis,2008,2008,Cleveland State,Horizon,34,634,55,146,37,82,18,64,17,28,60,73,133,22,13,16,34,68,145
13710,Robert Garrett,2012,2014,Santa Clara,WCC,89,773,59,114,59,114,0,0,27,65,60,106,166,8,12,81,32,145,145
13711,Andrew Guillory,2015,2015,Southeastern Louisiana,Southland,18,486,46,101,41,80,5,21,48,67,16,47,63,37,12,1,26,25,145
13712,Joe Hanstad,2012,2015,Boise State,MWC,75,727,47,118,21,36,26,82,25,33,9,48,57,42,18,3,30,48,145
13713,Blake Harris,2018,2019,Total,Total,44,480,50,120,42,94,8,26,37,51,13,60,73,90,36,0,54,63,145
13714,Frank Holmes,2008,2008,Alabama-Birmingham,CUSA,34,407,52,76,52,75,0,1,41,64,37,69,106,6,13,11,18,86,145
13715,Darion Jeralds,2008,2010,North Carolina-Wilmington,CAA,90,1154,48,105,31,67,17,38,32,45,18,60,78,94,25,3,71,103,145
13716,Mike Josserand,2008,2009,Southern Utah,Summit,59,910,47,150,27,74,20,76,31,43,13,59,72,136,54,1,109,114,145
13717,Mike Kale,2008,2008,Idaho,WAC,29,553,64,132,64,132,0,0,17,41,40,42,82,12,10,4,43,96,145
13718,Jared Kimbrough,2019,2019,La Salle,A-10,29,547,60,98,60,98,0,0,25,47,57,84,141,19,15,20,34,76,145
13719,Isaiah Omoregie,2016,2016,Florida A&M,MEAC,19,296,61,101,61,100,0,1,23,56,24,40,64,2,6,6,26,44,145
13720,Tom Parks,2009,2010,Youngstown State,Horizon,36,519,50,130,11,27,39,103,6,10,19,37,56,14,12,1,35,34,145
13721,Reggie Porter,2008,2011,Alabama A&M,SWAC,78,573,43,126,27,71,16,55,43,53,12,34,46,51,16,0,75,63,145
13722,Benjamin Stanley,2019,2019,Hampton,Big South,33,346,59,100,58,98,1,2,26,44,39,58,97,4,4,15,17,51,145
13723,Gerrell Thomas,2008,2008,Northwestern State,Southland,23,356,50,113,36,77,14,36,31,43,30,56,86,25,9,7,47,45,145
13724,L.J. Thorpe,2018,2019,North Carolina-Asheville,Big South,17,389,47,120,35,77,12,43,39,57,12,45,57,42,16,2,44,37,145
13725,Clay Verk,2017,2019,Stetson,A-Sun,56,543,54,153,45,125,9,28,28,60,40,62,102,17,9,4,38,79,145
13726,Jason Walberg,2008,2008,Pepperdine,WCC,17,421,43,117,23,55,20,62,39,51,5,30,35,43,20,2,29,38,145
13727,Ryan Wall,2008,2008,Texas Christian,MWC,30,326,43,105,8,18,35,87,24,29,8,20,28,22,24,1,24,34,145
13728,Dalvin White,2019,2019,South Carolina Upstate,Big South,32,650,48,146,20,53,28,93,21,29,6,43,49,90,17,1,42,53,145
13729,Kevin Abanobi,2008,2008,Texas Southern,SWAC,30,659,49,141,37,80,12,61,34,48,31,66,97,11,13,20,33,78,144
13730,Adam Allen,2008,2011,Florida,SEC,37,374,52,108,20,32,32,76,8,13,10,19,29,15,6,3,23,47,144
13731,Peyton Allen,2015,2015,Texas A&M,SEC,32,452,49,129,19,36,30,93,16,20,5,19,24,15,8,4,18,42,144
13732,Canaan Bartley,2019,2019,Maryland-Eastern Shore,MEAC,32,768,52,152,51,141,1,11,39,53,21,96,117,38,33,3,55,71,144
13733,Andrew Bastien,2016,2017,Utah Valley,WAC,51,594,56,107,56,107,0,0,32,56,58,116,174,12,8,50,29,97,144
13734,Tai Bibbs,2018,2019,Columbia,Ivy,41,573,50,152,29,71,21,81,23,38,19,38,57,22,14,3,23,55,144
13735,Jonah Bolden,2016,2016,UCLA,Pac-12,31,672,51,123,42,87,9,36,33,45,36,114,150,33,21,27,26,64,144
13736,Thomas Booker,2017,2019,South Carolina Upstate,Total,38,405,54,133,41,96,13,37,23,28,26,23,49,14,18,2,20,46,144
13737,Braden Burke,2017,2019,Total,Total,41,500,63,149,63,149,0,0,18,46,30,59,89,4,11,10,33,78,144
13738,Flynn Clayman,2008,2011,Total,Total,49,541,53,149,34,87,19,62,19,29,24,46,70,19,6,12,33,80,144
13739,Cliff Cornish,2014,2015,Total,Total,57,634,54,142,54,141,0,1,36,56,53,77,130,21,12,20,42,95,144
13740,Mamadou Diene,2008,2009,Baylor,Big 12,58,784,55,82,55,82,0,0,34,56,65,90,155,8,8,66,29,137,144
13741,Nick Foreman,2009,2012,Georgia Tech,ACC,106,928,49,115,30,66,19,49,27,39,38,58,96,34,32,10,25,139,144
13742,Alex Gauna,2012,2014,Michigan State,Big Ten,94,562,63,113,63,112,0,1,18,40,34,62,96,10,9,11,33,81,144
13743,Will Gladson,2017,2019,Princeton,Ivy,51,511,55,137,37,79,18,58,16,25,18,48,66,30,10,18,25,67,144
13744,Brian Glowiak,2008,2008,Hartford,AEC,33,424,47,114,4,12,43,102,7,11,6,27,33,23,5,1,14,31,144
13745,Steve Gruber,2008,2010,Brown,Ivy,67,522,36,94,23,63,13,31,59,71,5,36,41,54,21,0,43,60,144
13746,Chuck Hannah,2019,2019,Elon,CAA,32,629,59,114,45,66,14,48,12,22,39,51,90,20,16,7,18,88,144
13747,James Hemphill,2014,2017,Navy,Patriot,73,621,60,109,60,108,0,1,24,58,51,74,125,18,14,3,29,71,144
13748,Dwayne Johnson,2008,2008,North Carolina-Greensboro,Southern,30,944,36,115,25,69,11,46,61,88,15,77,92,128,30,2,57,58,144
13749,Jerry Jones,2009,2010,Bethune-Cookman,MEAC,40,679,63,143,53,110,10,33,8,19,14,57,71,37,19,7,39,53,144
13750,Houston King,2019,2019,Eastern Kentucky,OVC,27,470,47,121,15,46,32,75,18,24,15,33,48,20,18,1,24,50,144
13751,Mike Marcial,2009,2010,Sacramento State,Big Sky,59,1257,46,121,27,68,19,53,33,47,9,101,110,180,40,2,85,88,144
13752,Patrick Myers,2013,2015,South Carolina State,MEAC,52,759,51,171,36,109,15,62,27,40,40,61,101,40,23,5,51,67,144
13753,Cameron Posey,2018,2019,Arkansas-Pine Bluff,SWAC,64,869,46,134,26,72,20,62,32,39,20,52,72,50,35,3,78,81,144
13754,Max Rockmann,2010,2011,Missouri-Kansas City,Summit,34,658,46,126,29,70,17,56,35,51,15,50,65,29,13,0,38,56,144
13755,Austin Starr,2016,2018,Total,Total,46,570,40,145,6,24,34,121,30,38,17,30,47,30,17,0,24,77,144
13756,Hyman Taylor,2008,2009,San Francisco,WCC,52,716,50,129,50,129,0,0,44,74,50,118,168,18,21,35,62,116,144
13757,Robert Thomas,2016,2017,Southern Mississippi,CUSA,55,602,40,106,13,33,27,73,37,48,8,49,57,46,14,0,42,52,144
13758,Larry Vickers,2008,2008,Norfolk State,MEAC,31,835,66,137,66,137,0,0,12,33,49,128,177,28,37,47,57,114,144
13759,Elijah Weaver,2019,2019,Southern California,Pac-12,28,574,53,126,31,64,22,62,16,21,10,37,47,66,17,4,48,42,144
13760,Ross Wilson,2013,2014,Rice,CUSA,57,875,63,130,63,130,0,0,18,34,44,70,114,41,13,3,55,124,144
13761,Brandon Younger,2019,2019,Charlotte,CUSA,25,588,51,140,33,85,18,55,24,30,12,67,79,19,14,13,30,48,144
13762,Rodney Alexander,2008,2008,Illinois,Big Ten,31,424,49,126,38,69,11,57,34,48,38,52,90,11,11,4,25,31,143
13763,D.J. Bennett,2014,2015,Oklahoma,Big 12,61,517,54,100,54,100,0,0,35,55,37,77,114,5,10,44,27,96,143
13764,Tanner Borchardt,2016,2019,Nebraska,Big Ten,65,863,57,95,57,95,0,0,29,54,108,104,212,18,19,14,23,124,143
13765,Orlando Brazier,2011,2011,Lamar,Southland,26,331,59,137,59,137,0,0,25,38,43,49,92,8,12,18,26,43,143
13766,David Chadwick,2011,2015,Total,Total,76,536,61,122,50,84,11,38,10,22,20,56,76,14,9,16,24,38,143
13767,Derrell Conner,2011,2011,Nevada,WAC,32,385,54,146,32,74,22,72,13,29,13,22,35,48,15,1,39,39,143
13768,Ed Croswell,2019,2019,La Salle,A-10,31,591,55,100,55,100,0,0,33,52,98,118,216,18,14,21,43,64,143
13769,Anastasios Demogerontas,2018,2019,Northern Illinois,MAC,38,557,52,114,43,82,9,32,30,45,27,49,76,26,23,4,36,48,143
13770,Jamaal Douglas,2008,2008,Eastern Kentucky,OVC,29,619,54,100,51,81,3,19,32,42,41,69,110,66,25,20,41,76,143
13771,Nathaniel Drayton,2012,2012,Florida A&M,MEAC,32,384,58,128,57,125,1,3,26,49,37,44,81,4,17,14,33,85,143
13772,Zach Everingham,2008,2008,Detroit Mercy,Horizon,29,691,46,122,16,39,30,83,21,25,29,61,90,75,26,6,26,69,143
13773,Marquis Godwin,2018,2019,Old Dominion,CUSA,31,379,48,134,8,24,40,110,7,8,3,44,47,4,3,2,12,21,143
13774,Lonnie Hayes,2012,2012,Fairleigh Dickinson,NEC,11,400,49,143,39,103,10,40,35,50,8,28,36,45,22,0,48,31,143
13775,Jesse Hill,2016,2017,Florida Atlantic,CUSA,34,564,50,136,32,82,18,54,25,41,17,64,81,12,7,21,10,63,143
13776,Edwin Jeudy,2019,2019,Lamar,Southland,28,464,52,129,38,84,14,45,25,38,34,69,103,17,13,4,27,70,143
13777,Greg Jones,2018,2019,James Madison,CAA,64,845,52,131,44,95,8,36,31,42,67,92,159,16,25,25,48,125,143
13778,Zack Leahy,2011,2011,Toledo,MAC,30,547,41,119,20,58,21,61,40,63,5,36,41,33,24,1,54,44,143
13779,Kyle Madsen,2008,2010,Ohio State,Big Ten,78,772,58,108,58,108,0,0,27,35,46,73,119,15,17,19,39,93,143
13780,Ajak Magot,2014,2015,Idaho State,Big Sky,50,744,58,123,58,122,0,1,27,46,58,62,120,10,16,30,27,116,143
13781,Josip Mikulic,2013,2013,Fairfield,MAAC,33,472,54,140,25,47,29,93,6,9,22,41,63,16,9,21,33,68,143
13782,Mike Miller,2008,2008,Coppin State,MEAC,32,621,51,158,38,105,13,53,28,43,18,45,63,25,27,1,41,54,143
13783,Austin Mills,2013,2016,Total,Total,73,584,40,127,21,47,19,80,44,60,7,31,38,54,16,5,53,53,143
13784,Brendon Myles,2017,2019,Florida A&M,MEAC,65,737,56,145,40,103,16,42,15,23,42,83,125,17,16,7,60,68,143
13785,Jared Norsworthy,2014,2015,Howard,MEAC,48,598,45,113,34,75,11,38,42,74,24,53,77,14,29,4,38,63,143
13786,Michael O'Donnell,2015,2016,Southern Mississippi,CUSA,44,621,51,122,24,56,27,66,14,27,28,55,83,23,11,10,37,92,143
13787,Gilbert Parga,2014,2014,Long Island University,NEC,19,349,37,104,23,56,14,48,55,74,7,42,49,15,5,1,23,24,143
13788,Noah Springwater,2012,2015,Columbia,Ivy,90,714,40,122,6,17,34,105,29,34,5,48,53,27,34,7,24,69,143
13789,Cameron Wolter,2017,2017,Massachusetts-Lowell,AEC,30,332,57,114,55,104,2,10,27,38,17,26,43,9,11,6,20,60,143
13790,Jarvis Acker,2008,2008,Troy,Sun Belt,25,552,59,152,41,89,18,63,6,17,32,64,96,10,23,39,19,64,142
13791,Ed Berrios,2008,2009,Alabama-Birmingham,CUSA,42,745,43,121,13,50,30,71,26,33,5,60,65,103,17,0,53,45,142
13792,Gifford Blakely,2008,2010,Alcorn State,SWAC,59,681,58,133,58,133,0,0,26,49,45,84,129,10,21,12,37,107,142
13793,Anthony Brown,2008,2009,Oklahoma State,Big 12,47,617,54,112,53,105,1,7,33,58,48,62,110,13,12,19,20,92,142
13794,Taylor Bruninga,2018,2018,Illinois State,MVC,29,506,46,120,11,20,35,100,15,21,15,54,69,13,5,6,11,85,142
13795,Eric Dearden,2010,2010,Utah Valley,GWC,28,537,49,129,37,91,12,38,32,41,4,32,36,40,27,1,45,39,142
13796,Greg Dotson,2014,2014,Morehead State,OVC,29,482,52,104,52,94,0,10,38,57,32,37,69,21,13,18,20,47,142
13797,Quamauri Hardy,2018,2019,Arkansas-Pine Bluff,SWAC,66,934,56,146,49,116,7,30,23,41,32,46,78,85,48,1,57,90,142
13798,Carter Hendricksen,2019,2019,North Florida,A-Sun,33,561,44,129,19,37,25,92,29,36,25,105,130,42,8,6,41,57,142
13799,Daron Henson,2018,2018,Utah State,MWC,33,413,46,133,8,34,38,99,12,22,20,44,64,7,1,2,13,50,142
13800,Jalen Hill,2019,2019,UCLA,Pac-12,33,669,49,87,49,87,0,0,44,65,62,137,199,40,13,13,36,70,142
13801,Noah Knight,2015,2016,Missouri-Kansas City,WAC,28,456,43,105,30,55,13,50,43,73,23,41,64,35,36,4,29,71,142
13802,Paulin Mpawe,2014,2016,Idaho,Total,74,782,52,123,52,123,0,0,38,78,76,90,166,11,12,20,43,113,142
13803,C.J. Prince,2009,2010,Howard,MEAC,40,472,42,140,3,22,39,118,19,25,10,29,39,13,12,1,26,18,142
13804,Magnus Richards,2014,2015,Binghamton,AEC,55,830,52,143,52,142,0,1,38,64,51,99,150,25,19,12,76,133,142
13805,Lamar Thomas,2009,2013,Total,Total,97,946,61,155,61,153,0,2,20,48,91,95,186,11,13,28,43,170,142
13806,Moses Abraham,2011,2015,Total,Total,87,919,52,99,52,99,0,0,37,79,82,153,235,25,18,43,62,188,141
13807,Joe Boyd,2014,2015,Cal State Fullerton,Big West,59,860,51,128,51,126,0,2,39,49,57,129,186,15,8,12,41,107,141
13808,Marshall Brown,2008,2008,Missouri,Big 12,31,406,52,127,35,83,17,44,20,32,21,38,59,29,14,9,25,40,141
13809,Jabari Craig,2017,2018,East Carolina,AAC,47,704,50,133,50,132,0,1,41,74,72,111,183,14,10,37,50,103,141
13810,Duke Crews,2008,2008,Tennessee,SEC,26,384,52,103,52,103,0,0,37,55,53,50,103,16,11,10,24,64,141
13811,Sam Daly,2014,2015,Grand Canyon,WAC,34,664,49,110,43,82,6,28,37,62,14,57,71,91,21,5,70,70,141
13812,Carlos Dos Santos,2011,2011,Central Arkansas,Southland,27,500,58,117,58,117,0,0,25,44,39,67,106,19,14,15,33,67,141
13813,Maka Ellis,2019,2019,Columbia,Ivy,25,413,53,114,31,61,22,53,13,14,10,46,56,26,13,0,24,22,141
13814,Raiquan Gray,2019,2019,Florida State,ACC,36,441,50,115,40,83,10,32,31,43,23,60,83,27,29,6,33,62,141
13815,Ryann Green,2012,2015,Georgia State,Total,89,931,43,119,24,45,19,74,36,50,19,77,96,60,51,3,34,91,141
13816,Lasse Gummerus,2018,2018,Marist,MAAC,29,416,47,109,16,26,31,83,16,18,7,61,68,13,5,1,12,14,141
13817,Mitchell Hampton,2008,2009,Louisiana-Monroe,Sun Belt,47,596,54,122,54,122,0,0,33,69,50,96,146,7,5,24,33,76,141
13818,Allan Hanson,2008,2008,Milwaukee,Horizon,30,697,34,118,12,29,22,89,51,66,15,54,69,66,17,0,35,57,141
13819,Jordan Hare,2013,2013,Rhode Island,A-10,27,529,62,106,62,106,0,0,17,38,41,68,109,10,9,49,31,66,141
13820,Matt Hayes,2015,2016,Loyola Marymount,WCC,43,507,47,138,10,40,37,98,10,12,9,31,40,26,9,0,19,29,141
13821,Mikey Henn,2017,2017,UC-Davis,Big West,34,447,53,126,39,90,14,36,21,38,17,37,54,22,8,3,40,71,141
13822,Kyle Koszuta,2013,2014,Louisiana-Monroe,Sun Belt,48,606,46,129,12,40,34,89,15,24,3,30,33,55,32,0,50,57,141
13823,David Levitch,2014,2017,Louisville,Total,89,571,41,104,13,40,28,64,31,49,19,43,62,47,20,0,20,62,141
13824,Jonathan Lewis,2010,2013,Jackson State,SWAC,103,1594,42,125,20,66,22,59,35,64,38,113,151,160,83,1,93,149,141
13825,Maurice Lewis-Briggs,2013,2013,Morehead State,OVC,17,304,53,120,44,81,9,39,26,37,28,59,87,14,19,3,33,41,141
13826,Sedric Martin,2011,2012,Cal State Fullerton,Big West,51,481,58,112,58,112,0,0,25,39,51,39,90,14,6,7,39,66,141
13827,Ishmawiyl McFadden,2008,2008,Maryland-Eastern Shore,MEAC,29,535,58,180,48,142,10,38,15,31,29,45,74,15,14,21,42,52,141
13828,Asbjorn Midtgaard,2018,2019,Wichita State,AAC,42,431,59,96,59,96,0,0,23,39,45,78,123,6,4,29,23,70,141
13829,Milan Mijovic,2015,2018,Marshall,CUSA,89,755,53,103,52,101,1,2,34,60,43,85,128,26,16,9,48,132,141
13830,Laurynas Mikalauskas,2008,2008,Virginia,ACC,20,352,53,81,53,81,0,0,35,56,36,34,70,10,5,2,15,42,141
13831,Marty O'Sullivan,2008,2008,Fairfield,MAAC,28,397,50,128,41,96,9,32,32,46,36,56,92,32,7,5,27,54,141
13832,Omar Richards,2012,2012,Binghamton,AEC,27,574,57,121,54,115,3,6,24,48,25,77,102,11,12,13,45,69,141
13833,Derrick Richardson,2013,2014,Central Michigan,MAC,58,687,46,116,36,79,10,37,39,67,48,58,106,25,31,1,45,82,141
13834,Isaiah Salafia,2011,2014,Yale,Ivy,69,744,42,132,14,57,28,75,29,40,8,44,52,50,18,3,67,103,141
13835,Lamount Samuell,2011,2012,Fordham,A-10,40,537,45,123,37,93,8,30,43,71,14,48,62,64,23,4,70,70,141
13836,Alex Thompson,2008,2009,Iowa State,Big 12,63,843,62,147,56,123,6,24,11,27,44,104,148,39,13,37,43,92,141
13837,Neal Webb,2011,2012,Southern,SWAC,54,633,48,147,19,47,29,100,16,23,16,50,66,23,18,4,40,64,141
13838,Jordan Wood,2011,2012,Montana,Big Sky,57,759,53,146,33,59,20,87,15,41,21,73,94,47,24,4,45,69,141
13839,D'Marco Baucum,2019,2019,Delaware State,MEAC,17,432,48,133,38,98,10,35,34,41,35,34,69,15,9,8,25,48,140
13840,Gavin Baxter,2019,2019,Brigham Young,WCC,30,441,59,91,57,85,2,6,20,39,32,60,92,7,5,33,14,57,140
13841,Riley Bradshaw,2014,2016,Montana,Big Sky,78,802,49,145,27,71,22,74,20,25,10,47,57,46,12,1,39,70,140
13842,Justin Clark,2010,2011,Illinois State,MVC,59,845,50,158,26,55,24,103,16,27,14,74,88,52,25,6,42,65,140
13843,Marquavese Ford,2012,2012,Northern Illinois,MAC,31,562,55,142,47,111,8,31,22,39,7,43,50,63,26,4,69,57,140
13844,Jovan Grujic,2016,2019,Stephen F. Austin,Southland,100,716,57,142,56,131,1,11,25,38,42,75,117,15,11,17,66,95,140
13845,Calvin Hampton,2008,2010,Oregon State,Pac-10,72,603,60,141,60,140,0,1,20,25,46,65,111,12,8,10,42,101,140
13846,Keith Hayes II,2016,2016,Massachusetts-Lowell,AEC,23,320,41,92,27,54,14,38,44,54,8,25,33,16,14,1,16,29,140
13847,Daniel Hayles,2008,2009,South Alabama,Sun Belt,36,600,43,111,29,73,14,38,40,69,43,55,98,51,38,2,41,72,140
13848,Dwight Holmes,2008,2008,Youngstown State,Horizon,30,485,49,95,48,94,1,1,41,63,31,43,74,18,11,17,22,56,140
13849,Deonte Houston,2014,2014,Southern Mississippi,CUSA,36,651,40,116,32,88,8,28,52,81,15,35,50,64,29,0,37,55,140
13850,Donterious Hughes,2009,2009,Appalachian State,Southern,30,417,56,137,53,121,3,16,25,53,26,40,66,31,19,3,43,36,140
13851,Davis Jocolby,2008,2008,East Tennessee State,A-Sun,31,596,41,102,34,85,7,17,51,90,17,47,64,92,28,8,72,68,140
13852,Dylan Jones,2014,2019,Total,Total,74,486,54,103,54,103,0,0,32,72,39,45,84,9,14,10,37,95,140
13853,Lucas Jones,2016,2019,Eastern Illinois,OVC,76,794,51,121,29,62,22,59,16,21,41,99,140,34,15,17,23,50,140
13854,Dave Krmpotich,2016,2017,Colgate,Patriot,35,413,55,124,55,121,0,3,30,57,23,43,66,8,7,15,35,61,140
13855,Travis Lewis,2008,2008,Eastern Michigan,MAC,29,739,45,104,17,36,28,68,22,34,38,128,166,52,44,7,38,70,140
13856,Nate Louis,2019,2019,Charleston Southern,Big South,28,368,46,112,4,21,42,91,6,8,4,18,22,24,12,3,10,30,140
13857,Chris Malcolm,2009,2010,Winthrop,Big South,60,618,54,125,53,124,1,1,31,59,65,96,161,14,8,55,42,97,140
13858,Dravon Mangum,2019,2019,Charlotte,CUSA,29,560,43,117,27,58,16,59,38,60,24,51,75,12,10,15,35,58,140
13859,Karim Mawuenyega,2014,2015,South Carolina Upstate,A-Sun,34,462,51,134,25,57,26,77,12,23,6,31,37,44,24,1,27,42,140
13860,Austin Pennick,2009,2010,North Dakota State,Summit,44,704,53,133,51,124,2,9,32,62,12,57,69,70,19,2,42,97,140
13861,Eugene Pettway,2008,2008,Sacred Heart,NEC,30,414,45,100,45,100,0,0,50,74,29,34,63,17,21,13,21,38,140
13862,Jarrod Polson,2011,2014,Kentucky,SEC,94,800,48,113,33,65,15,48,29,43,23,59,82,53,14,4,42,79,140
13863,Kaipo Sabas,2011,2012,Colorado State,MWC,32,681,46,96,18,33,28,63,20,25,10,59,69,33,17,0,35,46,140
13864,Kelson Stewart,2008,2010,Little Rock,Sun Belt,41,502,44,122,27,83,17,39,35,43,24,28,52,21,6,2,16,27,140
13865,Jamal Thomas,2017,2018,Charleston Southern,Big South,34,408,43,116,15,33,28,83,26,41,16,52,68,26,16,5,30,66,140
13866,Tim Thomas,2013,2014,Pacific,Total,54,432,59,120,59,118,0,2,22,37,38,57,95,12,7,13,28,69,140
13867,Jeffrey Uju,2017,2019,Bowling Green State,MAC,66,708,58,117,55,106,3,11,21,39,59,113,172,17,12,13,30,80,140
13868,Rasason Young,2010,2010,Montana,Big Sky,31,385,56,127,29,62,27,65,1,5,11,33,44,12,6,0,22,38,140
13869,Marlon Adams,2017,2017,Eastern Kentucky,OVC,31,540,59,113,55,100,4,13,17,48,45,82,127,12,10,10,37,76,139
13870,Shareif Adamu,2011,2011,Alabama State,SWAC,31,517,48,107,46,93,2,14,41,73,24,54,78,17,10,29,33,73,139
13871,Job Alexander,2019,2019,Cal Poly,Big West,27,533,57,130,57,123,0,7,25,51,19,35,54,41,15,2,38,40,139
13872,Dontay Bassett,2018,2019,Florida,SEC,60,574,50,102,46,87,4,15,35,54,61,60,121,13,16,25,24,108,139
13873,Stanley Billings,2008,2008,Central Florida,CUSA,24,444,53,100,53,100,0,0,33,54,42,51,93,18,8,31,29,73,139
13874,Charles Boozer,2008,2010,Iowa State,Big 12,54,447,43,118,23,45,20,73,33,51,28,51,79,19,19,3,19,38,139
13875,Sean Coleman,2009,2010,Houston,CUSA,49,525,51,123,23,47,28,76,9,13,29,44,73,7,7,10,15,91,139
13876,Nikola Djogo,2018,2019,Notre Dame,ACC,53,766,50,150,27,63,23,87,16,29,25,91,116,40,16,10,24,50,139
13877,Caleb Fields,2019,2019,Bowling Green State,MAC,33,570,50,139,22,51,28,88,11,18,16,38,54,25,15,2,12,41,139
13878,Rashaad Goolsby,2019,2019,Portland State,Big Sky,32,587,44,93,42,76,2,17,49,74,48,70,118,24,22,13,25,47,139
13879,Seth Gorney,2008,2008,Iowa,Big Ten,32,817,57,135,55,124,2,11,23,30,32,133,165,31,11,12,37,63,139
13880,Jamir Hanner,2012,2013,Marshall,CUSA,53,379,54,100,50,92,4,8,27,63,62,66,128,15,11,10,31,50,139
13881,Kamani Johnson,2019,2019,Little Rock,Sun Belt,27,519,53,96,53,95,0,1,33,65,51,79,130,37,14,13,41,85,139
13882,Nevin Johnson,2013,2015,Total,Total,56,541,42,113,26,54,16,59,39,54,22,58,80,27,9,3,31,51,139
13883,EJ Montgomery,2019,2019,Kentucky,SEC,37,558,60,125,58,115,2,10,17,30,62,88,150,15,16,38,29,79,139
13884,Vincenzo Nelson,2011,2012,Lamar,Southland,50,549,44,114,41,98,3,16,48,73,24,76,100,37,17,8,43,83,139
13885,Zimmy Nwogbo,2010,2011,Charleston Southern,Big South,51,575,48,114,47,110,1,4,42,63,45,80,125,20,24,10,41,55,139
13886,Cory Pfleiger,2011,2011,Rice,CUSA,32,681,44,126,4,17,40,109,11,15,6,59,65,46,13,2,24,41,139
13887,Sam Phippen,2008,2010,UC-Santa Barbara,Big West,71,546,51,107,37,71,14,36,23,41,17,80,97,13,6,6,32,56,139
13888,Mickey Polis,2008,2009,Portland State,Big Sky,49,399,42,92,7,18,35,74,20,25,8,26,34,36,14,0,34,38,139
13889,Nenad Tomic,2012,2015,Cornell,Ivy,66,400,52,112,52,111,0,1,35,49,39,44,83,5,4,5,18,54,139
13890,Oliver Tot,2015,2018,William & Mary,CAA,112,1052,44,94,33,61,11,33,40,60,18,99,117,129,38,25,72,126,139
13891,Andre Toure,2019,2019,Howard,MEAC,28,514,56,127,53,107,3,20,24,60,37,57,94,16,15,19,36,60,139
13892,Chris Turner,2009,2010,East Carolina,CUSA,39,514,49,161,28,100,21,61,20,41,28,57,85,32,18,1,38,40,139
13893,Jake Wasco,2011,2012,Maryland-Baltimore County,AEC,53,775,59,131,59,130,0,1,21,41,66,79,145,23,12,6,32,111,139
13894,Jerard Ajami,2010,2011,Milwaukee,Horizon,64,1035,42,147,21,67,21,80,33,58,34,96,130,58,24,6,39,91,138
13895,Mitch Baenziger,2013,2014,Oakland,Total,46,545,44,116,13,33,31,83,19,29,12,31,43,18,15,2,18,68,138
13896,Shane Benton,2013,2016,North Dakota,Big Sky,69,638,45,130,29,71,16,59,32,57,17,58,75,28,17,1,31,83,138
13897,Gediminas Bertasius,2011,2011,Dartmouth,Ivy,28,531,47,126,43,102,4,24,40,59,21,77,98,15,11,7,48,62,138
13898,James Blasczyk,2009,2013,Total,Total,67,781,60,132,60,132,0,0,18,33,48,75,123,17,15,12,35,80,138
13899,Bobby Frasor,2008,2009,North Carolina,ACC,50,857,50,149,21,46,29,103,9,19,25,72,97,79,34,7,36,61,138
13900,Wesley Green,2008,2008,DePaul,Big East,29,549,56,149,47,123,9,26,17,25,27,97,124,27,15,24,48,47,138
13901,Khari Harley,2015,2018,Total,Total,52,740,40,120,25,68,15,52,43,56,19,48,67,30,17,9,38,84,138
13902,Jake Holtzmann,2016,2018,Denver,Summit,50,585,40,113,15,38,25,75,33,40,14,50,64,47,8,3,40,42,138
13903,Clinton Houston,2008,2010,San Diego,WCC,67,722,45,108,45,106,0,2,48,72,52,94,146,13,15,21,37,120,138
13904,Walter Jones Jr.,2019,2019,Alabama A&M,SWAC,30,633,55,160,39,97,16,63,12,25,17,70,87,35,33,5,42,89,138
13905,C.J. Kelly,2019,2019,Norfolk State,MEAC,31,380,46,100,35,59,11,41,35,54,8,52,60,13,20,15,42,50,138
13906,Bol Kong,2010,2010,Gonzaga,WCC,31,389,48,105,24,48,24,57,18,26,14,32,46,18,14,0,15,21,138
13907,Malte Kramer,2013,2014,Pepperdine,WCC,33,439,46,108,14,30,32,78,14,24,6,37,43,22,3,4,18,43,138
13908,Andrija Matic,2016,2017,American,Patriot,47,551,49,111,39,79,10,32,30,50,36,48,84,30,4,9,52,65,138
13909,Alexis Moore,2012,2012,Southern California,Pac-12,32,794,49,171,23,79,26,92,14,24,8,57,65,49,20,2,40,64,138
13910,Bj Nimocks,2008,2008,Maryland-Eastern Shore,MEAC,31,534,53,91,51,84,2,7,30,49,60,68,128,10,14,10,27,46,138
13911,Rell Porter,2008,2008,Liberty,Big South,32,671,51,114,26,46,25,68,11,20,34,65,99,33,16,10,25,85,138
13912,William Pugh,2011,2012,Mississippi Valley State,SWAC,34,420,46,144,29,75,17,69,29,35,22,50,72,26,28,1,25,79,138
13913,Collin Robinson,2008,2008,Cornell,Ivy,13,350,54,119,43,86,11,33,19,23,4,25,29,57,16,2,35,24,138
13914,Ian Salter,2009,2010,Toledo,MAC,64,955,53,115,53,115,0,0,32,58,54,101,155,10,20,17,42,138,138
13915,Jay Simpson,2013,2014,Purdue,Big Ten,36,388,58,136,57,126,1,10,21,41,45,71,116,17,15,14,29,55,138
13916,Steve Smith,2014,2016,Fairfield,MAAC,60,528,45,144,4,10,41,134,7,9,11,52,63,15,7,3,18,53,138
13917,Christopher Spears,2011,2013,Savannah State,Total,86,799,58,121,57,120,1,1,21,40,58,75,133,9,19,13,52,125,138
13918,Jonnie West,2008,2011,West Virginia,Big East,77,350,44,112,13,28,31,84,19,21,4,30,34,18,2,1,6,19,138
13919,Moses Wood,2019,2019,Tulane,AAC,31,560,45,115,26,64,19,51,29,37,26,69,95,29,16,16,27,67,138
13920,Xavier Alexander,2008,2009,George Washington,A-10,36,733,45,116,39,96,6,20,41,105,51,77,128,50,40,11,65,79,137
13921,James Anderson,2009,2011,Brigham Young,MWC,87,548,57,123,57,123,0,0,23,59,47,65,112,14,13,38,18,138,137
13922,Ike Anigbogu,2017,2017,UCLA,Pac-12,29,377,57,101,57,101,0,0,23,43,41,76,117,6,5,35,24,72,137
13923,Jacob Boonyasith,2019,2019,American,Patriot,30,493,48,112,21,38,27,74,14,22,2,44,46,23,10,9,22,58,137
13924,Marcus Burwell,2015,2019,Total,Total,41,512,48,138,31,70,17,68,24,38,24,54,78,45,16,13,27,51,137
13925,Jamal Dantzler,2013,2014,Texas-Rio Grande Valley,Total,58,609,51,119,41,91,10,28,25,59,39,57,96,29,18,5,39,53,137
13926,Ben Freeland,2013,2016,Lafayette,Patriot,96,718,61,118,61,118,0,0,15,26,35,118,153,13,22,19,52,145,137
13927,Freddie Gillespie,2019,2019,Baylor,Big 12,26,476,60,92,60,92,0,0,17,32,55,59,114,9,17,28,26,71,137
13928,Dwight Gordon,2010,2010,UC-Riverside,Big West,25,529,54,139,47,114,7,25,22,39,3,27,30,39,13,5,24,28,137
13929,Willie Hassell,2008,2008,Canisius,MAAC,24,414,55,154,33,62,22,92,5,9,10,37,47,30,18,0,43,32,137
13930,Carlos Jurgens,2019,2019,Oral Roberts,Summit,30,671,49,146,17,44,32,102,7,20,6,48,54,60,24,8,49,39,137
13931,Philip Jurick,2012,2013,Oklahoma State,Big 12,60,1016,63,100,63,100,0,0,11,31,111,214,325,31,13,82,55,165,137
13932,Ryan King,2014,2015,Northwestern State,Southland,47,524,57,99,57,99,0,0,23,47,46,64,110,6,7,26,19,57,137
13933,Lamar Lee,2008,2010,Total,Total,49,462,46,132,15,36,31,96,14,18,4,24,28,31,15,2,21,27,137
13934,Brant Leitnaker,2009,2010,Indiana State,MVC,55,661,46,108,46,107,0,1,45,64,44,48,92,19,16,20,37,73,137
13935,Paul Newman,2018,2019,Bucknell,Patriot,53,496,50,103,50,102,0,1,37,70,31,85,116,15,17,39,34,89,137
13936,Michael Prince,2008,2009,Texas Tech,Big 12,48,598,56,92,55,86,1,6,24,55,45,67,112,29,32,8,37,80,137
13937,Chris Reynolds,2009,2010,Campbell,A-Sun,53,437,49,119,49,115,0,4,39,60,42,57,99,15,19,9,46,57,137
13938,Evan Richard,2011,2015,Milwaukee,Horizon,77,638,46,140,32,81,14,59,31,36,18,43,61,20,13,3,31,35,137
13939,Patson Siame,2015,2015,Loyola Marymount,WCC,24,481,63,139,63,138,0,1,11,28,29,67,96,6,5,25,33,68,137
13940,Drew Streicher,2008,2008,Butler,Horizon,34,978,54,118,35,59,19,59,10,15,43,49,92,49,22,13,26,99,137
13941,Darrian Traylor,2017,2019,UC-Irvine,Big West,72,420,44,121,12,27,32,94,17,30,17,59,76,26,8,2,24,36,137
13942,Amir Warnock,2017,2017,Alabama State,SWAC,31,440,61,123,61,123,0,0,15,36,54,97,151,7,6,14,36,72,137
13943,C.J. Washington,2011,2012,Oklahoma,Big 12,61,714,52,107,52,107,0,0,33,52,70,128,198,9,24,30,21,96,137
13944,James Williams,2009,2010,Norfolk State,MEAC,40,422,46,128,8,22,38,106,7,13,10,29,39,11,12,0,24,34,137
13945,Cress Worthy,2019,2019,North Carolina-Asheville,Big South,31,745,49,142,35,85,14,57,25,37,22,86,108,66,28,2,54,75,137
13946,Conroy Baltimore,2012,2015,Lehigh,Patriot,69,545,52,110,52,110,0,0,32,46,61,88,149,10,15,23,32,87,136
13947,Kevin Canevari,2011,2014,Mercer,A-Sun,136,1011,45,116,21,50,24,66,22,25,16,55,71,129,61,0,81,83,136
13948,Prince Cooper,2015,2017,Louisiana-Monroe,Sun Belt,56,471,57,111,52,99,5,12,17,40,20,53,73,32,9,3,42,26,136
13949,Jakigh Dottin,2019,2019,Towson,CAA,32,560,55,146,54,135,1,11,25,43,16,57,73,60,16,0,35,29,136
13950,Hyron Edwards,2019,2019,Colorado State,MWC,20,421,42,123,30,82,12,41,40,49,7,48,55,49,27,2,36,35,136
13951,Dennis Harris,2010,2011,Louisiana State,SEC,33,441,57,115,52,99,5,16,17,32,29,67,96,13,10,16,23,69,136
13952,Markell Henderson,2016,2017,Tennessee Tech,OVC,41,350,51,122,31,55,20,67,14,21,16,33,49,10,11,9,12,40,136
13953,Dane Johnson,2010,2011,Portland State,Big Sky,58,810,43,92,17,28,26,64,24,38,11,46,57,127,30,0,52,51,136
13954,Marques Johnson,2008,2009,Boston University,AEC,58,1048,53,147,42,85,11,62,19,31,24,81,105,122,38,1,63,71,136
13955,Jake Kuhn,2018,2019,Cornell,Ivy,43,453,51,135,27,44,24,91,10,20,8,50,58,14,6,1,16,24,136
13956,Richardson Maitre,2019,2019,Florida Atlantic,CUSA,31,710,41,140,26,88,15,52,39,50,11,104,115,83,24,3,57,40,136
13957,Ulmer Manzie,2017,2019,Bethune-Cookman,MEAC,49,703,48,120,48,120,0,0,40,84,70,67,137,23,22,34,49,127,136
13958,Josh Martin,2008,2008,Albany (NY),AEC,25,526,42,119,21,62,21,57,31,42,13,66,79,53,13,0,49,41,136
13959,Jake Matthews,2011,2014,Cornell,Ivy,46,618,42,121,15,38,27,83,25,34,8,33,41,29,22,1,28,54,136
13960,Carter McMasters,2009,2011,Liberty,Big South,52,662,52,139,44,114,8,25,24,33,25,88,113,17,15,43,38,60,136
13961,Rayquawndis Mitchell,2019,2019,Idaho,Big Sky,31,565,39,113,12,33,27,80,31,38,5,50,55,37,6,0,31,31,136
13962,Richard Morrow,2013,2014,Florida Atlantic,Total,46,580,50,117,48,111,2,6,34,60,37,83,120,23,4,3,47,75,136
13963,Ben Murdock,2008,2008,Brigham Young,MWC,35,950,39,117,17,41,22,76,36,50,6,77,83,125,19,3,52,63,136
13964,Churchill Odia,2008,2009,Oregon,Pac-10,55,778,47,118,18,32,29,86,13,21,32,70,102,44,18,2,26,82,136
13965,Jeremy Purvis,2013,2015,Austin Peay,OVC,43,831,41,122,8,26,33,96,21,30,8,56,64,85,35,3,36,47,136
13966,Mirza Sabic,2011,2012,Kennesaw State,A-Sun,52,491,45,115,19,44,26,71,20,32,13,37,50,11,6,2,36,42,136
13967,Bourama Sidibe,2018,2019,Syracuse,ACC,59,666,50,93,50,93,0,0,36,83,66,107,173,9,25,34,36,139,136
13968,Cameron Smith,2015,2018,Dartmouth,Ivy,70,540,41,118,35,91,6,27,48,71,13,38,51,36,20,3,26,66,136
13969,Ifeanyi Umezurike,2016,2019,Total,Total,62,614,53,121,53,121,0,0,30,57,53,97,150,6,11,10,53,121,136
13970,Isaiah Wade,2019,2019,Washington State,Pac-12,29,421,60,107,60,102,0,5,16,41,36,65,101,16,13,3,27,63,136
13971,Menelik Watson,2011,2011,Marist,MAAC,29,468,49,103,47,100,2,3,36,69,35,61,96,11,6,0,38,82,136
13972,Nate Wells,2013,2016,Total,Total,86,633,56,128,53,114,3,14,21,40,30,70,100,16,13,31,27,95,136
13973,Demontrez Austin,2016,2017,Jacksonville,A-Sun,57,824,54,101,54,101,0,0,27,35,71,145,216,15,14,13,28,86,135
13974,Chris Balham,2008,2009,Nebraska,Big 12,59,524,50,83,50,83,0,0,35,53,48,63,111,8,3,8,39,65,135
13975,Jerimyjah Batts,2014,2016,Coppin State,MEAC,74,775,52,132,52,132,0,0,31,55,45,69,114,13,9,19,35,172,135
13976,Daquan Brown,2013,2014,Total,Total,34,450,54,119,54,119,0,0,27,47,32,53,85,8,8,11,30,50,135
13977,Richard Caldwell,2019,2019,Binghamton,AEC,32,505,43,141,22,59,21,82,28,46,11,58,69,9,11,12,25,55,135
13978,D'Von Campbell,2014,2014,Rutgers,AAC,25,434,45,117,24,54,21,63,24,36,8,22,30,37,9,1,22,32,135
13979,Andrew Del Piero,2012,2013,Louisiana State,SEC,35,435,55,104,55,104,0,0,25,48,40,59,99,4,5,35,27,44,135
13980,TK Edogi,2017,2017,Tulsa,AAC,32,368,49,80,49,79,0,1,37,52,51,66,117,8,8,13,22,50,135
13981,Keyshawn Embery,2019,2019,Arkansas,SEC,33,483,47,136,24,51,23,85,18,26,9,29,38,20,24,2,22,42,135
13982,Kalu Ezikpe,2019,2019,Old Dominion,CUSA,34,359,49,91,49,91,0,0,37,53,53,45,98,7,9,27,26,66,135
13983,Alex Farrer,2008,2010,Louisiana State,SEC,60,711,45,126,31,73,14,53,31,46,16,56,72,53,21,11,45,75,135
13984,Corey Hensley,2012,2015,Gardner-Webb,Big South,77,573,60,121,60,121,0,0,15,27,38,63,101,8,6,10,29,80,135
13985,Devin Hutchinson,2019,2019,Radford,Big South,33,324,44,101,16,25,28,76,19,23,10,28,38,18,3,1,18,31,135
13986,Jacob Ivory,2015,2016,Middle Tennessee,CUSA,38,525,34,95,32,78,2,17,65,78,6,41,47,52,15,1,44,53,135
13987,David Johnson,2008,2008,Southeast Missouri State,OVC,29,498,46,136,25,62,21,74,22,36,30,67,97,39,38,12,54,61,135
13988,Owen King,2019,2019,South Dakota State,Summit,33,550,54,110,39,64,15,46,12,15,2,50,52,75,22,3,47,71,135
13989,Richard Laku,2017,2019,McNeese State,Southland,55,406,43,127,17,45,26,82,23,31,30,39,69,9,8,12,17,62,135
13990,Emanuel Littles,2019,2019,North Alabama,A-Sun,30,674,55,130,54,124,1,6,24,49,90,149,239,17,9,17,37,78,135
13991,Brett Loscalzo,2008,2008,Columbia,Ivy,27,732,37,101,2,11,35,90,26,33,10,29,39,80,15,0,39,60,135
13992,J.J. N'Ganga,2015,2017,Total,Total,59,590,55,102,55,102,0,0,25,46,37,63,100,10,3,9,48,86,135
13993,Alex Rivas,2009,2010,South Florida,Big East,47,632,53,100,53,100,0,0,29,51,48,115,163,4,20,19,43,91,135
13994,Anthony Roberson,2016,2016,Texas State,Sun Belt,29,620,50,94,48,86,2,8,33,64,63,83,146,19,19,17,22,77,135
13995,Daniel Sackey,2019,2019,Valparaiso,MVC,33,588,48,133,39,93,9,40,30,47,4,48,52,61,24,0,56,36,135
13996,Josue Soto,2009,2009,Florida International,Sun Belt,13,411,48,116,27,56,21,60,18,25,5,27,32,41,5,0,28,16,135
13997,George Thomas,2014,2015,Alcorn State,SWAC,57,766,43,134,21,53,22,81,27,43,40,93,133,19,27,14,38,93,135
13998,Jason Wade,2019,2019,Old Dominion,CUSA,35,665,56,129,51,113,5,16,18,37,64,61,125,55,33,13,42,69,135
13999,Trace Young,2019,2019,Wyoming,MWC,20,476,50,127,23,54,27,73,8,17,8,59,67,16,15,9,43,35,135
14000,Bejay Corley,2008,2009,Mercer,A-Sun,62,880,63,97,63,97,0,0,8,35,63,102,165,23,18,13,28,78,134
14001,JJ Cratit,2016,2016,Central Connecticut State,NEC,18,346,44,139,25,85,19,54,27,44,5,21,26,9,7,6,22,30,134
14002,Payton Dastrup,2017,2018,Brigham Young,WCC,55,355,51,107,35,62,16,45,16,24,17,72,89,19,12,19,27,45,134
14003,Jermain Davis,2009,2009,Iowa,Big Ten,30,618,42,123,25,54,17,69,33,44,8,81,89,49,8,2,34,48,134
14004,Walter Davis,2013,2014,Florida A&M,MEAC,63,1112,57,111,57,109,0,2,20,57,79,138,217,42,31,48,40,100,134
14005,Johathan Frazier,2008,2008,Texas Southern,SWAC,32,684,57,112,52,97,5,15,15,33,41,66,107,66,42,3,55,82,134
14006,Sean Grennan,2012,2016,Total,Total,62,655,39,118,14,39,25,79,31,39,8,37,45,53,10,2,45,62,134
14007,Bryce Hamilton,2019,2019,Nevada-Las Vegas,MWC,31,402,48,136,27,65,21,71,17,27,8,41,49,19,10,5,16,38,134
14008,Bryson Hampton,2009,2010,UC-Riverside,Big West,38,651,59,121,59,121,0,0,16,26,61,73,134,8,8,24,19,74,134
14009,Corey Heyward,2014,2017,Georgia Tech,ACC,96,1394,41,136,22,76,19,60,33,58,30,101,131,93,53,7,54,144,134
14010,Hugh Hogland,2019,2019,Portland,WCC,30,461,53,98,53,98,0,0,28,50,32,63,95,16,10,10,41,44,134
14011,Brian Johnson,2008,2009,Mississippi State,SEC,54,501,48,87,48,85,0,2,38,58,57,61,118,14,20,18,55,67,134
14012,Rakwan Kelly,2015,2015,Mississippi Valley State,SWAC,32,577,47,118,46,116,1,2,39,66,49,52,101,27,31,5,31,57,134
14013,Trey Lowe,2016,2016,Temple,AAC,28,342,51,129,34,63,17,66,15,19,15,29,44,16,13,1,11,16,134
14014,Dwight McCombs,2011,2012,Central Florida,CUSA,47,574,51,85,51,85,0,0,32,57,43,81,124,7,12,37,27,82,134
14015,Daniel Mitchell,2009,2012,Radford,Big South,72,663,52,164,34,88,18,76,12,24,24,60,84,25,22,5,23,74,134
14016,Jason Owens,2014,2016,Delaware State,MEAC,67,631,56,154,55,150,1,4,21,39,33,103,136,18,13,11,41,95,134
14017,Will Peeples,2008,2008,Belmont,A-Sun,33,674,38,84,35,77,3,7,55,81,32,66,98,47,31,10,52,80,134
14018,Brad Reid,2012,2013,Missouri-Kansas City,Summit,47,507,56,107,56,107,0,0,22,36,50,78,128,10,7,33,19,85,134
14019,Yevgen Sakhniuk,2016,2017,La Salle,A-10,36,340,58,95,57,89,1,6,17,43,20,30,50,22,10,11,37,58,134
14020,Waylan Siverand,2012,2014,North Carolina A&T,MEAC,64,581,49,96,49,96,0,0,36,65,48,48,96,10,11,25,35,92,134
14021,Joel Smith,2008,2008,Washington,Pac-10,33,500,49,107,24,48,25,59,11,19,27,38,65,41,21,8,34,49,134
14022,Tate Sorenson,2008,2008,Southern Utah,Summit,22,395,55,98,55,98,0,0,24,52,40,55,95,18,11,14,29,62,134
14023,Blaise Staab,2009,2012,Columbia,Ivy,49,468,55,122,53,116,2,6,22,42,44,73,117,18,18,3,26,57,134
14024,Rasham Suarez,2015,2015,Southern Mississippi,CUSA,18,550,45,115,15,38,30,77,14,23,5,53,58,65,15,1,45,39,134
14025,Philip Tabet,2008,2010,South Alabama,Sun Belt,86,756,47,96,47,94,0,2,40,64,84,99,183,12,14,16,33,112,134
14026,Chris Watson,2009,2009,Florida Atlantic,Sun Belt,32,595,56,121,56,119,0,2,22,35,43,74,117,11,18,12,43,102,134
14027,Jason Williams,2017,2018,East Tennessee State,Southern,55,561,42,108,10,33,32,75,18,27,8,37,45,72,21,2,54,47,134
14028,Phil Winston,2017,2017,Quinnipiac,MAAC,31,488,39,99,32,73,7,26,49,75,14,37,51,96,10,1,47,47,134
14029,Dewayne Wright,2009,2010,Eastern Illinois,OVC,58,451,44,120,30,78,14,42,32,47,7,19,26,41,23,0,38,44,134
14030,Luke Adams,2012,2015,Texas Tech,Big 12,64,600,32,109,5,29,27,80,42,53,5,32,37,43,25,0,48,58,133
14031,Anthony Allen,2015,2016,Oklahoma State,Big 12,56,524,49,87,49,87,0,0,35,66,42,93,135,18,4,54,56,90,133
14032,Greg Allen,2012,2013,Southern California,Pac-12,33,604,45,143,14,37,31,106,12,17,4,46,50,29,11,0,23,36,133
14033,John Balwigaire,2012,2012,Wright State,Horizon,31,578,46,124,22,56,24,68,17,23,8,30,38,32,23,1,21,54,133
14034,Derek Benter,2011,2011,North Dakota,GWC,33,547,45,106,43,96,2,10,41,61,27,73,100,13,10,10,45,77,133
14035,Drake Beranek,2011,2011,Nebraska,Big 12,32,563,47,111,31,60,16,51,23,28,8,70,78,30,19,3,32,46,133
14036,Taylor Brown,2012,2014,Utah Valley,Total,86,932,43,139,12,27,31,112,16,29,26,58,84,53,26,5,30,71,133
14037,Santoine Butler,2011,2012,Gardner-Webb,Big South,43,381,54,95,54,95,0,0,25,37,31,46,77,5,5,26,20,61,133
14038,Arinze Chidom,2018,2019,Washington State,Pac-12,36,390,46,113,28,67,18,46,23,31,23,66,89,17,20,5,23,58,133
14039,Tyson Cunningham,2012,2014,Mississippi State,SEC,74,918,43,123,16,48,27,75,20,28,31,63,94,56,32,2,51,70,133
14040,Ante Dzepina,2009,2010,Northern Illinois,MAC,54,479,49,103,49,102,0,1,35,69,43,86,129,11,11,14,32,86,133
14041,Cayne Edwards,2016,2019,Army,Patriot,48,376,49,94,48,89,1,5,34,50,38,74,112,8,15,12,21,50,133
14042,Rafael Farley,2014,2014,Abilene Christian,Southland,27,421,44,111,11,35,33,76,12,18,8,27,35,12,4,2,18,33,133
14043,Matthew French,2008,2008,Gardner-Webb,A-Sun,28,450,50,88,45,74,5,14,28,53,30,58,88,12,14,12,29,72,133
14044,Dylan Haines,2014,2017,Boston University,Patriot,74,563,54,136,40,85,14,51,11,22,35,88,123,20,8,29,44,81,133
14045,James Harper,2013,2013,Houston Baptist,GWC,30,408,46,121,33,71,13,50,28,41,13,44,57,17,16,7,35,34,133
14046,Canberk Kus,2019,2019,Arkansas State,Sun Belt,24,391,46,124,31,70,15,54,26,31,13,46,59,25,18,16,33,50,133
14047,Malik London,2016,2017,Tennessee-Martin,OVC,46,383,57,85,57,85,0,0,19,38,39,71,110,9,7,28,24,68,133
14048,John Oates,2008,2008,Boston College,ACC,31,624,44,97,19,38,25,59,20,28,18,86,104,29,14,28,33,63,133
14049,Jay Parker,2013,2015,Illinois-Chicago,Horizon,60,674,37,133,31,93,6,40,53,69,14,65,79,99,33,5,73,73,133
14050,Terrence Parkes,2008,2009,Delaware State,MEAC,52,546,51,124,45,105,6,19,25,39,43,58,101,14,8,5,31,35,133
14051,Cordarius Samples,2013,2014,Mississippi Valley State,SWAC,44,405,43,104,33,82,10,22,37,57,5,33,38,36,14,1,50,54,133
14052,Kramer Soderberg,2009,2010,Miami (OH),MAC,59,610,42,116,23,50,19,66,30,45,2,35,37,44,16,3,40,61,133
14053,Nikola Stojakovic,2008,2008,Morehead State,OVC,30,1014,39,116,34,92,5,24,50,83,15,84,99,204,37,3,100,85,133
14054,Darien Williams,2016,2018,Total,Total,42,432,47,96,44,82,3,14,36,49,24,73,97,6,13,15,28,73,133
14055,Javien Williams,2017,2017,Alabama-Birmingham,CUSA,33,505,42,112,39,88,3,24,46,68,26,38,64,36,11,7,26,26,133
14056,Jacob Baryenbruch,2008,2009,Drake,MVC,66,713,39,141,3,9,36,132,18,24,4,41,45,65,14,0,35,30,132
14057,Carmelo Betancourt,2013,2014,Akron,MAC,65,918,48,132,39,88,9,44,27,47,10,55,65,125,38,2,109,101,132
14058,Caleb Catto,2019,2019,Florida Gulf Coast,A-Sun,32,574,51,118,31,58,20,60,10,17,13,64,77,55,18,5,54,41,132
14059,Derek Fracalossi,2008,2008,Western Michigan,MAC,32,533,42,106,25,52,17,54,31,40,25,44,69,24,14,3,31,47,132
14060,Bubba Furlong,2018,2019,Sam Houston State,Southland,51,425,51,104,46,93,5,11,25,35,47,60,107,12,12,23,36,72,132
14061,Evin Graham,2012,2013,Jacksonville,A-Sun,54,880,41,113,34,92,7,21,43,77,44,92,136,75,36,7,70,79,132
14062,Lamar Hamrick,2019,2019,Detroit Mercy,Horizon,27,443,49,105,40,73,9,32,25,41,24,55,79,31,32,5,29,38,132
14063,Cole Harrison,2014,2018,Total,Total,78,454,56,119,56,119,0,0,20,37,37,74,111,13,3,14,36,98,132
14064,Maleke Haynes,2016,2017,Pacific,WCC,52,785,41,145,28,83,13,62,37,58,8,65,73,98,24,5,71,88,132
14065,Shane Henry,2015,2016,Virginia Tech,ACC,64,605,56,119,56,119,0,0,20,56,42,111,153,5,14,40,34,102,132
14066,Brayden Holker,2017,2017,Southern Utah,Big Sky,33,486,49,88,49,88,0,0,34,54,41,42,83,4,7,8,24,79,132
14067,Cardell Hunter,2008,2008,Texas-Arlington,Southland,33,714,48,126,48,116,0,10,36,54,16,52,68,92,32,2,84,80,132
14068,Dagur Jonsson,2016,2016,St. Francis (NY),NEC,32,542,42,149,18,56,24,93,24,34,8,32,40,43,7,0,38,31,132
14069,Francis Lacis,2019,2019,Oral Roberts,Summit,28,494,47,110,16,27,31,83,7,14,18,58,76,21,15,8,26,48,132
14070,Fletcher Larson,2012,2015,Youngstown State,Horizon,86,792,59,129,59,129,0,0,14,17,35,78,113,25,7,27,32,129,132
14071,Stephane Manga,2014,2015,Seton Hall,Big East,47,492,51,112,48,100,3,12,27,52,19,61,80,18,13,9,45,66,132
14072,Jonny Marlin,2012,2014,Total,Total,48,858,37,119,11,45,26,74,32,36,6,46,52,107,27,1,52,47,132
14073,Ervins Meznieks,2016,2019,Boston College,ACC,56,706,44,134,15,36,29,98,15,25,19,60,79,36,21,4,32,76,132
14074,Matt O'Boyle,2016,2017,Appalachian State,Sun Belt,53,521,45,124,18,34,27,90,15,32,30,61,91,26,9,4,23,59,132
14075,Chris Rhymes,2009,2009,Cal State Fullerton,Big West,29,378,45,109,33,71,12,38,30,44,18,38,56,16,12,4,25,43,132
14076,A.J. Rogers,2009,2013,Total,Total,86,628,52,107,52,107,0,0,28,54,38,66,104,13,22,26,39,89,132
14077,Torico Simmons,2019,2019,Mississippi Valley State,SWAC,32,573,48,128,32,79,16,49,20,28,20,51,71,55,19,0,38,44,132
14078,Jared Stigall,2009,2010,Sacramento State,Big Sky,58,873,41,136,10,43,31,93,19,28,6,64,70,83,24,0,46,68,132
14079,Darius Tomlin,2013,2013,Mississippi Valley State,SWAC,24,421,48,115,48,107,0,8,36,59,7,31,38,37,21,0,57,49,132
14080,Michael Webb,2010,2011,Prairie View,SWAC,51,514,52,87,52,87,0,0,28,60,41,56,97,7,8,18,27,83,132
14081,Trajan Wesley,2019,2019,Louisiana,Sun Belt,28,471,33,81,28,61,5,20,61,73,4,22,26,42,23,2,29,55,132
14082,Charles White,2010,2012,Hartford,AEC,55,617,54,132,52,116,2,16,22,40,33,34,67,35,19,1,42,68,132
14083,Eric Wilson,2008,2008,Western Carolina,Southern,31,791,51,135,38,89,13,46,17,23,37,60,97,51,19,4,52,81,132
14084,Jack Anton,2015,2018,Elon,CAA,91,762,48,111,41,83,7,28,28,48,36,85,121,22,6,9,21,118,131
14085,Daryl Arnold,2008,2010,Total,Total,31,425,48,115,35,73,13,42,22,40,28,56,84,6,9,11,35,28,131
14086,Matt Ballard,2011,2012,San Jose State,WAC,63,1573,40,124,40,123,0,1,51,79,104,189,293,37,21,25,33,172,131
14087,Marquell Carter,2019,2019,Arkansas-Pine Bluff,SWAC,29,619,47,126,30,75,17,51,20,28,30,70,100,31,18,6,39,62,131
14088,Julian Clarke,2011,2014,Santa Clara,WCC,77,556,45,132,19,44,26,88,15,25,7,22,29,28,9,3,25,47,131
14089,Terrance Coleman,2010,2010,Tennessee-Martin,OVC,29,499,44,130,34,94,10,36,33,53,48,37,85,21,12,4,31,42,131
14090,Gary Cox,2011,2013,Monmouth,NEC,42,375,39,114,27,78,12,36,41,53,10,30,40,2,10,4,43,48,131
14091,E.J. Farris,2011,2012,Utah State,WAC,54,458,45,131,30,71,15,60,26,28,7,44,51,39,12,1,42,35,131
14092,Amos Given,2017,2017,Mississippi Valley State,SWAC,26,383,60,131,60,131,0,0,11,25,34,33,67,9,15,0,34,51,131
14093,Garrett Golday,2019,2019,Tennessee Tech,OVC,31,471,54,126,43,89,11,37,12,20,28,39,67,9,10,15,15,88,131
14094,Jeremiah Hartsock,2008,2008,Missouri-Kansas City,Summit,32,600,55,119,54,113,1,6,20,35,31,69,100,25,26,24,32,88,131
14095,Dominik Heinzl,2018,2019,Cal State Fullerton,Big West,55,529,51,88,51,88,0,0,29,42,34,65,99,7,14,9,31,72,131
14096,Roman Higgins,2012,2013,Grambling,SWAC,43,517,46,153,35,105,11,48,28,39,16,52,68,12,14,2,60,57,131
14097,Link Kabadyundi,2015,2018,Total,Total,72,495,50,77,50,77,0,0,31,75,43,86,129,6,9,27,35,100,131
14098,Dani Koljanin,2018,2019,Total,Total,47,579,50,135,35,68,15,67,16,28,30,65,95,18,7,4,17,47,131
14099,Richie Lewis,2015,2015,Nicholls State,Southland,26,671,44,119,40,99,4,20,39,57,13,44,57,68,45,4,76,70,131
14100,Jesse Love,2016,2019,Jackson State,SWAC,79,1021,47,124,27,62,20,62,17,33,25,57,82,47,19,9,29,81,131
14101,Dupree Lucas,2008,2008,Portland State,Big Sky,24,483,48,146,28,79,20,67,15,25,10,28,38,45,11,1,41,54,131
14102,David McCormack,2019,2019,Kansas,Big 12,34,363,55,88,55,88,0,0,21,35,42,62,104,13,7,13,27,39,131
14103,Dane Norman,2016,2018,Air Force,MWC,57,401,45,101,29,60,16,41,25,36,38,60,98,15,3,5,29,60,131
14104,Jamal Norman,2015,2015,Savannah State,MEAC,30,531,49,135,41,104,8,31,25,53,24,58,82,26,26,2,43,54,131
14105,George Papas,2018,2019,Monmouth,MAAC,47,430,41,126,13,26,28,100,21,30,5,35,40,25,24,4,19,31,131
14106,B.J. Porter,2008,2011,Total,Total,51,532,48,109,30,54,18,55,17,30,14,45,59,37,7,7,33,55,131
14107,Jon Reed,2008,2008,Pepperdine,WCC,31,338,43,125,4,8,39,117,6,12,3,18,21,8,9,4,11,46,131
14108,Jaylen Sebree,2019,2019,Florida Atlantic,CUSA,14,330,47,107,32,65,15,42,22,33,18,41,59,26,7,7,17,25,131
14109,Matt Smith,2008,2009,Northeastern,CAA,47,546,40,129,9,34,31,95,20,28,15,31,46,19,18,5,21,23,131
14110,Finn Sullivan,2019,2019,San Diego,WCC,32,525,41,104,22,47,19,57,30,36,12,48,60,15,15,6,14,56,131
14111,Dana Tate,2019,2019,Rhode Island,A-10,33,523,54,134,39,85,15,49,8,15,22,73,95,22,10,7,17,51,131
14112,Kellon Taylor,2017,2019,Duquesne,A-10,51,696,52,85,49,76,3,9,24,37,50,82,132,29,21,9,35,76,131
14113,Tyler Whatley,2008,2010,Total,Total,29,544,54,131,54,130,0,1,23,40,34,53,87,20,7,21,27,69,131
14114,Lorenzen Wright Jr.,2017,2018,Total,Total,48,443,42,124,5,18,37,106,10,16,4,22,26,8,10,0,23,43,131
14115,Nikko Acosta,2010,2013,Total,Total,79,690,46,120,46,120,0,0,38,70,50,71,121,20,13,48,47,92,130
14116,Ameka Akaya,2018,2019,Air Force,MWC,36,339,52,90,42,69,10,21,16,20,14,41,55,18,5,2,28,34,130
14117,Frank Ben-Eze,2009,2012,Davidson,Southern,96,713,55,129,55,129,0,0,20,38,70,137,207,19,17,59,48,93,130
14118,Brian Bridgewater,2015,2017,Louisiana State,SEC,71,448,54,107,54,107,0,0,22,35,32,48,80,13,15,10,28,75,130
14119,Jason Briggs,2008,2009,Princeton,Ivy,46,677,47,107,29,65,18,42,18,33,10,85,95,38,21,2,38,56,130
14120,Lance Brown,2011,2011,Quinnipiac,NEC,22,402,57,106,53,94,4,12,12,26,41,64,105,17,12,6,24,45,130
14121,David Chavarria,2009,2012,UC-Riverside,Big West,60,700,46,93,46,92,0,1,38,63,55,82,137,17,8,7,47,126,130
14122,Solomon Farris,2008,2009,Eastern Michigan,MAC,28,413,47,142,29,71,18,71,18,27,20,48,68,33,24,1,49,26,130
14123,Angel Garcia,2010,2011,Memphis,CUSA,21,216,43,95,26,50,17,45,27,33,11,27,38,3,4,9,13,34,130
14124,Orlando Griego,2008,2008,Southern Utah,Summit,29,383,40,95,40,92,0,3,50,60,16,46,62,22,7,3,22,34,130
14125,Robert Hayes,2011,2012,Cal State Bakersfield,Ind,32,228,39,93,14,31,25,62,27,43,11,14,25,12,8,1,15,26,130
14126,Jahvari Josiah,2014,2015,Coppin State,MEAC,32,389,42,120,36,79,6,41,40,65,34,37,71,11,16,6,41,47,130
14127,Reggie Mathis,2010,2010,Lamar,Southland,21,364,40,118,28,64,12,54,38,51,28,43,71,22,24,5,23,46,130
14128,Eugene McCrory,2014,2014,Central Florida,AAC,26,371,46,90,46,90,0,0,38,61,43,32,75,8,5,15,13,48,130
14129,Shae McNamara,2008,2008,Marist,MAAC,32,419,51,92,40,58,11,34,17,25,30,51,81,17,8,4,40,78,130
14130,Norm Nixon,2008,2010,Total,Total,44,581,49,135,32,82,17,53,15,24,16,55,71,51,22,2,40,51,130
14131,Andrew Ott,2008,2010,Total,Total,58,497,47,90,47,88,0,2,36,64,46,55,106,8,12,13,31,69,130
14132,Quinston Reggins,2010,2010,Coppin State,MEAC,29,602,35,117,23,76,12,41,48,69,7,33,40,47,19,0,48,57,130
14133,Jaylen Richard,2019,2019,College of Charleston,CAA,32,413,41,93,31,53,10,40,38,48,9,35,44,13,16,3,30,27,130
14134,Taurus Samuels,2019,2019,Dartmouth,Ivy,30,495,43,120,22,49,21,71,23,35,3,40,43,30,16,4,23,48,130
14135,Jaden Sayles,2018,2019,Akron,MAC,37,495,44,75,44,75,0,0,42,63,26,56,82,4,3,15,23,45,130
14136,Les Smith,2011,2014,Lafayette,Patriot,93,647,38,126,18,60,20,66,34,42,11,45,56,31,15,1,46,86,130
14137,Jacob Wiley,2018,2019,Illinois-Chicago,Horizon,56,551,48,95,45,87,3,8,31,62,37,98,135,19,9,27,36,106,130
14138,Kyle Williams,2015,2016,Grambling,SWAC,58,856,52,108,52,108,0,0,26,56,49,94,143,10,10,19,47,99,130
14139,Ed Zajac,2008,2009,Quinnipiac,NEC,43,703,50,108,50,108,0,0,30,51,46,104,150,6,12,19,33,102,130
14140,Luiz Bidart,2013,2014,Seattle,WAC,54,651,36,98,11,27,25,71,32,41,18,75,93,42,16,1,38,75,129
14141,Trevion Brown,2019,2019,Coastal Carolina,Sun Belt,30,410,39,92,16,42,23,50,28,34,7,22,29,42,8,2,35,34,129
14142,Marqueese Grayson,2017,2017,Albany (NY),AEC,27,455,44,124,22,67,22,57,19,27,3,53,56,27,14,2,34,36,129
14143,Riley Grigsby,2019,2019,Seattle,WAC,30,515,46,95,37,66,9,29,28,39,19,58,77,15,10,18,17,75,129
14144,Mason Harrell,2019,2019,Texas State,Sun Belt,33,423,38,103,26,62,12,41,41,52,9,25,34,56,22,1,27,51,129
14145,Chris Herren Jr.,2019,2019,Boston College,ACC,31,478,47,131,21,50,26,81,9,18,17,35,52,20,12,4,25,46,129
14146,D'Angelo Jackson,2018,2018,Eastern Illinois,OVC,17,339,35,94,30,84,5,10,54,82,20,35,55,37,14,1,52,32,129
14147,Tim Jacobs,2015,2016,New Mexico,MWC,55,856,47,99,41,73,6,26,29,51,8,104,112,126,25,2,50,58,129
14148,Eric Kibi,2011,2011,Little Rock,Sun Belt,29,484,48,112,48,111,0,1,33,66,44,79,123,19,18,3,34,69,129
14149,Felix Lemetti,2019,2019,Fairfield,MAAC,25,481,44,121,8,23,36,98,5,10,4,23,27,21,9,1,14,49,129
14150,Jonathan Malloy,2009,2010,Sacramento State,Big Sky,49,618,45,127,31,88,14,39,25,37,20,45,65,37,18,4,57,56,129
14151,Ronald March,2012,2012,Houston Baptist,GWC,15,280,48,108,32,59,16,49,17,28,21,27,48,9,14,10,23,30,129
14152,Antun Maricevic,2019,2019,South Florida,AAC,37,522,50,93,43,82,7,11,22,31,44,50,94,17,11,11,25,64,129
14153,George Mawanda-Kalema,2018,2019,Brown,Ivy,27,316,48,109,33,62,15,47,18,23,9,41,50,13,8,1,15,25,129
14154,Khalid Moore,2019,2019,Georgia Tech,ACC,31,508,40,84,33,62,7,22,42,64,5,40,45,36,11,2,22,54,129
14155,Lamar Norman Jr.,2019,2019,Duquesne,A-10,27,340,47,113,21,44,26,69,9,10,8,34,42,10,14,0,11,27,129
14156,Charles Norman,2019,2019,Troy,Sun Belt,24,356,37,105,5,16,32,89,23,29,3,25,28,14,10,1,12,21,129
14157,Sam Norton,2016,2019,Loyola (MD),Patriot,72,976,43,126,31,87,12,39,31,42,40,117,157,63,42,6,46,115,129
14158,Daniel Orton,2010,2010,Kentucky,SEC,38,502,48,91,48,89,0,2,33,63,45,81,126,15,21,53,38,88,129
14159,Matt Parker,2008,2010,James Madison,CAA,60,483,45,133,15,40,30,93,9,14,15,53,68,16,6,10,26,73,129
14160,Darryl Polk Jr,2019,2019,Pepperdine,WCC,33,602,42,116,24,57,18,59,27,36,8,44,52,41,39,3,25,51,129
14161,Preye Preboye,2010,2011,Stony Brook,AEC,53,537,50,135,46,118,4,17,25,38,41,89,130,22,20,6,56,72,129
14162,Justin Roberts,2018,2018,DePaul,Big East,30,453,51,135,39,98,12,37,15,21,8,29,37,62,15,3,45,29,129
14163,Dominique Rutledge,2012,2013,West Virginia,Total,54,517,45,94,45,93,0,1,39,74,74,80,154,23,17,18,55,88,129
14164,Jael Scott,2019,2019,Alcorn State,SWAC,29,722,55,115,52,104,3,11,16,32,38,63,101,58,31,8,53,60,129
14165,Jackson Simmons,2012,2015,North Carolina,ACC,115,562,53,89,53,89,0,0,23,42,55,64,119,19,10,6,14,63,129
14166,Dipanjot Singh,2010,2011,Illinois-Chicago,Horizon,31,458,45,107,25,51,20,56,19,25,13,34,47,27,13,1,29,36,129
14167,Ronnie Stevens,2014,2015,Nevada,MWC,41,579,43,95,43,95,0,0,43,62,57,58,115,6,5,17,39,84,129
14168,Nick Taylor,2008,2010,Florida International,Sun Belt,74,1342,35,149,25,82,10,67,49,93,22,103,125,141,58,1,72,119,129
14169,Arthur Wade,2015,2016,Alabama A&M,SWAC,40,709,43,117,23,49,20,68,23,37,25,38,63,31,31,8,22,90,129
14170,Johnny Zuppardo,2012,2016,Total,Total,55,527,50,118,32,68,18,50,11,16,22,70,92,9,15,9,34,84,129
14171,Stephaun Adams,2017,2018,Tennessee Tech,OVC,41,596,37,120,23,72,14,48,40,56,21,85,106,76,30,1,50,74,128
14172,Ryan Baker,2010,2012,Hartford,AEC,69,524,43,101,18,31,25,70,17,23,25,39,64,16,11,3,14,62,128
14173,Paris Bennett,2010,2013,George Mason,CAA,76,646,51,123,49,111,2,12,24,37,37,78,115,26,15,12,38,81,128
14174,Billy Blackmon,2009,2010,Charleston Southern,Big South,41,858,56,115,56,113,0,2,16,40,69,138,207,24,23,35,25,98,128
14175,J.J. Butler,2013,2016,Lipscomb,A-Sun,85,986,49,130,38,80,11,50,19,40,20,60,80,109,38,4,86,115,128
14176,Dre' Clayton,2015,2017,Total,Total,57,667,49,133,36,78,13,55,17,35,26,95,121,23,12,11,36,98,128
14177,Michael Drewy,2009,2009,Texas Southern,SWAC,31,648,55,106,55,105,0,1,18,40,37,73,110,15,9,9,34,74,128
14178,Ido Flaisher,2017,2018,Hawaii,Big West,52,441,49,94,49,94,0,0,30,51,39,71,110,7,3,9,39,91,128
14179,John Florveus,2012,2013,Georgia,SEC,60,903,54,120,54,120,0,0,20,43,60,86,146,18,13,39,50,110,128
14180,Landon Goesling,2015,2019,Total,Total,50,428,35,117,27,67,8,50,50,76,14,35,49,25,9,0,32,40,128
14181,Andrew Hershberger,2008,2008,Western Michigan,MAC,32,556,42,81,40,79,2,2,42,61,37,77,114,26,23,17,31,68,128
14182,Jason Hopkins,2008,2008,Lipscomb,A-Sun,30,561,44,78,44,77,0,1,40,79,60,120,180,25,14,27,40,103,128
14183,Shamile Jeffers,2011,2012,Jacksonville,A-Sun,60,569,51,101,51,101,0,0,26,51,58,71,129,6,19,20,41,118,128
14184,Cori Johnson,2018,2019,St. Francis (NY),NEC,47,399,47,121,44,103,3,18,31,51,30,56,86,20,4,24,38,78,128
14185,Ray Kowalski,2017,2018,Southeast Missouri State,OVC,28,438,43,113,13,38,30,75,12,12,4,28,32,17,6,0,21,24,128
14186,Jordan Mason,2013,2015,Total,Total,31,308,47,125,32,65,15,60,19,28,12,38,50,15,8,4,18,34,128
14187,Cheyenne Moore,2008,2008,George Washington,A-10,23,413,40,118,19,58,21,60,27,31,14,36,50,23,15,3,53,49,128
14188,Ryan Murphy,2018,2018,Charlotte,CUSA,19,379,46,113,14,33,32,80,4,8,1,21,22,18,10,0,18,28,128
14189,Gabe Osabuohien,2018,2019,Arkansas,SEC,54,645,48,140,43,106,5,34,27,63,52,84,136,51,32,18,49,116,128
14190,Cody Rincker,2011,2011,Southern Illinois-Edwardsville,Ind,28,440,43,109,8,17,35,92,7,9,4,26,30,34,24,1,21,40,128
14191,Liam Robbins,2019,2019,Drake,MVC,31,349,50,113,47,100,3,13,25,42,39,44,83,16,10,35,22,79,128
14192,Vlad Shustov,2015,2016,NJIT,Total,53,548,58,123,55,113,3,10,9,17,28,60,88,18,5,23,40,92,128
14193,Max Twyman,2015,2019,Total,AEC,90,731,42,101,15,28,27,73,17,27,20,44,64,32,12,2,21,67,128
14194,Artem Wallace,2008,2009,Washington,Pac-10,49,520,56,94,56,94,0,0,16,57,58,50,108,11,6,5,24,72,128
14195,Alec Williams,2010,2012,San Diego State,MWC,43,362,46,106,38,78,8,28,28,35,19,54,73,7,4,4,26,58,128
14196,Nana Akenten,2018,2019,Nebraska,Big Ten,35,381,46,130,20,43,26,87,9,19,22,51,73,7,10,3,10,42,127
14197,Bryan Assie,2019,2019,Southern,SWAC,32,504,45,86,45,86,0,0,37,66,51,63,114,11,10,23,47,83,127
14198,George Barbour,2008,2010,Monmouth,NEC,44,425,46,117,46,117,0,0,35,72,36,40,76,13,12,16,27,77,127
14199,Mame Bocar Ba,2009,2010,Colorado State,MWC,53,569,43,93,43,93,0,0,41,65,48,81,129,9,4,14,38,77,127
14200,Daniel Calandrillo,2011,2013,Bryant,NEC,57,641,48,139,26,65,22,74,9,15,25,47,72,29,12,3,17,60,127
14201,Eddie Castellanos,2008,2010,Stony Brook,AEC,75,1069,54,148,54,140,0,8,19,52,25,71,96,126,62,5,112,107,127
14202,Ryan Conrad,2010,2010,Wagner,NEC,19,345,38,122,17,44,21,78,30,37,7,22,29,30,18,2,34,32,127
14203,Dennis Diaz,2012,2013,Stetson,A-Sun,59,578,44,125,17,37,27,88,12,18,14,53,67,41,17,1,58,65,127
14204,Jake Duncan,2014,2014,NJIT,Ind,24,316,42,99,16,28,26,71,17,23,5,28,33,13,5,3,16,22,127
14205,Dan Fitzgerald,2008,2008,Marquette,Big East,30,428,42,102,9,15,33,87,10,13,23,36,59,11,21,0,14,56,127
14206,Mike Fleming,2017,2017,Dartmouth,Ivy,27,689,41,99,22,41,19,58,26,30,8,37,45,69,12,2,22,63,127
14207,Tyree Graham,2009,2013,Total,Total,29,386,39,133,15,52,24,81,25,30,9,26,35,38,13,1,41,35,127
14208,Kyle Guice,2017,2017,Illinois-Chicago,Horizon,36,508,41,106,2,4,39,102,6,9,8,70,78,32,7,8,19,48,127
14209,Khadre Lane,2016,2017,Campbell,Big South,32,357,36,101,23,55,13,46,42,60,20,17,37,14,12,10,15,44,127
14210,Gary Lawrence,2010,2011,Howard,MEAC,51,601,36,97,36,94,0,3,55,91,62,72,134,12,17,7,67,65,127
14211,Luqman Lundy,2018,2019,Bradley,MVC,52,629,45,105,31,60,14,45,23,35,9,55,64,60,30,7,32,53,127
14212,Mark MacDonald,2008,2008,Brown,Ivy,20,240,50,112,47,91,3,21,24,37,10,26,36,27,8,7,22,32,127
14213,Cody Mann,2012,2014,Total,Total,37,566,42,112,25,68,17,44,26,39,10,46,56,52,19,0,28,36,127
14214,Andy Martin,2013,2014,Montana,Big Sky,58,532,45,92,45,92,0,0,37,48,40,64,104,9,9,39,23,105,127
14215,Eddie Mitchell,2012,2012,Rider,MAAC,30,617,42,124,34,86,8,38,35,44,10,46,56,87,28,3,80,50,127
14216,Nate Nahimy,2018,2018,Mississippi Valley State,SWAC,30,578,48,141,33,74,15,67,16,25,5,37,42,41,22,1,33,39,127
14217,Tony Nunn,2016,2016,Southern,SWAC,35,416,55,101,55,101,0,0,17,42,40,60,100,3,4,40,28,79,127
14218,Wali Parks,2019,2019,Bethune-Cookman,MEAC,30,557,50,112,44,84,6,28,21,44,34,62,96,22,11,6,21,49,127
14219,Weisner Perez,2016,2019,Harvard,Ivy,56,446,45,108,41,90,4,18,33,47,49,75,124,7,13,5,25,47,127
14220,Czar Perry,2018,2018,Northwestern State,Southland,14,299,52,120,44,86,8,34,15,27,8,21,29,26,6,1,55,30,127
14221,Mayol Riathin,2012,2013,Prairie View,SWAC,51,662,46,112,46,112,0,0,35,66,57,88,145,12,14,20,52,108,127
14222,Stephen Sargent,2008,2011,Virginia Military Institute,Big South,53,512,57,120,57,120,0,0,13,36,59,105,164,5,19,64,31,137,127
14223,Theron Stephens,2010,2014,Total,Total,42,371,41,141,12,48,29,93,16,19,13,10,23,22,4,0,17,19,127
14224,Khadim Sy,2017,2017,Virginia Tech,ACC,32,364,55,97,54,96,1,1,16,27,28,58,86,6,3,20,24,45,127
14225,Ervin Thomas,2013,2014,Mississippi Valley State,SWAC,41,671,49,147,39,100,10,47,19,36,66,123,189,41,24,18,39,68,127
14226,Tyrel Adams,2009,2010,Bethune-Cookman,MEAC,62,790,48,130,48,128,0,2,30,53,35,62,97,12,5,18,44,137,126
14227,Benji Bell,2016,2016,Florida State,ACC,33,342,39,99,16,45,23,54,25,45,8,26,34,29,10,0,22,29,126
14228,Nolan Berry,2014,2016,Total,Total,28,265,39,81,29,52,10,29,38,46,10,53,63,8,9,5,18,39,126
14229,Tyler Billings,2008,2008,Weber State,Big Sky,29,399,43,108,24,53,19,55,21,31,13,41,54,14,6,5,26,41,126
14230,Josh Boutte,2018,2018,Sam Houston State,Southland,23,316,53,86,53,86,0,0,20,30,36,41,77,5,2,7,17,50,126
14231,Ashtyn Bradley,2017,2019,Long Island University,NEC,42,255,41,127,5,14,36,113,8,11,10,22,32,6,10,3,6,15,126
14232,Shaq Carter,2019,2019,Rutgers,Big Ten,28,392,49,85,48,84,1,1,27,38,42,59,101,12,3,6,24,38,126
14233,Keith Coleman,2013,2014,North Texas,Total,59,671,54,138,54,138,0,0,18,44,38,109,147,8,9,38,67,104,126
14234,Ibby Djimde,2012,2016,Total,Total,84,643,51,113,51,113,0,0,24,43,46,54,100,17,13,9,41,131,126
14235,Aaron Geramipoor,2011,2014,Seton Hall,Big East,92,783,55,104,55,104,0,0,16,45,69,95,164,6,16,25,34,146,126
14236,Jeff Havenstein,2011,2014,Longwood,Total,117,1238,48,118,48,117,0,1,30,47,69,144,213,24,14,27,52,197,126
14237,Dallas Jones,2012,2012,South Alabama,Sun Belt,28,426,45,116,19,35,26,81,10,17,10,18,28,23,11,1,14,47,126
14238,Dusan Kovacevic,2017,2019,Davidson,A-10,56,504,51,128,44,96,7,32,17,27,36,85,121,34,7,9,45,92,126
14239,Jamar Martin,2017,2018,Charleston Southern,Big South,46,482,44,112,23,46,21,66,17,24,37,68,105,29,18,8,26,67,126
14240,Jordan Martin,2016,2017,Missouri State,MVC,59,507,46,102,46,102,0,0,34,76,45,56,101,8,22,22,47,133,126
14241,Cainan McClelland,2018,2019,Texas Southern,SWAC,64,754,36,120,13,41,23,79,31,49,13,54,67,44,22,3,30,48,126
14242,Raine McKeython,2018,2019,Stetson,A-Sun,38,395,39,108,25,65,14,43,34,42,17,27,44,16,10,4,25,44,126
14243,Davion Mitchell,2018,2018,Auburn,SEC,34,582,45,105,30,53,15,52,21,31,9,30,39,63,18,1,38,73,126
14244,John Norvel,2019,2019,Northwestern State,Southland,31,513,41,128,18,55,23,73,21,31,14,37,51,42,24,3,32,49,126
14245,Chris Nsenki,2012,2014,Southern Utah,Total,78,799,46,164,24,75,22,89,12,15,9,26,35,56,12,4,51,64,126
14246,Steven Pearl,2008,2011,Tennessee,SEC,101,845,56,116,56,115,0,1,14,41,41,69,110,51,36,8,53,120,126
14247,David Pellom,2014,2014,Memphis,AAC,30,406,55,81,55,81,0,0,16,31,38,49,87,18,11,6,18,42,126
14248,Will Ransom,2015,2017,Total,Total,57,774,56,96,56,95,0,1,14,29,79,108,187,7,20,37,41,113,126
14249,Travis Sims,2010,2011,Centenary (LA),Summit,41,579,42,134,25,73,17,61,25,43,21,67,88,33,25,5,59,85,126
14250,Trey Spencer,2019,2019,Campbell,Big South,30,573,44,144,15,40,29,104,9,14,17,36,53,29,24,1,25,40,126
14251,Matthias Tass,2019,2019,Saint Mary's (CA),WCC,34,502,51,103,49,95,2,8,22,33,50,57,107,22,17,10,30,63,126
14252,Blake Thompson,2008,2009,Prairie View,SWAC,31,344,49,106,41,87,8,19,20,34,17,50,67,9,4,35,34,55,126
14253,David Brown,2012,2013,Furman,Southern,47,519,42,113,19,45,23,68,18,21,4,27,31,53,24,4,37,37,125
14254,Tyler Burgess,2017,2019,Citadel,Southern,39,223,41,128,1,3,40,125,3,5,5,22,27,6,1,4,9,11,125
14255,John Burke,2013,2014,Missouri-Kansas City,Total,49,405,44,103,33,64,11,39,26,32,9,27,36,10,13,2,34,56,125
14256,Terrell Hales,2015,2018,Cleveland State,Horizon,113,1440,46,116,43,91,3,25,30,50,85,113,198,87,91,10,72,158,125
14257,Daniel Hurtt,2014,2014,Mississippi Valley State,SWAC,31,365,52,117,45,94,7,23,14,27,21,41,62,9,8,6,13,41,125
14258,Alex Illikainen,2016,2018,Wisconsin,Big Ten,85,718,45,118,26,62,19,56,16,30,41,70,111,32,8,9,20,69,125
14259,Viktor Juricek,2013,2016,Total,Total,83,510,40,109,22,53,18,56,27,39,31,36,67,8,7,6,40,92,125
14260,Dave Morris,2019,2019,Tennessee State,OVC,28,422,36,103,17,45,19,58,34,41,8,36,44,27,19,1,40,64,125
14261,Djordjije Mumin,2015,2018,Central Florida,AAC,66,552,42,124,5,18,37,106,4,6,10,42,52,7,6,0,20,41,125
14262,Pat Nelson,2008,2010,Green Bay,Horizon,85,950,50,117,50,116,0,1,25,45,83,146,229,26,14,44,49,141,125
14263,Julian Olubuyi,2010,2011,Northern Arizona,Big Sky,60,1057,42,114,37,95,5,19,36,69,14,54,68,181,54,1,78,119,125
14264,Tyson Parker,2008,2008,Fresno State,WAC,28,571,45,137,34,78,11,59,24,31,14,55,69,42,14,8,29,56,125
14265,Logan Routt,2016,2019,West Virginia,Big 12,77,547,50,87,50,87,0,0,25,50,87,60,147,18,5,26,26,87,125
14266,Eric Rwahwire,2016,2019,UC-Riverside,Big West,39,398,45,148,26,66,19,82,16,21,17,65,82,14,7,3,25,50,125
14267,Brandan Smith,2008,2010,Chicago State,Total,66,643,41,119,30,83,11,36,32,49,18,50,68,55,20,0,53,65,125
14268,Kevon Tucker,2017,2019,Total,Southern,46,408,43,129,17,38,26,91,13,18,8,35,43,23,27,3,22,49,125
14269,Quentin Turner,2008,2008,Loyola Marymount,WCC,29,409,47,128,37,96,10,32,21,36,9,16,25,31,6,1,52,43,125
14270,Marchello Vealy,2008,2008,Oral Roberts,Summit,27,529,49,119,40,82,9,37,18,41,36,93,129,40,25,19,35,52,125
14271,Isaiah Williams,2018,2018,Liberty,Big South,30,420,41,90,38,80,3,10,40,68,24,41,65,22,9,6,40,59,125
14272,Eric Zastoupil,2008,2010,Army,Patriot,48,618,46,105,45,93,1,12,32,42,40,53,93,16,12,5,32,54,125
14273,Josiah Coleman,2015,2015,North Dakota,Big Sky,29,397,43,110,24,47,19,63,19,25,22,55,77,13,17,1,24,62,124
14274,Keithtrick Denson,2011,2012,Texas Southern,SWAC,38,562,52,87,52,87,0,0,20,50,40,66,106,20,19,17,34,88,124
14275,Gianni Ford,2017,2019,Total,Total,27,375,41,126,20,57,21,69,21,29,8,18,26,11,9,2,17,33,124
14276,Tyler Foster,2019,2019,East Carolina,AAC,30,514,46,130,38,87,8,43,24,42,8,36,44,26,26,5,34,60,124
14277,Collin Goss,2016,2019,Total,Total,64,435,47,94,35,63,12,31,18,26,28,84,112,13,5,21,29,65,124
14278,Jacoby Green,2015,2017,Prairie View,SWAC,38,509,42,120,17,46,25,74,15,24,12,29,41,33,18,1,35,58,124
14279,Damir Hadzic,2018,2019,Little Rock,Sun Belt,36,411,43,111,26,49,17,62,21,30,18,44,62,24,6,4,34,58,124
14280,Michael Hart,2008,2008,Northern Illinois,MAC,28,349,39,74,39,74,0,0,46,65,32,43,75,6,5,21,18,62,124
14281,Michael Harvey,2012,2013,Portland State,Big Sky,51,497,44,108,38,76,6,32,30,40,29,46,75,16,13,9,30,55,124
14282,Amari Haynes,2019,2019,New Orleans,Southland,32,290,48,96,48,95,0,1,28,43,29,25,54,11,15,6,42,47,124
14283,Jack Hemphill,2019,2019,Boston University,Patriot,32,316,47,118,31,64,16,54,14,25,21,50,71,9,6,8,25,43,124
14284,Desmond Johnson,2018,2018,Western Carolina,Southern,31,488,46,120,37,91,9,29,23,41,14,53,67,48,39,3,54,49,124
14285,Mike Kobani,2014,2016,Appalachian State,Total,47,340,54,98,54,98,0,0,16,45,37,48,85,2,3,4,20,74,124
14286,Kory Kuenstling,2015,2018,Drake,MVC,72,611,40,85,40,85,0,0,44,64,42,61,103,9,6,19,44,96,124
14287,Will Magnay,2017,2017,Tulsa,AAC,32,449,48,83,48,82,0,1,28,49,33,62,95,8,2,29,33,62,124
14288,Kyle Pearson,2013,2014,Fairleigh Dickinson,NEC,37,367,49,104,39,75,10,29,16,32,12,33,45,6,12,5,19,26,124
14289,Korey Sanders,2011,2011,Alcorn State,SWAC,28,510,54,126,54,123,0,3,16,43,48,97,145,12,10,23,18,82,124
14290,Marcus Sikes,2008,2008,Cincinnati,Big East,32,499,46,127,31,66,15,61,17,29,32,81,113,19,5,5,31,60,124
14291,Chance Smith,2012,2012,Radford,Big South,32,692,46,128,22,43,24,85,8,12,15,33,48,48,22,0,44,69,124
14292,Brandon St. Louis,2012,2015,Coppin State,MEAC,78,967,48,130,48,129,0,1,28,54,100,96,196,17,29,20,41,135,124
14293,Maxwell Starwood,2017,2019,Total,Total,54,471,57,122,55,116,2,6,8,16,33,42,75,16,7,24,30,93,124
14294,Jackson Stent,2019,2019,Houston Baptist,Southland,29,366,42,91,27,51,15,40,25,33,19,20,39,8,4,8,16,63,124
14295,Brad Sweezy,2008,2010,Loyola Marymount,WCC,78,1072,49,134,49,130,0,4,26,70,77,108,185,28,27,11,70,157,124
14296,Andre Tarver,2008,2008,Iona,MAAC,25,379,50,130,32,77,18,53,6,12,10,33,43,17,15,1,28,51,124
14297,Matt Thomas,2008,2009,San Diego State,MWC,65,924,40,114,31,77,9,37,35,50,37,68,105,64,52,3,38,64,124
14298,Roberto Vercellino,2017,2018,Northern Colorado,Big Sky,54,564,44,89,38,61,6,28,30,44,46,81,127,20,13,16,38,84,124
14299,Marshawn Blackmon,2016,2017,Eastern Illinois,OVC,38,405,55,93,54,89,1,4,12,41,42,53,95,11,18,7,26,40,123
14300,Corey Bloom,2008,2010,Louisiana,Sun Belt,50,479,37,122,14,27,23,95,26,40,18,24,42,20,6,2,19,22,123
14301,Jeremiah Bozeman,2017,2019,Jackson State,SWAC,58,720,37,95,27,68,10,27,39,57,28,49,77,28,29,3,32,84,123
14302,Christian Burton,2012,2015,Virginia Military Institute,Total,57,394,40,113,17,32,23,81,20,35,25,25,50,30,24,1,32,47,123
14303,Jalen Courtney,2011,2015,Total,Total,66,464,46,121,34,85,12,36,19,28,31,62,93,7,4,10,17,56,123
14304,Sam Cunliffe,2017,2018,Total,Total,25,328,43,114,26,69,17,45,20,31,8,49,57,18,7,4,23,37,123
14305,Andrew Dakich,2014,2018,Total,Big Ten,83,849,44,100,26,51,18,49,17,21,17,69,86,93,39,1,50,65,123
14306,Deven Dickerson,2008,2008,Georgia State,CAA,23,387,50,101,50,101,0,0,23,33,36,57,93,6,7,17,26,68,123
14307,Richard Griffin,2008,2008,Alcorn State,SWAC,11,321,39,99,15,36,24,63,21,27,7,25,32,11,14,0,15,32,123
14308,Manny Hendrix,2010,2010,Texas-Rio Grande Valley,GWC,29,439,38,116,23,78,15,38,32,48,11,42,53,23,16,5,26,30,123
14309,James Hennessy,2008,2009,Montana State,Big Sky,54,484,44,110,31,61,13,49,22,32,10,58,68,79,30,3,64,60,123
14310,Brandon Johnson,2008,2008,Long Beach State,Big West,30,433,52,111,42,80,10,31,9,15,22,27,49,21,11,0,17,43,123
14311,DeVante Jones,2015,2015,Middle Tennessee,CUSA,27,285,39,105,15,36,24,69,21,28,8,21,29,22,16,1,15,33,123
14312,Xavier Jones,2013,2013,San Jose State,WAC,27,485,42,130,40,117,2,13,37,62,20,35,55,41,15,4,35,49,123
14313,Marcus Lee,2009,2012,Alabama A&M,SWAC,40,655,39,89,30,64,9,25,36,49,16,38,54,55,28,4,69,53,123
14314,Calvin Martin,2018,2019,Sacramento State,Big Sky,53,638,47,95,47,95,0,0,29,47,54,73,127,9,22,7,42,121,123
14315,Timothy McCrory,2008,2008,Vermont,AEC,22,446,49,80,49,80,0,0,25,37,35,73,108,14,7,23,32,50,123
14316,Mark McLaughlin,2011,2011,Seattle,Ind,17,302,43,127,28,74,15,53,22,27,23,38,61,13,11,5,28,46,123
14317,Dan Peera,2012,2015,Rice,CUSA,94,852,46,99,18,34,28,65,3,14,8,68,76,48,22,0,33,100,123
14318,Peter Ryckbosch,2013,2018,DePaul,Big East,86,599,49,92,49,92,0,0,25,53,70,77,147,7,15,8,35,124,123
14319,Kherel Silcott,2011,2012,NJIT,GWC,51,583,41,84,40,81,1,3,40,74,62,105,167,11,11,29,25,127,123
14320,Kenny Simms,2008,2008,Missouri-Kansas City,Summit,22,349,47,102,47,102,0,0,29,56,37,69,106,9,15,30,28,70,123
14321,Rodney Spruill,2008,2008,Towson,CAA,10,290,48,125,44,94,4,31,23,41,20,30,50,22,12,5,22,28,123
14322,Levi Stockard III,2018,2019,Kansas State,Big 12,68,561,51,95,51,95,0,0,21,39,41,67,108,8,11,5,35,109,123
14323,Johnny Wang,2018,2019,Cal State Fullerton,Big West,49,575,49,101,45,89,4,12,21,31,42,70,112,10,5,17,32,93,123
14324,Jared Williams,2009,2012,North Carolina A&T,MEAC,62,491,41,126,13,34,28,92,13,17,8,41,49,13,10,1,13,21,123
14325,Josh Alexander,2019,2019,American,Patriot,28,334,43,81,41,76,2,5,34,48,24,39,63,13,5,7,27,42,122
14326,Andre Allen,2008,2008,Memphis,CUSA,37,521,41,132,17,50,24,82,16,37,12,32,44,76,35,2,42,56,122
14327,Joseph Bailey,2008,2009,Tennessee-Martin,OVC,39,338,41,111,9,21,32,90,8,11,6,25,31,13,5,0,21,24,122
14328,Colby Carr,2010,2010,Louisiana-Monroe,Sun Belt,25,428,47,109,46,104,1,5,27,37,30,39,69,35,20,4,40,28,122
14329,Joe Carr,2010,2013,Virginia Military Institute,Big South,65,669,44,111,38,73,6,38,28,40,37,67,104,80,47,1,65,104,122
14330,Idy Diallo,2016,2018,Total,Total,58,599,56,101,56,101,0,0,10,30,43,106,149,13,8,28,55,138,122
14331,Tobias Dowdell,2013,2014,Tennessee-Martin,OVC,56,595,54,107,53,106,1,1,13,20,53,68,121,8,12,16,23,67,122
14332,Freddie Edo,2008,2008,Prairie View,SWAC,27,413,41,106,30,74,11,32,29,51,9,20,29,28,23,1,34,50,122
14333,Savonte Frazier,2016,2017,Tennessee Tech,OVC,48,571,35,92,27,65,8,27,44,66,11,82,93,81,13,3,50,51,122
14334,Dondre Griffin,2017,2019,Total,Total,41,321,44,108,19,38,25,70,9,10,9,24,33,17,4,1,18,51,122
14335,Jacob Guest,2017,2019,Northwestern State,Southland,59,414,41,152,14,35,27,117,13,18,9,37,46,12,7,1,25,23,122
14336,Donnie Hale,2013,2013,Purdue,Big Ten,32,463,52,120,51,119,1,1,17,31,36,54,90,9,8,10,18,42,122
14337,Ja'Shon Henry,2019,2019,Bradley,MVC,28,351,46,87,44,80,2,7,28,53,32,39,71,7,14,7,24,40,122
14338,Sean Imadiyi,2009,2011,Boise State,WAC,58,479,53,102,53,102,0,0,16,38,39,51,90,11,17,16,30,51,122
14339,Jeremy Ingram,2012,2012,Alabama A&M,SWAC,22,263,44,128,20,61,24,67,10,17,9,15,24,15,10,4,19,31,122
14340,Collin Jennings,2015,2015,Missouri-Kansas City,WAC,30,443,44,99,24,50,20,49,14,19,16,23,39,27,14,3,26,51,122
14341,David Kralj,2019,2019,Coastal Carolina,Sun Belt,16,362,45,101,22,43,23,58,9,12,8,19,27,17,6,0,18,22,122
14342,Shakaris Laney,2015,2018,Central Connecticut State,NEC,59,651,44,137,29,70,15,67,19,29,19,46,65,39,18,6,37,57,122
14343,Aaron Osgood,2009,2011,Cornell,Ivy,35,377,47,93,46,91,1,2,27,54,27,58,85,18,13,9,28,47,122
14344,Nick Reese,2015,2017,North Carolina A&T,MEAC,67,609,50,126,44,96,6,30,16,31,34,66,100,26,18,5,38,114,122
14345,Keith Smith,2008,2008,Louisiana Tech,WAC,15,312,46,111,40,100,6,11,24,33,15,55,70,11,4,6,27,34,122
14346,Kader Tapsoba,2013,2014,Texas Tech,Big 12,53,439,44,70,44,70,0,0,34,50,26,46,72,8,15,29,24,71,122
14347,Andre Wallace,2017,2017,South Dakota State,Summit,26,388,40,109,22,48,18,61,24,49,4,35,39,29,10,1,24,24,122
14348,De'Torrion Ware,2019,2019,Jacksonville State,OVC,23,159,39,93,14,26,25,67,19,23,8,24,32,6,6,2,14,15,122
14349,Lavoris Weathers,2011,2012,Arkansas-Pine Bluff,SWAC,50,604,43,126,43,125,0,1,36,105,42,81,123,9,10,8,37,76,122
14350,Rodney Williams,2009,2009,Western Illinois,Summit,28,510,48,108,43,93,5,15,21,25,19,39,58,24,8,5,33,58,122
14351,Lukas Winegarner,2011,2012,Radford,Big South,48,466,45,115,44,111,1,4,31,52,51,59,110,3,9,23,32,78,122
14352,Patrick Wrencher,2014,2017,Saint Francis (PA),NEC,79,513,51,96,51,96,0,0,20,30,44,48,92,12,6,12,33,70,122
14353,Jahmel Bodrick,2017,2017,St. Francis (NY),NEC,31,454,49,129,48,120,1,9,22,38,29,50,79,7,8,4,37,94,121
14354,Tre Brewer,2011,2011,Youngstown State,Horizon,29,518,51,139,50,125,1,14,18,39,36,56,92,47,12,2,34,38,121
14355,DeAndray Buckley,2011,2014,Total,Total,50,508,33,94,28,69,5,25,50,87,33,52,85,28,18,11,21,54,121
14356,Svetoslav Chetinov,2009,2012,Maine,AEC,51,540,54,94,54,94,0,0,13,23,53,63,116,8,11,13,42,80,121
14357,Camryn Crocker,2012,2015,Pennsylvania,Ivy,82,902,36,109,24,67,12,42,37,59,10,76,86,105,28,10,85,91,121
14358,Aaron Foster-Smith,2016,2017,Detroit Mercy,Horizon,34,378,49,99,36,64,13,35,10,19,26,47,73,9,5,9,18,56,121
14359,Chris Gonzalez,2008,2008,Western Illinois,Summit,26,439,41,95,9,14,32,81,7,13,11,46,57,27,13,4,14,35,121
14360,Mantas Griskenas,2008,2009,Wichita State,MVC,37,462,39,98,27,54,12,44,31,39,30,34,64,15,8,10,20,44,121
14361,Brandon Hatton,2015,2015,Vermont,AEC,31,447,41,111,17,35,24,76,15,22,7,45,52,13,10,4,11,36,121
14362,Jeremy Hayes,2019,2019,Louisiana,Sun Belt,30,352,38,102,24,55,14,47,31,46,12,21,33,14,7,1,26,35,121
14363,Kamil Janton,2009,2012,Eastern Michigan,MAC,70,624,51,105,51,105,0,0,19,49,55,67,122,3,11,3,45,82,121
14364,Dave Johnson,2010,2010,Quinnipiac,NEC,32,529,38,100,25,56,13,44,32,41,14,42,56,61,21,2,43,53,121
14365,Travon Landry,2014,2015,New Mexico State,WAC,59,671,31,91,27,70,4,21,55,83,5,56,61,54,14,1,37,45,121
14366,Jordan Madrid-Andrews,2016,2018,Total,Total,44,504,48,98,47,91,1,7,24,46,47,71,118,10,11,9,41,90,121
14367,James Marcellus,2010,2012,Delaware State,MEAC,65,652,45,91,45,91,0,0,31,51,32,67,99,10,12,29,24,106,121
14368,Bobby Miles,2011,2012,Hawaii,WAC,55,838,40,107,31,74,9,33,32,62,20,58,78,96,28,5,78,81,121
14369,Michael Ou,2019,2019,Cal State Northridge,Big West,29,469,47,84,47,84,0,0,27,44,21,50,71,7,3,13,24,71,121
14370,Vince Polakovic,2008,2008,San Francisco,WCC,8,218,43,80,36,64,7,16,28,37,9,24,33,4,4,3,4,20,121
14371,DuShaun Rice,2014,2014,Central Arkansas,Southland,29,476,37,108,19,50,18,58,29,40,19,37,56,44,18,3,28,44,121
14372,Spencer Rivers,2016,2019,UC-Irvine,Big West,76,634,45,121,25,55,20,66,11,30,3,49,52,49,19,1,37,58,121
14373,Junior Russell,2008,2008,Cal State Fullerton,Big West,20,395,38,78,21,46,17,32,28,36,4,26,30,51,34,0,54,52,121
14374,Burton Sampson,2015,2018,Belmont,OVC,94,804,36,90,21,38,15,52,34,44,22,50,72,38,15,7,42,82,121
14375,Kody Shubert,2019,2019,Presbyterian,Big South,36,409,44,116,28,69,16,47,17,22,5,26,31,50,10,1,29,29,121
14376,Greg Smith,2009,2010,Delaware State,MEAC,49,531,52,133,46,124,6,9,11,16,36,46,82,11,14,16,18,78,121
14377,Kevin Steuerer,2008,2008,Princeton,Ivy,28,597,44,105,37,74,7,31,26,41,16,34,50,50,14,2,43,52,121
14378,Greg Stiemsma,2008,2008,Wisconsin,Big Ten,35,403,51,93,51,93,0,0,19,23,38,70,108,25,13,40,25,53,121
14379,Mario Stula,2009,2011,DePaul,Big East,71,640,42,142,15,49,27,93,10,13,29,33,62,13,9,1,17,80,121
14380,Tristan Thomas,2015,2016,South Carolina Upstate,A-Sun,43,359,40,104,2,9,38,95,3,7,6,18,24,36,20,1,17,36,121
14381,Kamron Warner,2008,2008,Rider,MAAC,26,283,44,99,19,38,25,61,8,15,7,29,36,10,11,0,17,15,121
14382,Juwan Williams,2016,2019,Total,Big Sky,34,326,42,104,25,56,17,48,20,30,16,41,57,11,9,8,25,57,121
14383,Emmanuel Akot,2018,2019,Arizona,Pac-12,48,649,47,120,32,75,15,45,11,26,20,62,82,44,10,5,34,47,120
14384,Devonte Banner,2015,2016,Norfolk State,MEAC,53,442,41,103,16,39,25,64,13,31,13,35,48,34,15,2,23,48,120
14385,Jordan Brickman,2012,2012,Navy,Patriot,29,670,43,138,21,55,22,83,12,21,6,30,36,64,20,0,49,36,120
14386,Alex Brown,2013,2013,San Jose State,WAC,26,562,51,90,51,90,0,0,18,59,49,72,121,7,10,49,19,59,120
14387,Darryl Butterfield,2008,2008,Missouri,Big 12,30,425,45,112,37,86,8,26,22,36,19,42,61,18,19,1,26,54,120
14388,Leroy Butts IV,2018,2019,Radford,Big South,62,419,51,111,43,82,8,29,10,23,26,65,91,11,15,4,18,35,120
14389,Chris Collins,2012,2014,Cal State Fullerton,Big West,51,602,41,107,41,102,0,5,38,74,28,41,69,41,14,1,40,71,120
14390,Avery Diggs,2018,2018,South Carolina Upstate,A-Sun,31,431,53,94,52,89,1,5,13,23,43,68,111,8,7,16,24,62,120
14391,Neil Duval,2009,2011,Furman,Southern,63,554,39,106,37,97,2,9,40,58,35,34,69,15,6,13,32,63,120
14392,Kyle Griffin,2008,2011,Total,Total,47,537,40,119,14,42,26,77,14,18,7,37,44,50,17,0,32,40,120
14393,Papa Guisse,2009,2010,Cal State Fullerton,Big West,45,826,44,105,44,103,0,2,32,46,65,82,147,17,30,47,27,109,120
14394,Martell Jackson,2011,2011,Campbell,A-Sun,29,362,50,98,50,98,0,0,20,39,32,53,85,9,5,12,29,37,120
14395,Myreon Jones,2019,2019,Penn State,Big Ten,30,324,39,132,21,67,18,65,24,31,4,26,30,15,15,0,14,16,120
14396,Marek Koltun,2008,2010,Lafayette,Patriot,81,599,48,94,48,94,0,0,24,55,58,83,141,4,5,51,51,119,120
14397,Dominykas Kvedys,2008,2009,Sam Houston State,Southland,51,324,41,108,36,90,5,18,33,56,41,70,111,12,3,14,28,61,120
14398,Larry Lewis,2015,2015,Texas-San Antonio,CUSA,25,380,39,97,34,78,5,19,37,59,11,17,28,35,20,0,32,29,120
14399,Nigel Marshall,2019,2019,Coppin State,MEAC,28,353,48,123,40,88,8,35,16,30,10,41,51,14,20,7,41,33,120
14400,Tony McGilveary,2010,2010,Southern,SWAC,24,337,44,122,29,74,15,48,17,32,25,37,62,5,5,0,25,38,120
14401,Jeremy McKay,2013,2013,Sam Houston State,Southland,31,427,42,139,16,43,26,96,10,16,8,33,41,35,12,3,17,33,120
14402,Johnny McWilliams,2017,2019,Fresno State,MWC,63,513,41,122,27,66,14,56,24,43,12,24,36,21,20,6,18,57,120
14403,Christian Bibi Ndongo,2011,2012,Louisiana-Monroe,Sun Belt,50,731,41,112,38,102,3,10,35,57,45,76,121,18,14,31,40,90,120
14404,Victor Ojeleye,2009,2012,Kansas State,Big 12,90,577,51,112,48,102,3,10,15,29,49,76,125,10,11,13,30,60,120
14405,Jack Shaughnessy,2016,2017,Seattle,WAC,56,609,33,100,24,52,9,48,45,64,12,60,72,41,23,0,39,61,120
14406,Lucas Stivrins,2014,2016,Nevada,MWC,57,502,41,88,33,71,8,17,30,49,52,66,118,14,4,12,25,77,120
14407,Matt Terwilliger,2008,2008,Ohio State,Big Ten,37,574,47,106,32,53,15,53,11,16,19,69,88,20,15,12,22,48,120
14408,Trevaron Vinson,2008,2009,Colgate,Patriot,62,840,43,104,30,78,13,26,21,37,16,71,87,86,30,0,49,38,120
14409,Adrian Zamora,2008,2008,Montana State,Big Sky,30,535,46,105,44,95,2,10,26,41,38,93,131,28,19,30,19,81,120
14410,Bilal Abdur-Rahim,2017,2017,Southern Mississippi,CUSA,26,312,46,86,43,77,3,9,24,43,24,43,67,23,12,1,21,54,119
14411,Michael Almonacy,2017,2018,Stony Brook,AEC,51,475,40,119,24,62,16,57,23,29,17,44,61,56,23,1,22,53,119
14412,Arinze Anakwenze,2018,2018,Mississippi Valley State,SWAC,32,525,52,108,52,104,0,4,15,32,36,58,94,15,13,16,32,76,119
14413,Christian Anigwe,2019,2019,San Jose State,MWC,30,447,43,75,41,69,2,6,31,64,46,53,99,7,4,8,18,39,119
14414,Hashim Bailey,2008,2011,Total,Total,61,633,49,101,49,101,0,0,21,64,91,108,199,9,10,30,41,152,119
14415,Ra'shun Bryant,2008,2009,Tennessee Tech,OVC,54,425,50,109,48,98,2,11,17,24,54,53,107,21,18,11,53,96,119
14416,Dajour Dickens,2018,2019,Total,Total,38,595,45,95,45,93,0,2,29,46,43,85,128,9,6,60,30,81,119
14417,Juan Ferrales,2013,2013,Florida International,Sun Belt,31,402,36,98,18,51,18,47,29,40,12,21,33,26,13,2,29,38,119
14418,Jordan Goodman,2015,2015,New Mexico,MWC,19,255,45,124,35,85,10,39,19,31,11,32,43,17,8,1,15,19,119
14419,Darion Griswold,2012,2012,Arkansas State,Sun Belt,26,348,50,82,50,81,0,1,19,35,19,45,64,3,8,3,13,35,119
14420,Justyn Hamilton,2018,2019,Temple,AAC,39,385,51,98,50,95,1,3,16,31,28,33,61,11,13,9,14,60,119
14421,Robinson Idehen,2019,2019,UC-Santa Barbara,Big West,32,327,52,76,52,76,0,0,15,35,37,52,89,4,3,18,24,63,119
14422,Zach Jones,2010,2010,Tennessee-Martin,OVC,24,427,34,100,33,97,1,3,50,80,23,55,78,17,11,14,41,70,119
14423,Scott Kingsley,2014,2015,Fairleigh Dickinson,NEC,53,373,40,119,23,60,17,59,22,29,9,30,39,8,8,0,18,36,119
14424,Nic Lynch,2019,2019,Lehigh,Patriot,31,372,49,106,49,106,0,0,21,42,34,69,103,1,6,14,31,66,119
14425,Tyrone Lyons,2019,2019,North Carolina A&T,MEAC,31,357,43,80,38,61,5,19,28,41,13,42,55,9,10,6,20,32,119
14426,Sam McMahon,2008,2008,Delaware,CAA,23,381,41,100,28,56,13,44,24,32,13,37,50,14,5,1,18,34,119
14427,Connor Niego,2018,2019,Holy Cross,Patriot,32,411,47,109,28,53,19,56,6,11,12,44,56,13,5,9,19,37,119
14428,Jonathan Norfleet,2019,2019,Wagner,NEC,28,451,44,119,25,60,19,59,12,15,5,35,40,34,13,4,30,40,119
14429,Sean Price,2018,2019,Charleston Southern,Big South,46,481,42,103,27,54,15,49,20,30,19,37,56,37,26,2,21,39,119
14430,Brandon Rachal,2018,2018,Louisiana State,SEC,27,429,48,90,47,85,1,5,22,40,30,58,88,18,26,5,19,58,119
14431,Ben Robertson,2017,2019,Bucknell,Patriot,81,515,50,93,44,68,6,25,13,37,21,63,84,30,12,4,24,55,119
14432,Christian Robertson,2018,2019,Arkansas-Pine Bluff,SWAC,54,611,48,115,48,107,0,8,23,40,31,42,73,20,12,3,31,55,119
14433,LaTre'e Russell,2014,2015,Norfolk State,MEAC,41,551,42,97,42,94,0,3,35,49,32,47,79,23,10,14,48,99,119
14434,Andre Sands,2016,2016,Sam Houston State,Southland,32,271,51,82,51,80,0,2,17,32,31,32,63,8,5,2,20,65,119
14435,Dontavious Smith,2016,2018,Massachusetts-Lowell,AEC,45,377,50,94,50,93,0,1,19,33,33,75,108,24,16,29,48,68,119
14436,Petar Torlak,2011,2014,East Carolina,CUSA,62,379,41,95,18,38,23,57,14,23,8,36,44,32,14,1,29,31,119
14437,Wanjang Tut,2019,2019,Omaha,Summit,31,341,53,112,48,97,5,15,8,11,16,54,70,17,9,16,27,57,119
14438,Sidney Wilson,2019,2019,Connecticut,AAC,26,489,44,126,36,91,8,35,23,41,23,46,69,7,8,20,23,56,119
14439,Chris Agwumaro,2008,2008,Texas State,Southland,23,250,38,75,27,49,11,26,31,44,20,28,48,14,3,0,29,41,118
14440,Jeremy Barr,2009,2009,Louisiana,Sun Belt,23,395,46,97,46,97,0,0,26,52,24,33,57,7,4,4,30,67,118
14441,Justin Bean,2019,2019,Utah State,MWC,29,352,44,86,43,80,1,6,29,38,41,68,109,22,19,8,17,38,118
14442,Derrick Blackwell,2008,2010,Alcorn State,SWAC,61,521,36,115,18,62,18,53,28,46,11,34,47,59,32,1,97,68,118
14443,Cam Burrell,2019,2019,Eastern Illinois,OVC,24,415,52,96,52,96,0,0,14,34,49,54,103,20,14,21,24,51,118
14444,Matt Chastain,2017,2019,Total,MVC,34,726,47,89,35,52,12,37,12,19,38,101,139,38,13,12,25,54,118
14445,Muhammed Conteh,2009,2012,Western Michigan,MAC,92,746,52,104,52,102,0,2,14,37,66,93,159,8,13,15,36,115,118
14446,Nick Davidson,2014,2017,Valparaiso,Horizon,67,441,34,93,18,47,16,46,34,38,14,31,45,41,11,1,17,19,118
14447,AJ Edu,2019,2019,Toledo,MAC,33,472,36,93,32,71,4,22,42,56,32,97,129,24,10,57,40,64,118
14448,Jacob Epperson,2018,2019,Creighton,Big East,21,250,52,72,47,66,5,6,9,18,11,44,55,3,3,16,10,30,118
14449,Tim Finke,2019,2019,Grand Canyon,WAC,34,537,39,104,21,55,18,49,22,39,27,70,97,30,12,4,21,37,118
14450,James Jackson,2017,2018,UC-Riverside,Big West,55,660,46,114,35,80,11,34,15,36,35,90,125,35,8,8,46,64,118
14451,Earl Jefferson,2012,2012,Texas-Rio Grande Valley,GWC,28,602,41,114,35,89,6,25,30,49,37,96,133,24,11,5,59,55,118
14452,Johnnie Lett,2009,2010,Auburn,SEC,53,690,49,105,49,103,0,2,20,55,63,111,174,20,15,15,32,100,118
14453,Marcus Love,2014,2016,Jackson State,SWAC,44,547,40,125,30,72,10,53,28,46,24,31,55,29,9,1,30,74,118
14454,Douglass McLaughlin-Williams,2008,2008,Appalachian State,Southern,29,478,39,99,11,22,28,77,12,24,17,52,69,24,14,2,30,29,118
14455,Devon Oakley,2016,2019,Hampton,Total,56,609,40,87,37,74,3,13,35,52,9,101,110,45,31,12,34,51,118
14456,Nick Pallas,2016,2016,Texas-Arlington,Sun Belt,35,455,42,99,42,97,0,2,34,55,42,60,102,32,17,15,45,61,118
14457,Jahlil Rawley,2019,2019,Stetson,A-Sun,30,601,49,121,48,115,1,6,19,28,8,66,74,85,35,5,52,42,118
14458,Jared Ridder,2019,2019,Missouri State,MVC,23,433,40,107,14,25,26,82,12,23,6,35,41,13,11,9,6,18,118
14459,Derrell Robertson,2012,2015,Total,Total,85,867,48,98,48,97,0,1,22,35,73,83,156,10,14,48,48,199,118
14460,Keith Smith,2017,2018,Oregon,Pac-12,62,487,48,106,45,81,3,25,19,31,33,42,75,37,22,11,26,64,118
14461,Christopher Taylor,2008,2011,Brown,Ivy,98,815,50,121,50,120,0,1,18,43,42,74,116,56,12,16,49,104,118
14462,Leon Tolksdorf,2013,2017,Total,Total,60,605,42,133,19,39,23,94,11,20,28,78,106,33,16,10,21,64,118
14463,James Westbrook,2017,2017,Prairie View,SWAC,18,388,37,92,27,59,10,33,34,47,4,46,50,22,18,1,39,36,118
14464,Charlie Woods,2010,2011,Cleveland State,Horizon,53,519,40,114,16,42,24,72,14,20,27,67,94,18,14,32,16,66,118
14465,Eric Allen,2009,2009,Middle Tennessee,Sun Belt,30,366,44,129,30,70,14,59,15,22,21,45,66,16,11,1,18,23,117
14466,Jovan Austin,2015,2015,Bowling Green State,MAC,33,545,36,95,29,73,7,22,38,60,7,40,47,87,16,3,63,36,117
14467,Andrae Belton,2008,2008,Tennessee State,OVC,30,473,44,98,23,52,21,46,8,16,25,40,65,21,19,5,8,36,117
14468,Connor Bennett,2017,2019,Massachusetts-Lowell,AEC,38,355,48,73,48,73,0,0,21,31,35,35,70,11,4,9,16,40,117
14469,Ira Brown,2008,2009,Gonzaga,WCC,57,435,47,89,43,73,4,16,19,33,36,64,100,9,16,16,20,53,117
14470,Daronte Clark,2012,2012,Troy,Sun Belt,25,381,42,125,18,41,24,84,9,16,27,25,52,15,15,0,16,19,117
14471,Jordan Dallas,2017,2019,Weber State,Big Sky,55,461,44,78,43,74,1,4,28,40,22,72,94,7,5,18,26,85,117
14472,Destin Damachoua,2009,2010,New Orleans,Sun Belt,54,553,45,131,35,74,10,57,17,24,14,36,50,18,18,2,35,43,117
14473,Jaiden Delaire,2019,2019,Stanford,Pac-12,31,394,41,118,35,84,6,34,29,48,14,47,61,12,7,9,20,43,117
14474,Dan Dwyer,2015,2019,Total,Total,88,827,47,82,47,79,0,3,23,34,49,112,161,33,12,34,33,112,117
14475,Mike Fofana,2017,2018,Tennessee-Martin,OVC,49,596,46,112,45,100,1,12,24,36,31,83,114,38,14,8,40,46,117
14476,Evans Ganapamo,2013,2017,Total,Total,42,336,40,126,18,52,22,74,15,28,9,32,41,9,7,7,29,27,117
14477,Jeffrey Gary,2018,2018,North Carolina-Wilmington,CAA,32,545,41,108,16,34,25,74,10,12,12,40,52,42,13,1,30,36,117
14478,Khaliq Ghani,2013,2016,Yale,Ivy,55,455,38,97,14,30,24,67,17,22,10,52,62,19,12,10,24,43,117
14479,Joey Glynn,2019,2019,Massachusetts-Lowell,AEC,23,275,43,81,43,78,0,3,31,40,22,30,52,3,5,4,17,42,117
14480,Jamonte Graham,2014,2014,Tennessee State,OVC,26,438,41,112,30,69,11,43,24,35,11,25,36,35,11,1,31,51,117
14481,DeOndre Haynes,2013,2015,Tennessee Tech,OVC,44,445,39,110,37,95,2,15,37,53,9,39,48,42,21,4,41,29,117
14482,A.J. Highsmith,2008,2010,Appalachian State,Southern,61,359,39,95,7,10,32,85,7,9,6,39,45,22,5,0,26,28,117
14483,Ariston Johnson,2017,2018,Alabama A&M,SWAC,59,771,40,146,28,107,12,39,25,35,14,66,80,52,12,0,51,70,117
14484,Algie Key,2014,2014,Alabama,SEC,32,492,40,99,39,92,1,7,36,54,24,48,72,45,17,4,25,53,117
14485,Garrett Lever,2011,2011,Seattle,Ind,31,904,35,93,27,57,8,36,39,72,62,113,175,55,74,2,44,82,117
14486,Rondale Livas,2012,2012,Grambling,SWAC,28,702,40,132,37,119,3,13,34,54,18,61,79,54,28,0,87,45,117
14487,Nehemiah Mabson,2015,2015,Campbell,Big South,31,365,42,102,31,67,11,35,22,45,22,32,54,22,10,4,38,72,117
14488,Joran Mackie,2011,2011,San Diego,WCC,26,440,40,94,30,68,10,26,27,47,18,30,48,20,10,2,34,50,117
14489,Adrian Moss,2008,2009,IUPUI,Summit,32,434,43,107,34,67,9,40,22,36,10,22,32,63,28,1,36,33,117
14490,David Nyarsuk,2013,2014,Cincinnati,Total,55,521,51,87,51,87,0,0,15,23,49,61,110,9,4,41,30,75,117
14491,Evan Phoenix,2016,2016,Central Connecticut State,NEC,28,409,46,110,46,110,0,0,25,40,43,59,102,11,9,12,34,61,117
14492,Terrance Saintil,2009,2010,Virginia Commonwealth,CAA,57,445,51,102,51,102,0,0,15,34,41,65,106,10,19,15,25,78,117
14493,Serrel Smith Jr,2019,2019,Maryland,Big Ten,34,406,38,107,18,46,20,61,21,25,7,36,43,17,8,0,18,34,117
14494,A.J. Spencer,2010,2011,Alabama State,SWAC,41,762,32,108,30,85,2,23,51,72,17,46,63,124,29,4,82,83,117
14495,Josh Thompson,2017,2019,Ball State,MAC,52,581,36,99,19,44,17,55,28,38,5,41,46,44,18,2,32,50,117
14496,Dalen Traore,2017,2018,Evansville,MVC,51,619,31,77,31,76,0,1,55,84,48,90,138,7,10,5,26,92,117
14497,Malcolm Allen,2014,2018,Total,Total,60,576,47,100,40,75,7,25,15,27,4,31,35,49,20,1,40,36,116
14498,Rhett Anderson,2009,2012,Yale,Ivy,71,679,38,109,38,97,0,12,40,61,40,84,124,31,6,11,48,72,116
14499,Gertavian Blake,2010,2011,Jackson State,SWAC,63,645,51,98,51,98,0,0,14,60,56,98,154,7,5,48,69,150,116
14500,Elhanan Bone,2009,2012,North Carolina-Greensboro,Southern,57,547,44,122,43,116,1,6,27,54,47,64,111,6,12,14,37,97,116
14501,Terry Brutus,2013,2017,Total,Total,65,606,44,97,44,92,0,5,28,46,33,82,115,16,23,4,35,76,116
14502,Melvin Crowder,2008,2009,High Point,Big South,47,458,41,115,29,69,12,46,22,27,25,30,55,18,12,3,24,54,116
14503,Damien Daniels,2019,2019,Abilene Christian,Southland,34,510,40,113,25,60,15,53,21,26,12,41,53,61,20,1,32,47,116
14504,Jaron Faulds,2018,2018,Columbia,Ivy,26,369,53,89,53,89,0,0,10,23,33,51,84,10,8,26,21,44,116
14505,Carte'Are Gordon,2019,2019,Saint Louis,A-10,13,318,45,83,43,78,2,5,24,48,16,37,53,16,14,22,27,34,116
14506,Christian Hinckson,2019,2019,Manhattan,MAAC,32,538,42,117,38,96,4,21,28,51,29,57,86,32,21,10,37,53,116
14507,Jose Martinez,2017,2019,San Diego,WCC,52,273,38,104,20,37,18,67,22,31,14,38,52,6,5,12,18,51,116
14508,Jason McClellan,2015,2015,Illinois-Chicago,Horizon,25,419,44,114,32,69,12,45,16,20,36,63,99,9,11,17,14,59,116
14509,Demetrius Moore,2014,2014,Indiana State,MVC,34,402,50,88,49,86,1,2,15,24,33,53,86,10,4,5,26,69,116
14510,Cheikh N'diaye,2014,2017,Oregon State,Pac-12,80,521,48,74,48,74,0,0,20,38,28,64,92,6,7,33,37,93,116
14511,Blake Nash,2012,2012,South Florida,Big East,34,416,36,95,20,33,16,62,28,34,4,24,28,39,18,1,31,37,116
14512,Dwight Ramos,2017,2018,Cal State Fullerton,Big West,42,324,42,124,24,57,18,67,14,29,16,19,35,14,8,6,17,45,116
14513,Will Reinke,2010,2010,Stephen F. Austin,Southland,29,385,52,112,51,111,1,1,11,14,25,66,91,25,9,28,31,49,116
14514,Rick Roberts,2008,2008,Southern Utah,Summit,30,504,44,114,37,88,7,26,21,37,18,74,92,45,14,9,40,42,116
14515,Will Sessoms,2019,2019,Milwaukee,Horizon,31,399,47,117,38,69,9,48,13,26,26,56,82,7,6,10,26,55,116
14516,Chyree Walker,2018,2018,Delaware,CAA,30,486,50,122,45,101,5,21,11,31,30,42,72,17,13,1,25,51,116
14517,Clay Yeo,2014,2014,Valparaiso,Horizon,28,360,42,94,22,50,20,44,12,17,9,31,40,27,8,3,24,40,116
14518,Tyler Alderman,2013,2014,Jacksonville,A-Sun,45,493,45,102,45,101,0,1,25,39,39,72,111,15,12,32,25,85,115
14519,Brett Barney,2017,2019,Total,Total,54,388,48,105,34,64,14,41,5,15,20,44,64,11,6,2,11,60,115
14520,Kyle Broekhuis,2015,2017,Air Force,MWC,53,623,37,105,27,67,10,38,31,46,32,82,114,28,9,5,39,63,115
14521,Joe Burton,2018,2018,Valparaiso,MVC,10,251,39,81,22,36,17,45,20,26,8,26,34,8,1,6,16,14,115
14522,Kyonze Chavis,2019,2019,Norfolk State,MEAC,33,415,42,85,39,67,3,18,28,35,14,46,60,36,14,7,18,34,115
14523,Matt Cimino,2015,2019,Total,Total,79,590,46,105,32,60,14,45,9,19,25,65,90,31,9,19,52,77,115
14524,Jonathan Dupre,2009,2009,Pepperdine,WCC,26,408,49,150,44,121,5,29,12,16,17,44,61,6,9,7,25,40,115
14525,Malik Ellison,2018,2019,Eastern Michigan,MAC,55,661,37,133,20,68,17,65,24,34,12,29,41,67,27,0,48,35,115
14526,Seth Fuller,2017,2019,Elon,CAA,54,526,37,118,9,29,28,89,13,17,12,45,57,39,16,0,41,52,115
14527,Alex Gynes,2008,2008,Radford,Big South,29,415,45,91,45,82,0,9,25,47,33,52,85,15,10,2,28,24,115
14528,Tim Henderson,2011,2014,Louisville,Total,90,444,41,106,16,31,25,75,8,14,13,45,58,32,20,1,19,49,115
14529,Romain Henry,2011,2012,Kennesaw State,A-Sun,49,752,40,118,25,76,15,42,20,36,20,53,73,46,20,1,57,72,115
14530,Andre Ingram,2012,2013,Minnesota,Big Ten,63,604,45,93,45,93,0,0,25,52,50,57,107,8,25,23,34,80,115
14531,Mario Karailiev,2015,2016,Florida A&M,MEAC,55,788,52,109,52,108,0,1,11,28,36,71,107,8,9,17,54,91,115
14532,Isaac Kreuer,2014,2015,Missouri-Kansas City,WAC,59,620,41,98,41,96,0,2,33,51,33,72,105,7,12,14,29,99,115
14533,Kurt Looby,2008,2008,Iowa,Big Ten,32,584,50,75,50,75,0,0,15,36,47,100,147,17,15,43,32,46,115
14534,Trevor Manuel,2017,2017,Loyola Marymount,WCC,21,309,37,84,27,54,10,30,31,45,12,43,55,14,10,22,21,52,115
14535,Cam Martin,2018,2018,Jacksonville State,OVC,28,273,38,74,27,48,11,26,28,45,17,56,73,20,3,4,21,48,115
14536,Eric Massey,2009,2009,Tennessee-Martin,OVC,32,422,45,92,45,92,0,0,25,40,38,49,87,6,7,11,26,69,115
14537,Jordan Montgomery,2013,2014,Kennesaw State,A-Sun,46,361,34,91,12,30,22,61,25,45,14,34,48,22,18,3,24,54,115
14538,Grant Prusator,2015,2016,Indiana State,MVC,56,361,37,101,3,10,34,91,7,14,4,25,29,12,8,0,7,35,115
14539,Jeffrey Ryan,2008,2009,Longwood,Ind,44,343,35,88,29,68,6,20,39,61,28,38,66,9,8,7,32,63,115
14540,DeAndre Thomas,2008,2008,Indiana,Big Ten,32,330,52,111,52,111,0,0,11,21,24,35,59,16,13,3,30,73,115
14541,Reece Uhlenhopp,2010,2012,Drake,MVC,62,594,39,104,18,50,21,54,16,19,27,71,98,10,19,5,16,78,115
14542,Christian White,2013,2015,Total,Total,48,389,37,94,13,28,24,66,17,30,6,29,35,33,16,1,25,35,115
14543,Jeenathan Williams,2019,2019,Buffalo,MAC,36,327,44,123,39,76,5,47,22,36,30,31,61,8,8,7,13,41,115
14544,Kene Anyigbo,2011,2013,Western Kentucky,Sun Belt,65,488,38,87,38,87,0,0,38,70,52,52,104,22,19,4,41,80,114
14545,Corey Bingham,2008,2008,Toledo,MAC,30,734,40,118,14,25,26,93,8,17,11,52,63,33,28,5,35,66,114
14546,Christian Bishop,2019,2019,Creighton,Big East,28,229,49,73,49,70,0,3,16,37,28,32,60,12,11,15,25,37,114
14547,Allin Blunt,2019,2019,Massachusetts-Lowell,AEC,31,420,39,92,33,71,6,21,30,49,20,38,58,25,7,3,28,50,114
14548,Ryan Brooks,2010,2013,Rhode Island,A-10,78,814,51,115,51,115,0,0,12,36,58,105,163,20,15,38,33,71,114
14549,John Cahill,2011,2012,Boston College,ACC,54,735,35,79,6,15,29,64,15,19,11,55,66,20,22,5,15,39,114
14550,Montray Clemons,2013,2016,Total,Total,57,411,42,102,42,96,0,6,30,45,40,65,105,8,9,9,33,70,114
14551,Dwayne Cohill,2019,2019,Dayton,A-10,33,509,43,98,36,66,7,32,21,31,4,30,34,27,14,3,27,59,114
14552,Mike Cook,2008,2008,Pittsburgh,Big East,11,274,38,88,30,65,8,23,30,36,9,22,31,29,6,3,20,16,114
14553,Egheosa Edomwonyi,2010,2013,Total,Total,64,473,45,111,45,111,0,0,24,36,38,56,94,12,14,23,39,108,114
14554,Onyi Eyisi,2019,2019,Fordham,A-10,32,461,45,80,45,80,0,0,24,44,63,65,128,9,11,26,22,93,114
14555,John Guerra,2017,2019,North Carolina Central,MEAC,56,441,32,94,20,52,12,42,38,54,27,28,55,26,15,0,21,44,114
14556,Jay Hedgeman,2016,2016,Louisiana,Sun Belt,24,326,32,81,26,52,6,29,44,63,18,47,65,26,17,3,18,51,114
14557,Lorenza Knight,2008,2009,Charleston Southern,Big South,48,653,41,76,41,73,0,3,32,44,13,37,50,124,30,11,61,60,114
14558,Dave LaMore,2012,2015,Cornell,Ivy,69,634,46,93,46,92,0,1,22,41,49,59,108,11,4,16,27,98,114
14559,Kendall Lauderdale,2019,2019,Albany (NY),AEC,32,368,45,83,45,83,0,0,24,28,21,57,78,3,9,6,20,45,114
14560,Zachary Lee,2015,2015,Tennessee State,OVC,31,593,44,105,44,103,0,2,26,44,34,57,91,13,13,15,33,68,114
14561,Trey Lenox,2017,2019,Abilene Christian,Southland,89,890,40,110,20,54,20,56,14,18,12,69,81,41,32,2,45,105,114
14562,Artavious McDyess,2017,2019,Arkansas-Pine Bluff,SWAC,66,648,46,85,46,85,0,0,22,48,49,79,128,13,14,32,51,82,114
14563,Camden Miller,2008,2010,Total,Total,37,350,39,100,16,39,23,61,13,19,16,41,57,18,10,7,28,38,114
14564,Alpha N'Diaye,2011,2011,Sacramento State,Big Sky,19,394,42,94,40,91,2,3,28,53,42,83,125,8,9,20,12,49,114
14565,Aliaksei Patsevich,2011,2012,Southern Methodist,CUSA,48,679,40,122,22,51,18,71,16,21,22,32,54,36,24,8,30,54,114
14566,Federico Poser,2019,2019,Elon,CAA,30,462,44,84,44,84,0,0,26,49,27,58,85,30,7,10,48,87,114
14567,Jared Rhoden,2019,2019,Seton Hall,Big East,34,436,39,114,24,53,15,61,21,37,37,52,89,12,17,9,11,43,114
14568,Chris Sights,2010,2011,Prairie View,SWAC,59,656,41,134,36,105,5,29,27,39,17,57,74,71,24,0,56,65,114
14569,Scott Sill,2013,2016,Delaware State,MEAC,51,458,45,139,23,53,22,86,2,9,23,63,86,6,7,6,21,45,114
14570,Derrick Simmons,2008,2008,Florida Atlantic,Sun Belt,31,462,41,81,34,59,7,22,25,34,33,38,71,11,16,8,27,66,114
14571,Troy Simmons,2014,2015,Bethune-Cookman,MEAC,57,1073,34,113,27,85,7,28,39,51,7,47,54,105,34,4,85,94,114
14572,Quentin Thomas,2008,2008,North Carolina,ACC,37,588,43,78,40,65,3,13,25,32,6,46,52,113,17,5,62,55,114
14573,Jacolby Wells,2010,2012,Mount St. Mary's,NEC,63,496,44,100,44,100,0,0,26,47,45,46,91,9,7,39,28,55,114
14574,Jeremy Bogus,2012,2015,Jacksonville,A-Sun,64,406,38,128,12,32,26,96,11,14,13,13,26,10,10,4,14,46,113
14575,Will Butler,2019,2019,Alabama-Birmingham,CUSA,17,374,47,79,47,79,0,0,19,31,32,65,97,7,7,6,16,44,113
14576,Ridell Camidge,2016,2016,Charlotte,CUSA,28,404,40,135,16,40,24,95,9,18,9,45,54,22,7,0,25,31,113
14577,Chris Clement,2011,2014,Princeton,Ivy,66,663,32,93,14,36,18,57,31,36,10,51,61,31,31,2,28,81,113
14578,Allen Dickerson,2011,2014,Radford,Big South,75,531,39,111,20,41,19,70,16,26,17,32,49,27,19,3,29,44,113
14579,Vincent Dillard,2014,2014,Texas-Arlington,Sun Belt,28,342,36,100,25,61,11,39,30,60,24,35,59,6,14,2,30,34,113
14580,Wil Fameni,2008,2008,Virginia Commonwealth,CAA,25,443,39,90,39,85,0,5,35,56,40,54,94,14,10,9,28,46,113
14581,Perry Francois,2017,2018,Texas A&M-Corpus Christi,Southland,64,581,51,106,51,106,0,0,11,33,52,72,124,17,5,25,42,109,113
14582,Karlis Garoza,2018,2019,Cal Poly,Big West,47,576,43,100,43,100,0,0,27,50,72,92,164,19,14,8,42,90,113
14583,Jack Hill,2009,2012,Saint Peter's,MAAC,84,729,50,108,50,108,0,0,13,28,52,86,138,23,13,31,39,136,113
14584,Brandon Jackson,2008,2010,Gardner-Webb,Total,51,680,38,92,38,88,0,4,37,65,15,54,69,139,40,2,92,105,113
14585,Trevis Jackson,2014,2017,Sacramento State,Big Sky,85,792,33,81,18,29,15,52,32,44,18,59,77,76,20,1,37,68,113
14586,Johndre Jefferson,2010,2011,South Carolina,SEC,54,646,49,95,49,95,0,0,15,46,59,83,142,13,18,62,29,75,113
14587,Steve Johnson,2013,2013,Winthrop,Big South,29,418,38,102,33,77,5,25,32,45,28,65,93,10,8,2,15,60,113
14588,Ted Kapita,2017,2017,North Carolina State,ACC,26,328,45,74,45,74,0,0,23,28,29,59,88,9,2,8,25,50,113
14589,Houston Kessler,2014,2017,Georgia,SEC,105,925,45,130,39,92,6,38,17,30,58,101,159,10,16,17,36,131,113
14590,Daniel Levitt,2016,2017,Cleveland State,Horizon,35,329,34,103,6,19,28,84,17,22,15,13,28,6,10,0,6,23,113
14591,Jordan Little,2019,2019,Morgan State,MEAC,28,348,49,97,49,97,0,0,15,29,31,55,86,4,2,7,23,55,113
14592,Lorenzo Mata-Real,2008,2008,UCLA,Pac-10,37,500,47,95,47,95,0,0,19,42,53,75,128,6,6,41,18,56,113
14593,Patrick McCollum,2010,2010,San Diego,WCC,25,363,37,133,28,85,9,48,30,46,15,35,50,42,10,2,62,30,113
14594,B.J. McLaughlin,2013,2013,Tennessee-Martin,OVC,29,455,43,109,38,87,5,22,22,33,28,55,83,22,14,6,33,76,113
14595,Karlos Odum,2016,2017,North Florida,A-Sun,47,405,29,65,29,64,0,1,55,81,26,40,66,15,10,12,21,53,113
14596,Francis Okoro,2019,2019,Oregon,Pac-12,37,502,45,96,45,96,0,0,23,49,49,70,119,6,7,20,26,65,113
14597,Phillip Pandak,2008,2011,Citadel,Southern,51,348,39,117,9,18,30,99,5,8,9,35,44,12,12,1,7,28,113
14598,Bryce Peters,2017,2017,Colorado,Pac-12,24,379,40,102,27,63,13,39,20,36,7,26,33,24,10,1,17,37,113
14599,Justin Philippe,2014,2014,Incarnate Word,Southland,26,329,41,79,41,79,0,0,31,42,27,52,79,22,4,4,29,40,113
14600,Stacey Poole,2011,2014,Total,Total,57,373,39,113,33,85,6,28,29,46,15,43,58,17,9,2,22,37,113
14601,Lachlan Prest,2012,2013,Nicholls State,Southland,22,523,40,104,13,29,27,75,6,7,8,39,47,29,7,6,30,55,113
14602,Bruce Reed,2013,2013,Morehead State,OVC,31,402,39,75,33,60,6,15,29,40,32,47,79,28,22,13,34,70,113
14603,Patrick Robinson Jr.,2016,2017,Detroit Mercy,Horizon,32,358,37,81,7,13,30,68,9,10,12,16,28,20,6,4,7,44,113
14604,Logan Ryan,2018,2019,Colorado State,MWC,48,382,41,68,34,49,7,19,24,33,26,50,76,18,7,12,20,82,113
14605,Brandon Smith,2009,2011,Total,Total,31,360,36,93,16,40,20,53,21,26,4,26,30,9,13,1,14,28,113
14606,Thaddeus Smith,2015,2016,Missouri-Kansas City,WAC,58,849,48,98,48,98,0,0,17,49,92,126,218,5,28,64,49,146,113
14607,Brendyn Taylor,2013,2016,Total,Total,56,539,39,102,26,57,13,45,22,46,12,64,76,34,16,4,25,65,113
14608,Brandon Vega,2014,2014,Winthrop,Big South,32,416,39,84,38,81,1,3,34,44,12,36,48,61,11,1,37,37,113
14609,Dibaji Walker,2019,2019,Cleveland State,Horizon,24,335,41,97,21,37,20,60,11,19,14,23,37,13,10,6,14,35,113
14610,Brion Whitley,2018,2019,Murray State,OVC,45,306,35,81,11,26,24,55,19,29,6,19,25,11,11,1,14,29,113
14611,Mitch Woods,2011,2012,Appalachian State,Southern,56,956,39,110,31,76,8,34,27,55,26,83,109,110,17,9,74,95,113
14612,Jamie Ahale,2019,2019,Illinois-Chicago,Horizon,32,491,38,100,3,6,35,94,1,4,14,37,51,14,10,3,9,27,112
14613,Doug Archer,2011,2013,North Dakota,Total,75,619,43,93,39,73,4,20,22,40,28,58,86,24,9,41,41,96,112
14614,Lavar Batts Jr.,2018,2018,North Carolina State,ACC,30,396,35,109,26,61,9,48,33,56,9,28,37,45,25,3,19,43,112
14615,David Boarden,2008,2012,Total,Total,67,661,41,138,23,73,18,65,12,23,17,40,57,31,12,11,34,70,112
14616,Basil Brown,2012,2013,Texas State,Total,52,405,32,90,26,59,6,31,42,61,17,38,55,22,16,1,18,35,112
14617,Zach Cameron,2017,2019,Total,Total,62,849,43,93,43,92,0,1,26,47,57,136,193,27,11,26,30,101,112
14618,Pierre Crawford,2014,2015,Total,Total,47,349,48,107,48,107,0,0,16,38,43,53,96,7,6,7,31,81,112
14619,Aaron Duhart,2019,2019,Army,Patriot,32,411,42,106,31,63,11,43,17,20,5,29,34,48,12,1,26,41,112
14620,Rod Emanuel,2011,2011,Middle Tennessee,Sun Belt,29,538,41,116,29,78,12,38,18,24,6,71,77,45,25,4,31,64,112
14621,Bruce English,2012,2013,Loyola Marymount,WCC,43,549,38,134,28,79,10,55,26,47,14,32,46,31,11,1,37,65,112
14622,Junior Farquhar,2019,2019,Middle Tennessee,CUSA,32,631,44,126,36,83,8,43,16,25,14,61,75,55,28,3,44,65,112
14623,Nourse Fox,2015,2018,Navy,Patriot,105,979,40,133,25,64,15,69,17,27,11,69,80,101,32,0,74,107,112
14624,Tanner Giddings,2013,2014,Fresno State,MWC,57,813,49,116,47,110,2,6,12,21,43,63,106,12,17,21,25,106,112
14625,Robert Harris,2013,2013,Idaho,WAC,24,421,44,112,28,71,16,41,8,16,7,42,49,42,11,0,43,44,112
14626,Baryn Houston,2013,2016,Alabama A&M,SWAC,67,503,40,145,23,67,17,78,15,28,30,59,89,11,9,3,14,49,112
14627,Jordan Lawson,2011,2014,Delaware State,MEAC,84,563,39,83,39,82,0,1,34,49,51,61,112,10,19,13,27,76,112
14628,Simeon Marsalis,2010,2011,Vermont,AEC,67,687,26,107,18,59,8,48,52,69,10,52,62,49,23,3,63,52,112
14629,Sekani Milligen,2010,2010,Alabama State,SWAC,30,406,36,119,12,34,24,85,16,22,13,31,44,10,12,2,19,34,112
14630,Tim Myles,2014,2018,Total,Total,54,613,41,92,40,91,1,1,29,64,81,115,196,23,22,21,63,137,112
14631,Alibaba Odd,2010,2011,Delaware State,MEAC,21,292,37,85,29,68,8,17,30,38,10,15,25,13,9,2,23,24,112
14632,Kudus Ogbara,2008,2009,Alabama A&M,SWAC,47,749,42,112,39,95,3,17,25,44,35,75,110,21,26,25,49,116,112
14633,Will Ohuaregbe,2010,2010,North Carolina-Wilmington,CAA,28,487,46,104,46,103,0,1,20,53,50,83,133,15,9,10,37,70,112
14634,Jermey Parnell,2008,2008,Mississippi,SEC,30,409,44,83,44,83,0,0,24,41,41,58,99,10,7,22,23,60,112
14635,Mitchell Seraille,2019,2019,Stephen F. Austin,Southland,27,481,46,77,46,76,0,1,20,40,38,78,116,15,11,29,38,62,112
14636,Tolu Smith,2019,2019,Western Kentucky,CUSA,34,344,42,72,42,72,0,0,28,49,30,59,89,8,3,11,35,52,112
14637,Xavier Smith,2018,2019,Total,Total,37,451,40,89,36,74,4,15,28,40,1,40,41,48,14,4,38,33,112
14638,Da'Monte Williams,2019,2019,Illinois,Big Ten,33,713,32,93,19,52,13,41,35,50,28,89,117,41,26,8,22,66,112
14639,Jai Williams,2015,2018,Saint Joseph's,A-10,57,446,42,68,42,68,0,0,28,45,33,51,84,2,9,9,25,74,112
14640,Angelo Allegri,2019,2019,North Carolina-Greensboro,Southern,35,369,42,98,21,31,21,67,6,13,24,31,55,10,12,2,14,50,111
14641,Robert Baker,2008,2008,South Carolina State,MEAC,27,390,36,106,14,44,22,62,17,23,20,34,54,23,11,5,38,64,111
14642,Stian Berg,2012,2012,Northern Illinois,MAC,30,514,34,101,7,22,27,79,16,26,4,23,27,38,10,0,35,31,111
14643,Martell Buie,2010,2010,Tennessee State,OVC,28,333,33,83,15,36,18,47,27,38,5,31,36,31,32,0,33,32,111
14644,Duane Clark,2017,2017,Missouri-Kansas City,WAC,32,349,50,102,50,102,0,0,11,31,23,40,63,14,7,14,37,58,111
14645,Cory Davis,2009,2009,Southern Utah,Summit,28,486,34,91,21,56,13,35,30,40,8,20,28,62,13,2,53,50,111
14646,Brian Freeman,2011,2013,Total,Total,26,338,47,97,47,97,0,0,17,28,18,54,72,5,6,26,34,39,111
14647,Ron Giplaye,2011,2015,Total,Total,64,476,42,91,42,91,0,0,27,71,70,73,143,12,15,40,25,83,111
14648,Kevin Henderson,2012,2013,Montana,Big Sky,49,437,42,101,29,59,13,42,14,20,20,55,75,14,12,2,27,46,111
14649,Christian Hernandez,2008,2009,San Francisco,WCC,59,674,35,106,9,25,26,81,15,24,13,49,62,48,24,8,41,106,111
14650,Preston Herring,2013,2014,Austin Peay,OVC,49,369,40,68,34,60,6,8,25,46,21,43,64,11,10,16,19,39,111
14651,Jason Horton,2008,2008,Missouri,Big 12,29,666,35,98,27,61,8,37,33,42,9,45,54,94,35,0,33,70,111
14652,Tony Kimbro,2012,2012,Georgia State,CAA,34,477,43,96,35,70,8,26,17,41,28,49,77,28,34,8,30,51,111
14653,Josh Linthicum,2008,2009,Bucknell,Patriot,37,518,45,102,45,102,0,0,21,39,54,73,127,13,10,25,31,96,111
14654,Yemi Makenjuola,2012,2013,Tennessee,SEC,57,457,42,86,42,86,0,0,27,45,60,87,147,7,7,20,23,93,111
14655,Kevin McShane,2009,2012,Oregon State,Total,101,868,48,87,48,76,0,11,15,34,57,79,136,36,20,5,56,122,111
14656,Robin Mestdagh,2008,2010,Eastern Kentucky,OVC,77,619,39,108,10,20,29,88,4,7,14,45,59,38,19,1,32,73,111
14657,Jay Nagle,2019,2019,UC-Santa Barbara,Big West,32,380,37,77,7,9,30,68,7,9,9,49,58,15,6,2,5,10,111
14658,Tshiefu Ngalakulondi,2018,2019,St. Bonaventure,A-10,37,376,46,103,31,63,15,40,4,12,23,71,94,15,18,16,19,45,111
14659,Patrick Nyeko,2010,2013,Nevada,Total,93,974,27,94,17,48,10,46,47,67,42,56,98,49,20,7,42,77,111
14660,Anthony Ochefu,2018,2019,Stony Brook,AEC,47,443,44,96,44,95,0,1,23,42,38,72,110,5,9,7,42,65,111
14661,Jamar Redmond,2015,2016,Morgan State,MEAC,41,351,36,122,12,35,24,87,15,29,14,19,33,9,8,1,20,61,111
14662,Josh Riddle,2009,2010,Dartmouth,Ivy,49,627,46,141,43,113,3,28,16,24,29,65,94,33,23,21,34,50,111
14663,Quentin Scott,2018,2019,Texas State,Sun Belt,45,429,42,107,41,94,1,13,26,54,31,55,86,14,9,5,16,60,111
14664,Shack Scott,2017,2018,Wagner,NEC,43,464,47,93,46,91,1,2,16,30,30,55,85,5,6,12,14,93,111
14665,Mohamed Sherif,2016,2017,Alabama A&M,SWAC,33,383,39,74,39,74,0,0,33,77,36,49,85,5,3,8,28,61,111
14666,Anthony Silvestri,2013,2015,Cal Poly,Big West,64,504,37,132,8,15,29,117,8,14,22,46,68,4,7,1,11,71,111
14667,Darrion Strong-Moore,2017,2017,Oklahoma,Big 12,29,437,42,109,22,44,20,65,7,13,4,29,33,41,7,1,32,37,111
14668,Mohamed Thiam,2019,2019,New Mexico State,WAC,25,289,40,104,21,38,19,66,12,18,35,61,96,6,9,5,22,29,111
14669,Richard Thomas,2010,2010,North Texas,Sun Belt,21,375,34,93,18,39,16,54,27,40,7,38,45,22,9,9,34,44,111
14670,Jonathan Williams,2008,2009,Minnesota,Big Ten,50,529,48,110,48,110,0,0,15,34,41,61,102,22,13,28,45,85,111
14671,Devin Wilson,2014,2015,North Florida,A-Sun,58,574,31,94,15,40,16,54,33,51,6,45,51,69,28,0,44,41,111
14672,Simon Wright,2018,2019,Elon,CAA,62,533,43,114,24,57,19,57,6,14,29,73,102,36,11,4,27,71,111
14673,Brendan Bailey,2019,2019,Marquette,Big East,34,478,39,113,23,50,16,63,16,25,26,34,60,14,13,16,7,41,110
14674,Travon Bunch,2019,2019,Grambling,SWAC,32,403,46,76,46,76,0,0,18,48,21,79,100,13,3,44,53,79,110
14675,Russell Byrd,2012,2014,Michigan State,Big Ten,78,526,35,121,13,26,22,95,18,32,23,36,59,25,10,9,28,66,110
14676,Mairega Clarke,2016,2018,Texas-Arlington,Sun Belt,47,462,36,84,24,54,12,30,26,38,8,35,43,19,18,19,36,50,110
14677,Olivier Dupiton,2008,2010,Stetson,A-Sun,78,744,39,90,39,90,0,0,32,58,55,84,139,18,46,15,59,85,110
14678,D.J. Griggs,2013,2014,Long Island University,NEC,44,437,30,104,15,54,15,50,35,43,7,27,34,19,12,1,20,49,110
14679,Hari Hall,2015,2015,James Madison,CAA,19,283,40,96,28,62,12,34,18,26,13,38,51,6,6,2,22,18,110
14680,Jamir Harris,2018,2018,Minnesota,Big Ten,28,394,38,108,10,27,28,81,6,12,5,20,25,17,7,1,15,25,110
14681,Rodney Hunter,2016,2019,Columbia,Ivy,65,733,48,107,47,93,1,14,13,32,43,95,138,48,22,16,46,88,110
14682,Rasi Jenkins,2013,2014,Prairie View,SWAC,63,844,39,89,39,88,0,1,32,56,71,86,157,20,27,23,45,105,110
14683,Tyrell Lynch,2009,2009,Massachusetts,A-10,30,492,50,106,50,105,0,1,10,25,45,64,109,14,11,11,27,77,110
14684,Sam Mike,2011,2014,Georgia Southern,Southern,94,781,45,87,45,87,0,0,20,40,49,74,123,3,10,7,41,128,110
14685,Jaro Moravek,2015,2018,Troy,Sun Belt,56,488,39,113,20,35,19,78,13,21,36,61,97,16,14,12,18,52,110
14686,Emmanuel Negedu,2009,2011,Total,Total,43,380,32,65,31,60,1,5,45,65,34,76,110,13,12,19,21,49,110
14687,D'Jari Nelson,2012,2012,Chicago State,GWC,29,570,43,92,35,67,8,25,16,30,18,62,80,4,19,20,45,92,110
14688,Wayne Portalatin,2008,2011,Texas-El Paso,CUSA,98,794,45,84,45,84,0,0,20,38,61,76,137,13,13,20,30,189,110
14689,Raymond Robinson,2008,2008,Texas Southern,SWAC,30,249,41,103,29,60,12,43,16,20,2,10,12,22,2,0,31,16,110
14690,Jake Spurgeon,2016,2018,Seattle,WAC,44,445,37,120,16,28,21,92,15,24,13,32,45,15,7,3,17,51,110
14691,Julian Torres,2016,2018,Total,Total,33,341,41,100,37,92,4,8,24,40,33,50,83,10,5,18,29,80,110
14692,Jacob Tryon,2019,2019,Portland,WCC,21,376,45,101,33,55,12,46,8,11,9,57,66,13,3,13,18,19,110
14693,Andrew Williams,2008,2008,Alabama A&M,SWAC,28,384,38,90,17,41,21,49,13,30,35,33,68,10,19,5,19,32,110
14694,Da'Monte Williams,2018,2018,Illinois,Big Ten,31,523,35,104,26,64,9,40,31,44,31,58,89,33,23,4,28,43,110
14695,Damian Windham,2010,2010,Chicago State,GWC,19,458,39,91,39,91,0,0,32,55,47,42,89,21,19,3,43,39,110
14696,Jordan Ash,2016,2019,Northwestern,Big Ten,88,653,38,112,17,41,21,71,12,19,6,58,64,60,27,1,30,59,109
14697,Karanvir Aujla,2008,2008,Morgan State,MEAC,29,310,38,87,13,21,25,66,8,10,12,12,24,4,4,1,18,29,109
14698,Peter Barba,2016,2019,Columbia,Ivy,49,473,39,98,11,27,28,71,3,4,9,45,54,28,12,3,12,61,109
14699,Quinn Brownfield,2008,2009,Virginia Military Institute,Big South,51,388,36,112,12,32,24,80,13,22,19,36,55,12,12,5,27,70,109
14700,Zach Burnham,2013,2014,Coppin State,MEAC,32,573,44,125,44,124,0,1,21,33,40,62,102,6,12,10,29,74,109
14701,Cory Cardwell,2014,2016,Utah Valley,WAC,42,396,35,97,9,17,26,80,13,15,2,34,36,33,11,2,14,47,109
14702,Nelly Cummings,2018,2018,Bowling Green State,MAC,30,396,41,108,31,68,10,40,17,28,7,27,34,29,20,2,19,31,109
14703,Mike Davis,2013,2013,Northern Illinois,MAC,29,400,37,110,34,94,3,16,32,53,19,41,60,7,15,2,20,32,109
14704,Karee Ferguson,2012,2013,Saint Peter's,MAAC,31,446,45,121,37,95,8,26,11,24,31,49,80,10,9,25,30,54,109
14705,Donovan Franklin,2017,2017,Indiana State,MVC,26,332,35,102,21,49,14,53,25,33,11,29,40,17,6,0,24,27,109
14706,Erten Gazi,2016,2019,Total,Total,48,578,43,89,35,53,8,36,15,20,18,43,61,40,12,2,37,64,109
14707,Jordan Guest,2019,2019,Boston University,Patriot,21,307,43,99,32,55,11,44,12,20,23,51,74,8,4,4,26,48,109
14708,Jordan Henderson,2019,2019,Canisius,MAAC,31,456,38,82,20,36,18,46,15,21,13,30,43,26,13,8,18,55,109
14709,Emerson Herndon,2009,2012,Rice,CUSA,70,341,41,110,41,110,0,0,27,48,27,56,83,10,7,8,18,60,109
14710,Corey Hilliard,2012,2015,Total,Total,46,457,37,112,25,72,12,40,23,37,8,31,39,26,12,2,33,51,109
14711,Jovan Ignjatovic,2008,2009,Illinois-Chicago,Horizon,54,435,43,100,41,88,2,12,21,28,25,59,84,6,18,9,22,69,109
14712,Darien Jackson,2018,2019,Tulsa,AAC,44,403,48,98,48,84,0,14,13,28,16,33,49,23,25,1,26,46,109
14713,Stevan Krtinic,2019,2019,St. Francis (NY),NEC,28,417,38,75,18,31,20,44,13,17,7,40,47,29,5,1,25,33,109
14714,Greg Kuakumensah,2018,2019,Niagara,MAAC,59,526,40,101,33,73,7,28,22,29,31,79,110,12,16,16,28,85,109
14715,Luke Lawson,2019,2019,North Carolina-Asheville,Big South,31,451,37,99,8,16,29,83,6,6,17,41,58,17,7,6,19,26,109
14716,Marcus Malone,2008,2008,Houston,CUSA,30,470,35,120,4,26,31,94,8,11,10,42,52,35,28,6,17,45,109
14717,John Moran,2013,2017,Total,Total,50,472,32,109,0,12,32,97,13,21,11,25,36,32,13,1,38,53,109
14718,Jessie Pernell,2012,2013,Georgia Southern,Southern,35,553,40,106,20,45,20,61,9,12,7,45,52,22,18,0,25,38,109
14719,Graeme Radford,2008,2011,Stetson,A-Sun,103,1053,46,107,46,107,0,0,17,77,82,121,203,7,14,55,42,152,109
14720,Zack Rebillot,2008,2010,Youngstown State,Horizon,52,525,40,76,40,74,0,2,29,44,47,89,136,14,11,19,27,80,109
14721,DeMonte Simpson,2010,2011,Florida Atlantic,Sun Belt,28,399,42,86,42,86,0,0,25,47,30,78,108,9,3,7,24,62,109
14722,Cameron Solomon,2011,2013,Total,Total,26,227,39,87,38,80,1,7,30,46,9,18,27,8,4,1,13,15,109
14723,Johnnie Vassar,2015,2019,Total,Total,38,326,38,102,27,72,11,30,22,45,6,47,53,22,9,2,50,47,109
14724,Britton Williams,2013,2014,Total,Total,37,655,38,93,36,80,2,13,31,44,2,36,38,97,20,1,44,63,109
14725,Wendell Wright,2009,2013,Total,Total,76,958,39,88,39,84,0,4,31,61,39,59,98,55,14,8,55,87,109
14726,Branden Aughburns,2016,2017,Hampton,MEAC,38,332,42,91,41,89,1,2,23,40,30,37,67,3,3,21,22,50,108
14727,Aaron Austin,2012,2013,Hampton,MEAC,39,626,39,117,32,89,7,28,23,46,13,51,64,59,22,7,58,87,108
14728,Corey Blake,2013,2013,New Orleans,Ind,14,372,37,112,29,72,8,40,26,33,20,34,54,17,26,6,40,24,108
14729,K.J. Bluford,2014,2016,Total,Total,20,216,36,101,5,9,31,92,5,10,5,11,16,10,7,2,9,32,108
14730,Mitch Boyce,2008,2008,Nicholls State,Southland,28,301,40,109,29,58,11,51,17,33,18,25,43,13,11,10,19,35,108
14731,Tevin Caldwell,2014,2016,Texas-El Paso,CUSA,58,461,38,64,38,63,0,1,32,41,29,47,76,26,19,6,14,47,108
14732,Sherman Diaz,2008,2008,La Salle,A-10,30,387,41,94,23,42,18,52,8,15,19,24,43,32,17,25,28,46,108
14733,Osas Ebomwonyi,2011,2013,Lamar,Southland,62,671,45,96,45,96,0,0,18,57,78,112,190,7,19,86,30,100,108
14734,Carl Engstrom,2011,2014,Alabama,SEC,84,773,43,90,43,90,0,0,22,37,59,105,164,16,13,44,45,112,108
14735,Ali Fall,2013,2014,Nevada,MWC,46,543,39,91,39,91,0,0,30,44,34,49,83,16,4,14,40,96,108
14736,Andrew Hampton,2015,2016,Morgan State,MEAC,18,254,38,92,10,27,28,65,4,7,4,21,25,7,7,2,2,27,108
14737,Kevin Harden,2013,2015,Purdue-Fort Wayne,Summit,28,493,41,127,25,77,16,50,10,21,27,49,76,30,17,0,32,20,108
14738,"Allen Hatchett, Jr.",2019,2019,South Carolina State,MEAC,34,577,36,119,19,53,17,66,19,27,18,51,69,19,19,10,30,64,108
14739,Kwinton Hinson,2018,2018,Washington State,Pac-12,28,381,41,105,24,53,17,52,9,20,14,49,63,18,7,4,28,56,108
14740,Sam Ibiezugbe,2017,2019,Monmouth,MAAC,74,509,46,109,46,109,0,0,16,32,40,85,125,3,13,23,22,82,108
14741,Michael Kach,2008,2008,Pennsylvania,Ivy,23,314,30,78,23,53,7,25,41,51,14,43,57,19,12,4,31,32,108
14742,Clark Lammert,2012,2015,Texas Tech,Big 12,75,529,31,76,20,48,11,28,35,55,55,45,100,26,17,5,20,61,108
14743,Paul Larsen,2011,2012,Mercer,A-Sun,61,370,33,94,33,94,0,0,42,70,38,60,98,9,14,3,32,45,108
14744,Sidy Ndir,2016,2016,New Mexico State,WAC,28,305,34,83,21,40,13,43,27,36,6,36,42,20,3,4,20,31,108
14745,Casmir Ochiaka,2019,2019,Loyola (MD),Patriot,28,377,42,77,42,77,0,0,24,46,34,67,101,12,10,5,33,58,108
14746,Julius Rajala,2015,2016,Loyola (IL),MVC,49,420,46,79,45,77,1,2,15,25,30,46,76,11,10,17,32,61,108
14747,Stephane Raquil,2013,2014,Alcorn State,SWAC,64,881,44,97,44,96,0,1,20,42,47,88,135,11,14,32,37,142,108
14748,Adam Saeed,2019,2019,Savannah State,MEAC,27,398,40,83,36,58,4,25,24,45,27,29,56,13,14,10,29,46,108
14749,Manny Suarez,2015,2018,Total,Total,43,323,41,117,29,69,12,48,14,21,26,76,102,12,4,31,23,58,108
14750,Anselm Uzuegbunem,2019,2019,Southern Illinois-Edwardsville,OVC,30,661,41,94,41,91,0,3,26,37,36,91,127,17,7,16,30,88,108
14751,Marc-Antoine Bourgault,2013,2014,St. John's (NY),Big East,43,349,37,107,8,20,29,87,4,5,11,22,33,9,6,3,12,20,107
14752,Sy Chatman,2019,2019,Massachusetts,A-10,29,410,40,77,36,66,4,11,23,38,29,33,62,9,8,18,21,60,107
14753,A.J. Cockrell,2016,2016,Texas-San Antonio,CUSA,32,421,42,90,42,89,0,1,23,40,33,36,69,8,8,8,19,74,107
14754,Jason Francis,2008,2009,Rhode Island,A-10,51,486,47,77,47,77,0,0,13,27,35,50,85,10,7,1,32,86,107
14755,Samson Froling,2019,2019,Creighton,Big East,30,277,49,85,45,68,4,17,5,13,15,43,58,14,3,11,32,36,107
14756,Ishmael Hollis,2011,2012,Western Carolina,Southern,39,354,41,100,30,54,11,46,14,22,24,43,67,7,15,11,16,49,107
14757,Aaron Horne,2017,2017,North Florida,A-Sun,27,413,40,92,24,38,16,54,11,15,25,56,81,26,14,1,31,43,107
14758,Kendall Jackson,2014,2017,Columbia,Ivy,67,508,35,93,16,31,19,62,18,24,5,32,37,32,23,1,30,69,107
14759,D.J. Jones,2008,2008,Georgia State,CAA,30,787,41,125,37,97,4,28,21,41,32,59,91,84,47,3,84,65,107
14760,Mike Lewis,2009,2010,Eastern Kentucky,OVC,42,314,37,101,16,40,21,61,12,20,7,6,13,33,9,0,21,23,107
14761,Dusan Majstorovic,2016,2018,Total,Total,39,465,37,123,22,51,15,72,18,22,18,51,69,19,15,6,23,43,107
14762,Juwan Newmen,2014,2014,Central Connecticut State,NEC,28,338,38,87,38,86,0,1,31,46,37,52,89,4,10,13,31,53,107
14763,Filip Nowicki,2015,2016,Sacred Heart,NEC,40,430,49,88,49,88,0,0,9,17,40,68,108,8,3,13,36,65,107
14764,Akachi Okugo,2014,2014,Grand Canyon,WAC,29,602,29,111,15,53,14,58,35,50,9,33,42,63,13,1,39,72,107
14765,Torrey Patton,2018,2018,Akron,MAC,32,512,39,80,36,64,3,16,26,42,37,63,100,16,15,1,21,56,107
14766,Austin Phyfe,2018,2019,Northern Iowa,MVC,35,341,40,67,37,59,3,8,24,35,24,32,56,13,3,4,19,57,107
14767,Adrian Rogers,2008,2009,Louisiana Tech,WAC,55,710,45,123,45,121,0,2,17,36,50,69,119,15,16,6,53,106,107
14768,Zach Saylor,2009,2014,Central Michigan,MAC,93,681,46,125,46,124,0,1,15,34,50,69,119,13,24,30,37,94,107
14769,LaNorris Smith,2008,2008,Alabama A&M,SWAC,27,402,34,111,13,42,21,69,18,31,10,35,45,12,15,2,28,36,107
14770,Ty Solomon,2016,2016,South Carolina State,MEAC,33,693,32,103,12,32,20,71,23,28,10,60,70,121,23,3,61,73,107
14771,Kem Ubaru,2015,2015,North Carolina-Asheville,Big South,13,242,37,85,33,77,4,8,29,44,19,42,61,8,10,0,34,30,107
14772,Toby Veal,2009,2011,Total,Total,48,424,46,94,46,94,0,0,15,36,40,53,93,6,16,15,20,63,107
14773,Mike Walker,2008,2009,Western Kentucky,Sun Belt,53,689,47,87,47,85,0,2,13,44,70,90,160,19,15,13,45,89,107
14774,Brandon Webster,2008,2010,Fresno State,WAC,56,423,44,82,44,82,0,0,19,38,33,48,81,5,6,25,35,57,107
14775,Tristan Wilson,2011,2011,Long Beach State,Big West,29,406,44,110,40,90,4,20,15,32,29,44,73,16,12,1,35,37,107
14776,Deividas Zemgulis,2016,2018,Penn State,Big Ten,67,563,37,108,20,39,17,69,16,23,32,41,73,13,9,2,23,53,107
14777,Chinedu Amajoyi,2014,2015,Louisiana-Monroe,Sun Belt,44,515,31,91,15,41,16,50,28,38,12,71,83,25,10,2,26,29,106
14778,Chris Baez,2009,2009,Central Florida,CUSA,30,422,39,111,21,47,18,64,10,15,17,36,53,19,11,5,25,41,106
14779,Mike Bothwell,2019,2019,Furman,Southern,30,300,38,84,25,46,13,38,17,23,7,20,27,22,16,3,18,22,106
14780,Brendon Brooks,2019,2019,Southern,SWAC,28,398,31,95,17,41,14,54,30,34,3,12,15,35,12,0,27,36,106
14781,Josh Cottrell,2019,2019,Western Carolina,Southern,32,396,34,84,4,8,30,76,8,10,3,19,22,16,7,0,19,35,106
14782,Jimmie Covington,2008,2009,Albany (NY),AEC,59,688,33,66,33,66,0,0,40,56,56,63,119,11,10,7,41,89,106
14783,Casiem Drummond,2008,2009,Villanova,Big East,23,297,44,83,44,83,0,0,18,38,47,52,99,9,10,13,18,59,106
14784,Mark Engen,2009,2010,South Dakota State,Summit,45,306,36,94,34,81,2,13,32,48,28,42,70,4,10,21,23,63,106
14785,Maurice Foster,2010,2010,Nicholls State,Southland,13,204,44,88,43,83,1,5,17,29,17,20,37,3,6,2,22,34,106
14786,Brandon Goldsmith,2018,2018,North Carolina Central,MEAC,26,425,39,99,35,80,4,19,24,38,15,53,68,20,17,5,34,44,106
14787,DaShawn Gomez,2013,2014,Iona,MAAC,56,532,33,98,6,22,27,76,13,19,6,37,43,82,15,0,20,39,106
14788,DaJion Henderson,2019,2019,Tennessee State,OVC,29,336,45,69,45,69,0,0,16,31,46,39,85,14,7,4,41,75,106
14789,Aramani Hill,2019,2019,South Carolina State,MEAC,24,292,34,64,30,58,4,6,34,51,24,32,56,8,7,1,28,62,106
14790,Jordan Hughes,2016,2019,Western Illinois,Summit,63,396,44,72,44,72,0,0,18,26,26,68,94,0,6,11,16,49,106
14791,Rahamanh Katumbusi II,2016,2017,Alcorn State,SWAC,40,409,33,104,17,54,16,50,24,32,4,27,31,10,14,1,30,31,106
14792,Ryan Larson,2019,2019,Wofford,Southern,35,491,39,90,26,48,13,42,15,19,5,38,43,78,29,0,42,33,106
14793,Jerry Moody,2008,2008,Northwestern State,Southland,23,501,45,102,44,99,1,3,15,28,44,82,126,16,17,33,20,66,106
14794,Chudier Pal,2012,2015,North Carolina-Asheville,Big South,44,380,45,80,45,80,0,0,16,31,40,74,114,25,7,34,24,58,106
14795,Andrew Platek,2018,2019,North Carolina,ACC,67,381,41,85,26,43,15,42,9,14,19,29,48,25,9,5,15,36,106
14796,James Ringholt,2015,2018,Texas-San Antonio,CUSA,75,650,32,97,9,16,23,81,19,30,12,87,99,20,6,22,22,69,106
14797,Julian Scott,2012,2013,Southern Utah,Total,25,287,42,89,42,89,0,0,22,37,16,29,45,10,7,7,35,35,106
14798,Jahmiah Simmons,2019,2019,North Texas,CUSA,30,491,37,92,35,77,2,15,30,57,32,88,120,18,9,9,21,67,106
14799,Jevon Smith,2017,2019,Total,Total,28,272,37,91,29,64,8,27,24,33,17,31,48,22,8,2,26,39,106
14800,Dantai St. Louis,2017,2019,Canisius,MAAC,66,530,40,85,40,85,0,0,26,49,41,58,99,6,5,15,24,106,106
14801,Jonathan Tchamwa Tchatchoua,2019,2019,Nevada-Las Vegas,MWC,31,411,38,80,38,77,0,3,30,44,57,50,107,6,7,21,25,68,106
14802,Dan Vandervieren,2009,2009,Colorado State,MWC,17,260,41,79,41,79,0,0,24,37,27,40,67,8,5,10,29,40,106
14803,Martin Whitmore,2012,2013,Portland State,Big Sky,40,317,35,93,17,34,18,59,18,24,18,36,54,9,14,0,16,23,106
14804,Christian Willis,2017,2019,Arkansas State,Sun Belt,37,369,37,93,27,55,10,38,22,30,15,18,33,17,4,1,23,47,106
14805,Muhammed Ahmed,2015,2015,North Texas,CUSA,28,288,40,112,37,90,3,22,22,44,31,38,69,2,9,12,16,22,105
14806,Grant Anticevich,2018,2019,University of California,Pac-12,50,484,41,104,30,66,11,38,12,16,31,62,93,13,11,9,27,61,105
14807,Brandon Ayers,2009,2009,Arkansas State,Sun Belt,20,291,37,110,15,30,22,80,9,12,4,21,25,11,8,0,22,14,105
14808,Dalano Banton,2019,2019,Western Kentucky,CUSA,31,469,39,97,31,60,8,37,19,34,16,76,92,65,14,16,52,27,105
14809,Deon Barrett,2017,2017,Texas-El Paso,CUSA,31,420,34,93,9,30,25,63,12,14,2,21,23,29,6,0,17,22,105
14810,Dominique Cowell,2013,2013,Maryland-Eastern Shore,MEAC,28,739,37,116,27,76,10,40,21,27,10,18,28,59,32,1,49,46,105
14811,Pape Diatta,2017,2018,Georgia,SEC,48,478,33,83,21,48,12,35,27,39,13,67,80,23,9,5,31,53,105
14812,Sam Dowd,2018,2019,Idaho State,Big Sky,56,515,34,103,26,71,8,32,29,44,8,24,32,67,12,0,42,43,105
14813,Omar El-Sheikh,2018,2019,Fairfield,MAAC,33,311,39,77,35,67,4,10,23,50,18,60,78,15,12,11,36,55,105
14814,Marc Ellis,2009,2010,Texas Southern,SWAC,45,460,38,74,30,47,8,27,21,41,23,54,77,17,21,5,29,100,105
14815,Drimir Ferguson,2013,2013,North Carolina Central,MEAC,30,375,27,70,20,50,7,20,44,54,11,19,30,53,26,0,32,37,105
14816,Fred Ford,2009,2009,Missouri-Kansas City,Summit,28,608,38,118,30,79,8,39,21,28,16,36,52,51,20,3,49,60,105
14817,Andre Gilbert,2008,2008,Kansas State,Big 12,27,478,38,104,27,66,11,38,18,29,27,41,68,42,14,3,37,53,105
14818,Marcus Holt,2014,2015,Colorado State,MWC,45,457,39,68,39,65,0,3,27,60,47,50,97,0,8,22,14,69,105
14819,Demetrice Jacobs,2012,2012,Northwestern State,Southland,16,350,35,98,24,60,11,38,24,35,13,27,40,22,24,3,26,36,105
14820,Josh Jones,2014,2016,Richmond,A-10,57,454,36,94,16,31,20,63,13,22,16,29,45,23,7,5,15,54,105
14821,Josh Jones,2008,2011,Holy Cross,Patriot,64,462,40,85,37,80,3,5,22,40,22,49,71,5,7,13,24,63,105
14822,Christian Morris,2010,2010,Norfolk State,MEAC,8,229,38,78,38,78,0,0,29,48,25,25,50,0,2,5,31,24,105
14823,Rashad Moss,2008,2008,Little Rock,Sun Belt,29,373,41,85,40,83,1,2,22,45,39,50,89,14,9,9,28,66,105
14824,Rahjan Muhammad,2014,2015,Chicago State,WAC,23,350,36,95,20,43,16,52,17,22,10,31,41,13,20,1,20,22,105
14825,Demola Onifade,2016,2018,Delaware State,MEAC,86,1222,48,150,48,150,0,0,9,25,80,163,243,21,14,68,63,176,105
14826,Jarrin Randall,2017,2018,Western Michigan,MAC,56,437,37,127,21,53,16,74,15,24,0,14,14,33,13,0,32,41,105
14827,Valdas Sirutis,2008,2010,Boston University,AEC,78,928,33,107,21,55,12,52,27,51,45,89,134,30,13,9,32,144,105
14828,Tirus Smith,2018,2018,Texas-El Paso,CUSA,24,327,38,82,37,78,1,4,28,47,27,48,75,4,2,11,29,69,105
14829,Eli Stalzer,2013,2016,Colorado,Pac-12,80,584,35,92,18,36,17,56,18,30,11,45,56,27,18,3,38,49,105
14830,Darius Stokes,2012,2015,Total,Total,67,665,46,100,46,97,0,3,13,38,43,81,124,8,12,38,22,109,105
14831,Khristian Taylor,2012,2015,Tennessee-Martin,OVC,75,663,38,96,33,76,5,20,24,59,26,56,82,66,24,4,57,47,105
14832,Deandre Thomas,2019,2019,Samford,Southern,32,402,38,82,15,33,23,49,6,8,18,32,50,16,9,0,13,43,105
14833,Patrick Triplett,2015,2018,Brown,Ivy,64,475,31,114,24,65,7,49,36,53,8,50,58,19,14,10,40,70,105
14834,Torin Walker,2010,2014,Total,Total,73,377,38,89,38,89,0,0,29,39,32,32,64,4,3,10,24,62,105
14835,A.J. Youngman,2018,2018,Eastern Kentucky,OVC,28,403,36,95,6,19,30,76,3,4,4,33,37,16,10,2,13,39,105
14836,Aguir Agau,2019,2019,Fresno State,MWC,32,316,39,90,28,57,11,33,15,25,23,45,68,14,12,5,18,53,104
14837,Justin Archie,2009,2009,New Orleans,Sun Belt,29,455,38,95,25,47,13,48,15,27,7,45,52,42,18,3,36,45,104
14838,Frankie Bougher,2011,2012,Jacksonville State,OVC,34,311,35,96,13,31,22,65,12,17,14,23,37,14,6,2,23,26,104
14839,Hikeem Champaigne,2014,2015,Savannah State,MEAC,37,384,47,96,47,96,0,0,10,24,43,43,86,7,9,20,34,57,104
14840,Bryce Clark,2010,2014,Total,Total,50,356,39,114,36,81,3,33,23,37,27,55,82,11,10,4,26,40,104
14841,Deion Clark,2013,2015,Old Dominion,Total,38,438,39,98,29,60,10,38,16,24,18,20,38,21,12,2,23,42,104
14842,Evan Clayborne,2017,2018,Cleveland State,Horizon,48,497,47,87,47,87,0,0,10,31,46,50,96,11,12,25,29,79,104
14843,Raymond Davis,2009,2010,Winthrop,Big South,35,397,40,114,24,49,16,65,8,18,26,37,63,27,15,4,34,26,104
14844,Mike Dejworek,2008,2011,Total,Total,63,422,38,76,38,73,0,3,28,49,28,64,92,13,5,15,24,60,104
14845,Lucas Dyer,2013,2015,Radford,Big South,60,480,31,75,31,75,0,0,42,62,33,63,96,7,14,19,23,80,104
14846,Christian Ejiga,2014,2015,Maine,AEC,43,443,39,91,39,90,0,1,26,39,35,68,103,8,15,16,29,93,104
14847,Davis Francis,2018,2019,Bethune-Cookman,MEAC,47,407,40,104,33,83,7,21,17,41,45,49,94,25,14,9,23,53,104
14848,Brian Gilbert,2008,2010,Jacksonville,A-Sun,58,434,40,112,22,37,18,75,6,9,16,47,63,17,14,7,25,58,104
14849,Colin Hale,2017,2018,Texas A&M-Corpus Christi,Southland,59,620,41,107,29,61,12,46,10,18,11,48,59,38,18,2,45,55,104
14850,Quincy Hankins-Cole,2010,2010,Nebraska,Big 12,26,250,35,78,35,78,0,0,34,78,30,33,63,11,7,4,21,53,104
14851,Chris Harris,2018,2019,Houston,AAC,48,454,47,66,47,66,0,0,10,46,52,77,129,3,8,38,19,70,104
14852,Fred Heldring,2011,2014,William & Mary,CAA,91,859,36,96,33,76,3,20,29,43,29,102,131,43,12,23,50,111,104
14853,Josh Ivory,2013,2016,Total,Total,85,777,34,125,4,26,30,99,6,16,5,51,56,61,18,2,48,76,104
14854,Khari Jabriel Allen,2018,2019,Alcorn State,SWAC,17,400,30,115,9,41,21,74,23,27,7,17,24,16,6,3,32,36,104
14855,Jerred Kite,2015,2017,Incarnate Word,Southland,69,586,36,75,28,59,8,16,24,39,36,51,87,21,22,20,19,76,104
14856,Rodney Milium,2012,2012,Appalachian State,Southern,11,235,32,86,6,17,26,69,14,22,2,18,20,12,4,1,11,25,104
14857,Jordan Nelson,2012,2013,Evansville,MVC,54,382,36,99,11,24,25,75,7,9,4,19,23,15,5,1,9,24,104
14858,Jordan Percell,2012,2014,Morehead State,OVC,68,640,37,85,35,77,2,8,28,51,37,28,65,12,16,2,23,76,104
14859,Jabari Rice,2019,2019,New Mexico State,WAC,31,338,31,95,23,44,8,51,34,52,24,44,68,24,16,5,15,45,104
14860,Brian Richards,2008,2009,Navy,Patriot,43,547,38,79,38,79,0,0,28,49,55,45,100,11,16,1,34,70,104
14861,Brad Schaub,2015,2015,Massachusetts-Lowell,AEC,22,539,39,94,23,61,16,33,10,22,12,53,65,16,16,5,35,55,104
14862,Jon Sizemore,2008,2010,Army,Patriot,61,539,47,106,46,102,1,4,9,15,19,45,64,41,14,2,41,37,104
14863,T.K. Smith,2011,2011,Central Arkansas,Southland,29,342,35,111,11,25,24,86,10,11,5,19,24,16,2,1,19,21,104
14864,Aaron Thompson,2010,2012,Sam Houston State,Southland,48,415,41,106,34,75,7,31,15,21,30,62,92,14,9,17,27,58,104
14865,Quintin Thornton,2008,2009,Louisiana State,SEC,50,675,40,75,40,75,0,0,24,49,46,80,126,26,17,15,28,104,104
14866,Nick Walls,2010,2010,Southern,SWAC,29,624,35,111,34,97,1,14,33,55,13,56,69,111,19,0,80,39,104
14867,Max Zhang,2009,2010,University of California,Pac-10,42,353,38,59,38,59,0,0,28,56,33,40,73,5,5,50,17,67,104
14868,Emir Ahmedic,2018,2019,Oral Roberts,Summit,42,336,40,75,40,75,0,0,23,37,27,55,82,8,6,4,30,58,103
14869,Tyreese Breshers,2010,2010,Washington,Pac-10,34,335,35,81,35,81,0,0,33,63,31,57,88,1,5,26,20,89,103
14870,Cade Crosland,2018,2019,Tennessee Tech,OVC,51,386,36,91,8,14,28,77,3,7,19,27,46,29,11,2,19,33,103
14871,Leslie Jackson,2009,2010,Texas-San Antonio,Southland,50,566,43,109,37,84,6,25,11,18,45,103,148,23,18,2,18,60,103
14872,Dylan Johns,2014,2017,Total,Total,68,663,46,79,46,79,0,0,11,24,38,54,92,16,9,39,43,102,103
14873,Alston Jones,2018,2018,North Carolina Central,MEAC,23,316,38,84,32,76,6,8,21,25,4,21,25,45,3,1,41,39,103
14874,Bernard Kamwa,2011,2012,Missouri-Kansas City,Summit,31,514,38,84,38,84,0,0,27,64,49,55,104,5,10,6,50,90,103
14875,Anthony Kelley,2010,2013,Illinois-Chicago,Horizon,60,519,36,103,21,51,15,52,16,22,26,73,99,26,12,7,38,39,103
14876,Aleksa Koracin,2019,2019,Mississippi Valley State,SWAC,24,377,41,96,41,96,0,0,21,31,33,62,95,13,3,5,21,42,103
14877,Mustafa Lawrence,2018,2018,Missouri State,MVC,22,273,33,88,9,26,24,62,13,17,5,19,24,20,13,0,13,31,103
14878,Dominic Moore,2010,2011,Arkansas-Pine Bluff,SWAC,43,498,31,94,18,56,13,38,28,46,22,58,80,22,15,11,45,57,103
14879,Zach Nelson,2011,2011,Sacramento State,Big Sky,16,354,30,91,27,80,3,11,40,55,32,44,76,14,12,5,27,35,103
14880,Yemi Ogunoye,2008,2008,Oral Roberts,Summit,33,872,33,80,25,55,8,25,29,47,47,64,111,55,22,24,33,52,103
14881,P.J. Owsley,2008,2008,Hawaii,WAC,27,454,45,103,45,103,0,0,13,23,29,44,73,20,11,17,19,58,103
14882,Richard Polanco,2018,2018,Eastern Washington,Big Sky,27,227,38,83,29,53,9,30,18,25,9,34,43,10,5,5,29,60,103
14883,Frank Ryder,2017,2017,San Diego,WCC,25,339,38,80,38,80,0,0,27,37,19,23,42,15,4,4,17,59,103
14884,Caden Sanchez,2019,2019,High Point,Big South,31,360,44,86,42,81,2,5,13,32,36,42,78,7,4,17,27,29,103
14885,Shaun Smith,2011,2014,Total,Total,44,418,31,118,20,67,11,51,30,38,10,31,41,15,7,0,32,17,103
14886,Derek St. Hilaire,2019,2019,Jacksonville State,OVC,31,351,36,101,26,58,10,43,21,30,8,35,43,28,4,0,26,21,103
14887,Ronnie Stacy,2017,2018,Oregon State,Pac-12,51,575,39,106,35,90,4,16,21,45,15,58,73,39,17,2,56,80,103
14888,Tucker Thompson,2015,2017,Total,Total,37,478,39,82,39,81,0,1,25,38,39,54,93,17,14,13,20,49,103
14889,Sean Thurston,2010,2011,Jacksonville State,OVC,56,991,44,104,43,102,1,2,14,31,79,92,171,26,27,75,63,141,103
14890,Sekou Toure,2019,2019,UC-Santa Barbara,Big West,32,256,37,70,33,57,4,13,25,44,32,46,78,18,8,4,16,31,103
14891,Luke Vargo,2017,2018,High Point,Big South,60,574,36,96,16,37,20,59,11,22,15,60,75,13,7,10,20,56,103
14892,Berend Weijs,2011,2012,Maryland,ACC,55,474,47,88,47,87,0,1,9,26,38,43,81,12,8,42,21,67,103
14893,Peyton Woods,2016,2017,Chattanooga,Southern,31,261,31,84,4,7,27,77,14,16,11,13,24,7,8,0,7,32,103
14894,Theo Akwuba,2019,2019,Portland,WCC,30,511,41,84,41,84,0,0,20,46,35,86,121,7,8,46,23,72,102
14895,Aaron Ariri,2015,2017,Troy,Sun Belt,68,553,39,91,39,89,0,2,24,54,66,89,155,5,8,14,28,74,102
14896,Reynaul Baker,2011,2011,Cal State Bakersfield,Ind,24,479,39,95,38,91,1,4,23,36,19,17,36,41,21,4,23,27,102
14897,Kalvin Bay,2009,2009,Idaho State,Big Sky,16,335,32,101,10,28,22,73,16,20,1,15,16,23,6,1,28,38,102
14898,Frank Bertz,2019,2019,Central Florida,AAC,33,380,34,97,7,22,27,75,7,9,16,29,45,15,20,2,13,31,102
14899,Matt Borton,2012,2013,Idaho,WAC,47,476,35,97,14,31,21,66,11,22,15,64,79,35,8,5,25,64,102
14900,Willie Carmichael,2015,2017,Total,Total,36,498,42,84,41,79,1,5,17,26,45,33,78,11,6,13,32,102,102
14901,Tyrone Cole-Scott,2008,2008,Bradley,MVC,27,354,40,127,26,69,14,58,8,15,6,20,26,22,6,0,29,38,102
14902,E.J. Datcher,2017,2019,Mississippi State,SEC,67,481,39,77,38,75,1,2,23,35,30,74,104,5,10,26,23,110,102
14903,Elhadji Dieng,2018,2019,Florida International,CUSA,56,559,36,73,36,73,0,0,30,76,56,72,128,5,10,21,35,108,102
14904,Cameron Diggs,2019,2019,North Alabama,A-Sun,26,368,44,70,44,69,0,1,14,23,17,53,70,4,4,9,25,51,102
14905,Austin Donaldson,2016,2017,Georgia State,Sun Belt,45,431,40,101,35,83,5,18,17,39,15,39,54,56,33,1,43,57,102
14906,John Edwards,2014,2015,New Hampshire,AEC,27,383,28,82,26,64,2,18,44,61,14,36,50,20,8,4,34,40,102
14907,Malcolm Gilbert,2012,2015,Total,Total,72,636,44,103,44,103,0,0,14,30,46,92,138,13,8,75,28,124,102
14908,Harry Giles,2017,2017,Duke,ACC,26,300,45,78,45,78,0,0,12,24,41,59,100,9,9,17,18,58,102
14909,James Harrison,2018,2019,East Tennessee State,Southern,35,262,41,78,41,78,0,0,20,31,21,41,62,8,3,7,31,44,102
14910,Justin Howerton,2008,2009,North Texas,Sun Belt,54,441,40,72,40,72,0,0,22,45,43,79,122,12,16,7,35,68,102
14911,Shawn Jackson,2011,2011,Murray State,OVC,26,243,39,72,39,72,0,0,24,37,20,8,28,3,1,6,21,41,102
14912,Jake Lindfors,2010,2011,Albany (NY),AEC,44,439,39,118,29,70,10,48,14,22,26,71,97,7,9,19,30,53,102
14913,Nick Mason,2011,2013,Idaho State,Big Sky,69,597,36,127,14,35,22,92,8,9,7,37,44,17,12,3,17,32,102
14914,Rod Melton Jr,2019,2019,Florida A&M,MEAC,13,256,35,76,17,43,18,33,14,22,9,20,29,14,11,1,23,18,102
14915,Chris Miller-Williams,2008,2008,South Carolina State,MEAC,27,276,39,92,39,91,0,1,24,50,26,42,68,11,11,9,32,45,102
14916,Garrett Moles,2008,2008,North Carolina-Asheville,Big South,33,544,38,87,37,85,1,2,25,42,35,61,96,39,10,11,38,95,102
14917,Christopher Morgan,2013,2015,Holy Cross,Patriot,57,454,43,68,43,68,0,0,16,24,25,42,67,2,6,6,21,75,102
14918,Bryson Mozone,2019,2019,South Carolina Upstate,Big South,20,311,35,93,9,23,26,70,6,9,10,48,58,12,9,6,20,44,102
14919,Joshua Nurse,2016,2018,St. Francis (NY),NEC,74,635,36,87,36,87,0,0,30,72,54,76,130,29,15,34,56,149,102
14920,Ralueke Orizu,2018,2018,Savannah State,MEAC,26,301,38,70,38,69,0,1,26,46,29,52,81,4,8,18,22,40,102
14921,Andy Pack,2019,2019,Elon,CAA,29,353,34,89,14,32,20,57,14,25,14,40,54,22,10,1,34,23,102
14922,Andrija Ristanovic,2019,2019,Iona,MAAC,29,438,33,90,10,23,23,67,13,16,16,75,91,13,6,18,20,45,102
14923,Peter Simek,2010,2011,UC-Irvine,Big West,51,434,43,103,43,100,0,3,16,32,43,54,97,5,5,12,22,54,102
14924,David Theis,2008,2011,Duquesne,A-10,54,445,34,99,23,55,11,44,23,36,28,42,70,13,14,13,36,73,102
14925,Alex White,2008,2009,Drake,MVC,41,457,42,74,42,74,0,0,18,37,45,84,129,9,19,9,30,74,102
14926,Aris Williams,2008,2009,South Florida,Big East,49,559,44,91,44,91,0,0,14,44,42,82,124,5,10,14,23,74,102
14927,Collin Woods,2012,2012,UC-Irvine,Big West,31,435,34,124,15,42,19,82,15,27,8,27,35,27,11,11,21,42,102
14928,Ronnie Aguilar,2008,2008,Colorado State,MWC,26,441,38,87,38,87,0,0,25,41,43,116,159,5,7,27,34,75,101
14929,D'Arian Allen,2016,2016,Southern,SWAC,28,307,42,71,41,70,1,1,16,35,33,42,75,4,6,9,24,67,101
14930,Jonathan Barnes,2015,2017,Wyoming,MWC,58,444,34,67,34,67,0,0,33,62,25,55,80,7,6,12,20,56,101
14931,Rocco Belcaster,2013,2016,Ball State,MAC,34,529,33,111,8,20,25,91,10,19,24,39,63,30,11,4,34,56,101
14932,Chass Bryan,2013,2015,Southern California,Pac-12,74,666,34,105,27,80,7,25,26,49,9,43,52,79,28,4,48,102,101
14933,Charles Burley,2014,2015,Delaware State,MEAC,63,1014,23,82,17,59,6,23,49,73,32,89,121,157,37,0,108,105,101
14934,Brian Coffey II,2018,2019,North Florida,A-Sun,55,502,36,99,21,54,15,45,14,18,10,19,29,50,14,0,55,47,101
14935,Bryce Daley,2019,2019,Massachusetts-Lowell,AEC,30,563,32,115,29,86,3,29,34,46,14,84,98,79,18,4,44,38,101
14936,Trey Eckloff,2009,2012,Colorado,Total,68,450,39,103,29,64,10,39,13,24,24,56,80,19,8,8,36,79,101
14937,Antonin Galaya,2013,2014,North Carolina Central,MEAC,44,284,33,111,7,18,26,93,9,12,8,41,49,12,10,3,15,22,101
14938,Ryne Hamblet,2008,2008,Bowling Green State,MAC,8,252,35,94,27,57,8,37,23,25,1,30,31,43,8,9,23,19,101
14939,Barnett Harris,2014,2017,Delaware,CAA,113,871,27,68,27,68,0,0,47,79,88,131,219,40,28,37,42,202,101
14940,Eli Harrison,2014,2016,Dartmouth,Ivy,28,202,34,83,6,20,28,63,5,9,8,16,24,5,7,0,10,23,101
14941,Tyren Harrison,2018,2019,New Orleans,Southland,47,386,37,62,33,51,4,11,23,35,24,45,69,27,11,10,29,33,101
14942,Teven Jones,2013,2014,Virginia,ACC,59,531,31,96,20,59,11,37,28,43,3,23,26,42,18,2,28,61,101
14943,Colin Klebon,2010,2013,Bucknell,Patriot,58,327,38,89,37,87,1,2,24,37,15,55,70,11,6,2,20,51,101
14944,Alex Majewski,2014,2014,Texas-Rio Grande Valley,WAC,32,328,32,86,10,23,22,63,15,22,17,23,40,8,5,2,18,33,101
14945,Michael Moynihan,2008,2008,Georgia State,CAA,17,214,30,71,18,39,12,32,29,36,5,12,17,25,12,0,30,30,101
14946,Chene Phillips,2011,2012,Liberty,Big South,58,606,28,106,24,83,4,23,41,55,14,66,80,56,26,0,56,88,101
14947,Justin Roberts,2017,2018,Toledo,MAC,62,554,31,77,8,22,23,55,16,22,3,34,37,59,10,0,21,69,101
14948,John Schurman,2016,2018,Binghamton,AEC,48,337,36,114,8,21,28,93,1,7,14,40,54,8,6,2,7,22,101
14949,Marlon Sierra,2019,2019,Bowling Green State,MAC,33,382,37,83,28,54,9,29,18,23,28,56,84,19,13,5,16,38,101
14950,Bryant Smith,2011,2011,Texas-Arlington,Southland,29,448,29,78,23,54,6,24,37,62,5,35,40,48,24,2,38,44,101
14951,Josh Stamps,2018,2018,Florida International,CUSA,12,235,35,93,18,40,17,53,14,21,6,16,22,8,7,1,11,20,101
14952,Gilbert Talbot,2013,2014,Louisiana Tech,Total,44,246,42,78,42,78,0,0,17,37,36,43,79,4,1,6,18,62,101
14953,Racine Talla,2016,2017,Purdue-Fort Wayne,Summit,56,565,33,115,25,81,8,34,27,45,41,62,103,17,10,28,44,81,101
14954,De'Aires Tate,2013,2013,Sacred Heart,NEC,27,325,45,85,45,85,0,0,11,18,24,53,77,5,11,17,27,38,101
14955,Mike Taylor,2009,2010,Marist,MAAC,53,504,34,102,13,45,21,57,12,15,23,51,74,17,14,2,23,55,101
14956,Jeff Wherry,2011,2011,Prairie View,SWAC,31,439,34,111,13,31,21,80,12,24,8,51,59,42,18,1,34,45,101
14957,Chris Williams,2017,2019,Central Connecticut State,NEC,46,336,38,105,26,58,12,47,13,15,9,18,27,7,8,1,16,22,101
14958,D'Erryl Williams,2014,2017,San Diego State,MWC,85,717,38,91,32,75,6,16,19,36,18,70,88,52,30,2,39,72,101
14959,Kwesi Abakah,2014,2017,Total,Total,109,824,35,83,35,83,0,0,30,70,57,82,139,28,8,18,33,120,100
14960,LaCurtis Allen,2018,2019,Mississippi Valley State,SWAC,50,588,38,75,37,74,1,1,23,44,36,38,74,16,19,2,25,82,100
14961,Luis Augusto,2008,2009,Idaho,WAC,49,200,36,100,36,100,0,0,28,70,18,19,103,6,18,2,60,26,100
14962,Andre Ball,2019,2019,Pepperdine,WCC,30,394,38,87,24,45,14,42,10,23,14,36,50,8,3,8,14,34,100
14963,Jimmy Barton,2014,2016,Total,Total,43,562,36,108,20,50,16,58,12,18,12,27,39,61,17,0,48,52,100
14964,Stetson Billings,2013,2014,Little Rock,Sun Belt,63,513,31,106,29,95,2,11,36,50,34,67,101,16,10,6,29,44,100
14965,Stefan Borovac,2017,2018,Massachusetts-Lowell,AEC,44,419,35,83,31,62,4,21,26,52,21,64,85,26,11,5,42,72,100
14966,Tyron Brewer,2019,2019,Southeastern Louisiana,Southland,26,369,38,77,36,71,2,6,22,44,27,46,73,2,10,13,17,34,100
14967,Jordan Brown,2019,2019,Nevada,MWC,33,332,40,79,40,78,0,1,20,32,16,54,70,15,10,16,24,35,100
14968,Josh Chojnacki,2011,2014,Youngstown State,Horizon,103,696,37,85,34,68,3,17,23,34,35,46,81,20,11,18,33,117,100
14969,Teraes Clemmons,2014,2014,Jacksonville State,OVC,24,313,36,82,30,63,6,19,22,26,18,32,50,18,9,2,17,50,100
14970,Jordan Cook,2008,2008,Maine,AEC,28,413,45,94,45,94,0,0,10,14,21,58,79,10,9,13,19,43,100
14971,Ibrahima Diallo,2016,2019,Total,Total,57,514,42,104,42,104,0,0,16,38,42,66,108,10,13,19,33,95,100
14972,Grant Dressler,2016,2017,Sacramento State,Big Sky,35,301,32,98,16,45,16,53,20,25,8,41,49,21,9,1,18,13,100
14973,Jordan Gaither,2013,2014,Tennessee State,OVC,43,492,34,105,18,39,16,66,16,31,13,30,43,25,11,1,28,49,100
14974,Devin Gilmore,2018,2019,Murray State,OVC,38,273,44,69,44,66,0,3,12,20,26,57,83,9,9,14,4,21,100
14975,Gavin Gilmore,2011,2012,Seattle,Ind,44,640,39,105,39,104,0,1,22,37,46,55,101,18,13,10,51,110,100
14976,Tyler Hall,2010,2012,North Texas,Sun Belt,34,379,33,88,12,29,21,59,13,17,7,44,51,26,13,2,32,33,100
14977,Brachen Hazen,2017,2019,Total,Total,31,349,35,65,27,45,8,20,22,39,19,62,81,9,5,6,24,40,100
14978,Gavin Horne,2008,2009,Wright State,Horizon,42,499,33,83,19,49,14,34,20,35,26,35,61,11,14,5,22,77,100
14979,Jacob Larsen,2018,2018,Gonzaga,WCC,34,284,36,55,36,55,0,0,28,42,31,60,91,17,4,15,26,37,100
14980,Kwei Lartey,2018,2018,North Carolina A&T,MEAC,31,429,37,104,20,43,17,61,9,17,9,37,46,40,12,4,33,42,100
14981,Gage Loy,2017,2017,Texas-Rio Grande Valley,WAC,32,414,35,104,26,72,9,32,21,32,33,60,93,26,15,6,27,57,100
14982,Ifeanyi Onyekaba,2014,2015,Rhode Island,A-10,38,420,33,67,33,67,0,0,34,63,49,59,108,2,8,17,27,99,100
14983,Jeremy Peck,2017,2019,Total,Total,49,560,40,77,38,70,2,7,18,28,37,82,119,15,6,12,36,72,100
14984,Darius Redding,2010,2011,Louisiana Tech,WAC,33,427,38,83,33,69,5,14,19,37,21,43,64,22,20,5,27,28,100
14985,J.D. Slajchert,2017,2018,UC-Santa Barbara,Big West,29,367,41,102,40,99,1,3,17,24,37,56,93,8,4,0,22,31,100
14986,Roderick Taylor,2016,2019,Total,Total,82,666,44,93,44,93,0,0,12,27,39,73,112,6,14,19,36,129,100
14987,Greg Travis,2012,2012,Illinois-Chicago,Horizon,25,432,36,96,31,81,5,15,23,47,10,29,39,53,19,0,44,42,100
14988,Tydus Verhoeven,2018,2018,Duquesne,A-10,32,625,40,77,40,77,0,0,20,37,44,62,106,28,7,71,24,94,100
14989,Wayne Whiting,2009,2012,Virginia Military Institute,Big South,66,389,38,87,37,86,1,1,23,35,36,41,77,14,8,16,15,74,100
14990,Erik Adams,2008,2008,Jacksonville State,OVC,19,244,39,88,29,66,10,22,11,20,21,32,53,5,7,7,17,30,99
14991,Valerio Altheimer,2014,2016,Grambling,SWAC,66,445,39,92,37,75,2,17,19,40,33,55,88,14,15,4,21,47,99
14992,Wayne Arnold,2019,2019,Cal State Fullerton,Big West,33,401,39,115,22,43,17,72,4,6,4,48,52,18,9,1,9,23,99
14993,Drew Bender,2014,2015,Total,Total,35,326,35,95,19,36,16,59,13,20,4,38,42,22,12,3,25,40,99
14994,Stetson Billings,2016,2017,Little Rock,Sun Belt,48,582,34,101,21,65,13,36,18,23,19,56,75,35,17,10,22,74,99
14995,Phil Bledsoe,2017,2018,Marshall,CUSA,35,254,35,83,25,53,10,30,19,27,24,40,64,5,4,1,8,33,99
14996,Malik Brevard,2019,2019,Arkansas State,Sun Belt,30,498,42,81,41,74,1,7,14,28,49,82,131,17,19,19,32,70,99
14997,Antwuan Butler,2019,2019,Austin Peay,OVC,27,460,32,94,22,61,10,33,25,39,14,40,54,71,11,2,32,66,99
14998,Rashid Cann,2008,2008,Norfolk State,MEAC,31,682,36,115,28,89,8,26,19,30,13,40,53,54,31,1,40,76,99
14999,Marko Cukic,2010,2011,Nevada,WAC,52,368,37,60,37,59,0,1,25,36,27,40,67,7,7,13,16,86,99
15000,Aboubacar Diallo,2016,2019,Eastern Illinois,OVC,98,915,39,94,39,94,0,0,21,40,91,141,232,31,28,101,33,129,99
15001,Terrence Durham,2015,2016,Tennessee-Martin,OVC,60,699,31,93,20,48,11,45,26,45,12,63,75,82,25,1,48,75,99
15002,Parker Edwards,2019,2019,Southeastern Louisiana,Southland,26,164,30,74,6,10,24,64,15,20,1,10,11,7,6,2,6,17,99
15003,C.J. Ford,2013,2014,Murray State,OVC,59,512,34,95,31,74,3,21,28,47,7,49,56,48,17,2,32,61,99
15004,Harry Froling,2017,2018,Total,Total,30,394,43,93,36,64,7,29,6,15,31,61,92,26,7,6,30,47,99
15005,Victor Gomez,2008,2008,Evansville,MVC,21,292,39,87,32,64,7,23,14,26,21,54,75,5,8,8,32,61,99
15006,Malek Harwell,2017,2019,Boise State,MWC,57,389,22,81,11,34,11,47,44,57,7,30,37,20,10,2,21,59,99
15007,Donovan Johnson,2013,2013,Cal State Northridge,Big West,29,388,31,108,20,58,11,50,26,36,9,14,23,17,20,2,26,42,99
15008,Travis Julien,2013,2015,Nicholls State,Southland,49,485,41,95,41,83,0,12,17,50,36,49,85,18,14,23,36,94,99
15009,Brendan Keane,2012,2014,Northern Colorado,Big Sky,57,461,38,106,37,102,1,4,22,39,23,31,54,8,4,10,25,74,99
15010,Eric Kenzik,2008,2008,Air Force,MWC,30,347,36,81,28,57,8,24,19,26,8,47,55,24,8,3,23,46,99
15011,Elijah Landrum,2018,2018,Southern Methodist,AAC,32,561,35,122,16,45,19,77,10,16,11,40,51,34,25,3,17,43,99
15012,Kijana Love,2017,2019,New Hampshire,AEC,39,327,36,100,21,55,15,45,12,20,4,21,25,11,10,1,24,36,99
15013,Dijon Manns,2011,2011,North Carolina Central,Ind,29,405,42,80,42,80,0,0,15,26,36,41,77,7,6,18,42,84,99
15014,Xander McNally,2008,2008,Denver,Sun Belt,30,768,43,91,35,64,8,27,5,11,28,62,90,64,66,28,65,86,99
15015,Kevin Menner,2010,2010,Cal State Northridge,Big West,24,255,37,92,37,90,0,2,25,47,16,29,45,6,5,3,23,17,99
15016,Gaston Moliva,2008,2008,Richmond,A-10,24,424,43,76,40,70,3,6,10,25,23,59,82,13,10,30,24,46,99
15017,Nathaniel Musters,2013,2016,Lafayette,Patriot,115,930,46,86,46,86,0,0,7,21,44,128,172,27,24,30,43,121,99
15018,Jabari Narcis,2019,2019,Texas-Arlington,Sun Belt,32,423,39,87,28,47,11,40,10,18,31,68,99,8,6,34,20,47,99
15019,Albert Odero,2018,2019,Binghamton,AEC,23,251,36,91,30,66,6,25,21,34,23,14,37,10,7,6,19,35,99
15020,Chidozie Omile,2015,2016,Alabama State,SWAC,41,415,38,122,27,70,11,52,12,24,15,41,56,19,11,6,27,44,99
15021,Shannon Sharpe,2011,2012,Colorado,Total,54,601,34,84,32,66,2,18,29,53,20,44,64,54,12,12,37,44,99
15022,Brian Steele,2013,2015,South Carolina,SEC,50,476,34,110,11,31,23,79,8,12,13,38,51,27,15,1,18,62,99
15023,Mario Stramaglia,2013,2013,East Tennessee State,A-Sun,27,337,26,95,12,39,14,56,33,48,9,31,40,19,9,1,29,29,99
15024,LeAndre Thomas,2018,2019,Maryland-Eastern Shore,MEAC,33,454,39,102,39,102,0,0,21,41,43,58,101,3,7,15,28,99,99
15025,Deirunas Visockas,2008,2012,Total,Total,38,335,33,80,16,30,17,50,16,20,7,25,32,19,7,0,24,37,99
15026,Ben Vozzola,2012,2014,Total,Total,36,326,36,99,17,46,19,53,8,8,4,31,35,33,9,0,31,32,99
15027,Amaad Wainright,2018,2018,Kansas State,Big 12,36,470,38,85,26,46,12,39,11,26,26,57,83,18,21,4,17,51,99
15028,Bailey Walker,2016,2018,Northwestern State,Southland,59,624,32,92,13,47,19,45,16,24,12,25,37,54,22,1,67,68,99
15029,J.R. Weathers,2008,2008,Jacksonville State,OVC,26,291,42,87,42,87,0,0,15,38,30,36,66,6,6,17,21,56,99
15030,T.J. Williams,2011,2011,Texas-San Antonio,Southland,25,303,38,90,38,90,0,0,23,36,27,40,67,8,8,11,22,61,99
15031,Desmond Adedeji,2009,2010,Stony Brook,AEC,22,213,39,79,39,79,0,0,20,48,17,39,56,5,6,17,21,31,98
15032,Dorian Albritton,2013,2013,Virginia Military Institute,Big South,25,277,35,113,10,21,25,92,3,8,12,24,36,14,5,0,17,28,98
15033,Josh Aldrich,2019,2019,South Carolina Upstate,Big South,31,610,34,94,22,47,12,47,18,36,30,60,90,15,21,20,24,72,98
15034,Sukhjot Bains,2018,2018,Green Bay,Horizon,33,517,38,88,31,59,7,29,15,33,31,59,90,38,17,9,22,55,98
15035,Alex Bazzell,2010,2010,Missouri-Kansas City,Summit,29,583,32,77,20,34,12,43,22,27,7,35,42,49,10,1,21,37,98
15036,Alonzo Brandon,2010,2011,Portland State,Big Sky,43,377,35,116,10,23,25,93,3,6,13,35,48,7,7,3,11,27,98
15037,Elijah Burns,2017,2019,Notre Dame,ACC,44,397,28,68,26,62,2,6,40,49,32,59,91,9,8,5,18,25,98
15038,Mikel Byers,2019,2019,Marshall,CUSA,32,313,38,74,28,43,10,31,12,20,16,38,54,13,13,12,27,53,98
15039,Trahern Chaplin,2008,2008,North Carolina A&T,MEAC,31,536,43,94,39,61,4,33,8,22,27,82,109,21,14,6,32,74,98
15040,James Claar,2016,2019,Western Illinois,Summit,54,424,40,66,40,66,0,0,18,27,34,48,82,7,6,21,15,56,98
15041,Mamadou Doucoure,2018,2019,Rutgers,Big Ten,40,476,39,113,39,113,0,0,20,33,46,73,119,4,10,13,25,86,98
15042,Taylor Dunn,2010,2014,Total,Total,81,462,30,95,3,12,27,83,11,21,8,40,48,14,7,1,10,31,98
15043,Ari Feldman,2012,2012,Cal State Northridge,Big West,25,351,37,83,27,62,10,21,14,18,20,27,47,10,10,7,11,51,98
15044,Ronnie Gombe,2017,2018,Total,Total,28,364,45,91,45,91,0,0,8,25,45,53,98,0,17,22,27,57,98
15045,Octavious Green,2014,2014,Lamar,Southland,25,325,35,82,16,28,19,54,9,20,22,49,71,10,7,5,18,39,98
15046,Matt Grogan,2010,2013,Hofstra,CAA,80,523,31,106,9,31,22,75,14,18,20,29,49,11,10,6,24,59,98
15047,Xavier Hallinan,2016,2019,Portland,WCC,31,305,34,84,22,56,12,28,18,26,2,22,24,23,19,0,30,26,98
15048,Jamal Hartwell II,2019,2019,George Mason,A-10,31,344,34,96,9,40,25,56,5,8,2,12,14,23,3,0,16,35,98
15049,Hayden Hoerdemann,2012,2014,Western Michigan,MAC,44,311,30,91,9,30,21,61,17,24,7,25,32,22,7,0,13,22,98
15050,Kevin Hovde,2008,2011,Richmond,A-10,69,465,39,70,28,43,11,27,9,15,32,40,72,23,20,4,20,50,98
15051,Andre Jackson,2019,2019,North Carolina A&T,MEAC,32,299,33,89,17,37,16,52,16,25,2,35,37,14,3,1,24,23,98
15052,Allen Jiles,2011,2014,Total,Total,64,486,39,80,39,78,0,2,20,44,29,45,74,21,15,5,39,54,98
15053,Given Kalipinde,2010,2010,Loyola Marymount,WCC,24,303,34,85,20,43,14,42,16,33,16,27,43,22,13,1,16,30,98
15054,Kolton Kohl,2018,2019,Abilene Christian,Southland,56,247,33,75,33,75,0,0,32,53,31,43,74,8,5,23,19,42,98
15055,John Majors II,2016,2016,Presbyterian,Big South,23,297,40,78,40,78,0,0,18,39,24,49,73,4,5,1,25,42,98
15056,Hunter McClinton,2011,2011,Oral Roberts,Summit,29,506,32,85,11,25,21,60,13,20,6,16,22,39,7,0,38,41,98
15057,Jaquan McKennon,2017,2017,Maine,AEC,24,309,38,97,35,76,3,21,19,32,10,23,33,58,7,2,36,33,98
15058,Alex Moosmann,2008,2008,Miami (OH),MAC,33,714,32,104,8,29,24,75,10,16,3,25,28,33,14,1,25,52,98
15059,Jabs Newby,2011,2012,Eastern Kentucky,OVC,52,615,37,115,33,92,4,23,20,35,28,40,68,74,21,5,41,72,98
15060,Thierno Niang,2013,2014,Milwaukee,Horizon,34,494,36,101,24,60,12,41,14,24,8,64,72,31,22,1,45,64,98
15061,John Ntoko,2008,2010,Hampton,MEAC,73,617,36,89,25,50,11,39,15,27,42,62,104,18,16,6,30,84,98
15062,Nelson Nweke,2017,2019,Total,Total,47,442,40,87,40,87,0,0,18,29,39,57,96,8,6,11,22,65,98
15063,Emanuel Pellot,2015,2015,Florida A&M,MEAC,29,752,40,121,40,120,0,1,18,32,27,77,104,29,6,22,40,52,98
15064,Jock Perry,2018,2019,Saint Mary's (CA),WCC,47,206,36,76,23,44,13,32,13,18,9,28,37,5,1,3,15,19,98
15065,Austin Rogers,2017,2019,Alabama State,SWAC,51,589,38,110,30,74,8,36,14,28,28,48,76,33,17,6,29,64,98
15066,Terrell Rogers,2013,2013,Delaware,CAA,27,399,31,116,20,70,11,46,25,30,7,27,34,32,9,0,31,42,98
15067,Nikola Scekic,2016,2019,Total,Total,53,619,43,112,39,98,4,14,8,19,34,59,93,6,1,18,30,91,98
15068,Will Scott,2008,2009,Louisville,Big East,48,303,31,91,10,21,21,70,15,18,8,18,26,14,10,1,8,45,98
15069,KJ Simon,2019,2019,Troy,Sun Belt,29,361,39,74,34,54,5,20,15,31,11,25,36,36,19,13,33,44,98
15070,Cole Walton,2014,2017,Sacred Heart,NEC,71,677,38,93,38,92,0,1,22,43,51,77,128,22,15,17,32,114,98
15071,Alex Watson,2018,2019,Sacred Heart,NEC,30,407,35,91,21,45,14,46,14,19,7,34,41,21,13,5,25,43,98
15072,TreVaughn Wilkerson,2016,2017,Hartford,AEC,55,665,41,91,40,83,1,8,15,29,26,91,117,21,13,36,45,105,98
15073,Marquel Willis,2015,2015,Morehead State,OVC,23,236,27,70,18,41,9,29,35,43,10,23,33,9,2,1,16,27,98
15074,Danny Wilson,2008,2008,Longwood,Ind,31,445,37,83,37,82,0,1,24,35,45,56,101,20,6,4,24,69,98
15075,Jake Wolfe,2019,2019,Lipscomb,A-Sun,33,402,32,72,24,47,8,25,26,35,9,31,40,29,7,2,23,18,98
15076,Raphael Akpejiori,2011,2014,Miami (FL),ACC,85,593,28,66,28,66,0,0,41,67,56,72,128,5,10,38,22,91,97
15077,Miks Antoms,2018,2019,Maine,AEC,53,438,36,86,36,85,0,1,25,65,36,69,105,37,7,11,38,56,97
15078,Adam Arnold,2008,2008,Indiana State,MVC,29,511,30,81,21,43,9,38,28,41,51,76,127,19,14,7,26,62,97
15079,Charles Ashford,2012,2013,Coastal Carolina,Big South,39,317,33,69,32,64,1,5,30,48,15,28,43,20,6,1,28,30,97
15080,Ivo Basor,2015,2016,San Jose State,MWC,40,545,36,75,29,60,7,15,18,41,43,64,107,11,6,4,29,73,97
15081,Austin Budke,2016,2017,Kansas State,Big 12,56,539,27,75,22,51,5,24,38,54,25,52,77,18,12,4,23,85,97
15082,Josh Collins,2016,2017,North Dakota,Big Sky,52,465,35,88,28,62,7,26,20,34,17,49,66,14,9,5,24,69,97
15083,Malachi De Sousa,2019,2019,Albany (NY),AEC,28,356,35,77,29,49,6,28,21,32,11,41,52,16,10,19,25,27,97
15084,Tashawn Desir,2015,2015,Florida International,CUSA,30,533,33,98,22,62,11,36,20,30,5,49,54,62,31,0,56,61,97
15085,Ajon Efferson,2015,2015,Cal State Northridge,Big West,26,291,35,96,12,36,23,60,4,7,2,13,15,16,4,0,16,20,97
15086,Frankie Eteuati,2011,2012,Cal State Northridge,Big West,55,538,38,89,35,74,3,15,18,40,38,60,98,18,15,49,59,124,97
15087,Cameron Gunter,2011,2014,Pennsylvania,Ivy,91,566,36,78,36,76,0,2,25,50,31,47,78,6,10,22,38,86,97
15088,Isaiah Hobbs,2015,2017,Total,Total,32,404,30,72,30,57,0,15,37,60,16,34,50,13,15,9,34,53,97
15089,Emmanuel Igbinosa,2009,2010,Stanford,Pac-10,27,244,36,79,21,34,15,45,10,18,12,21,33,9,6,4,17,22,97
15090,Donya Jackson,2012,2013,Navy,Patriot,33,345,40,92,32,66,8,26,9,17,16,29,45,11,6,2,26,29,97
15091,Jaelyn Johnson-Coston,2015,2015,Weber State,Big Sky,30,304,36,71,36,70,0,1,25,40,20,36,56,8,12,6,27,40,97
15092,Dejan Kostur,2012,2013,Idaho State,Big Sky,40,406,40,93,37,83,3,10,14,22,16,36,52,6,8,8,33,82,97
15093,Anton Larsen,2011,2014,Old Dominion,Total,72,480,40,107,35,78,5,29,12,20,20,65,85,11,12,13,24,55,97
15094,Vince Legarza,2010,2013,Miami (OH),MAC,81,654,38,89,38,86,0,3,21,27,31,63,94,39,15,8,34,79,97
15095,Abednego Lufile,2016,2016,East Tennessee State,Southern,29,315,37,80,37,74,0,6,23,34,25,62,87,9,7,6,19,20,97
15096,Nick Marshall,2016,2016,Memphis,AAC,31,274,43,79,43,79,0,0,11,20,35,49,84,7,7,13,13,36,97
15097,David McClure,2008,2009,Duke,ACC,66,836,42,86,41,78,1,8,12,29,51,131,182,50,38,25,25,74,97
15098,Jalon Plummer,2014,2015,Youngstown State,Horizon,31,404,34,101,24,51,10,50,19,34,21,32,53,19,11,1,23,41,97
15099,Leon Redd,2019,2019,Bethune-Cookman,MEAC,13,286,32,88,12,23,20,65,13,17,4,31,35,24,8,0,21,28,97
15100,Ryan Salmonson,2014,2015,North Dakota,Big Sky,41,375,39,81,39,79,0,2,19,24,16,36,52,2,6,3,32,93,97
15101,Brad Sheehan,2008,2010,Georgia Tech,ACC,61,510,41,102,41,97,0,5,15,22,26,72,98,19,14,23,22,45,97
15102,K.J. Smith,2017,2019,Total,Total,46,352,35,92,24,48,11,44,16,29,5,17,22,26,8,4,14,17,97
15103,Peter Smith,2009,2010,San Francisco,WCC,24,323,29,77,7,14,22,63,17,24,1,23,24,29,7,0,13,27,97
15104,Jason Strong,2018,2019,Northeastern,CAA,39,310,40,94,30,61,10,33,7,10,13,32,45,8,3,4,18,28,97
15105,Cameron Wilbon,2019,2019,Robert Morris,NEC,32,400,41,92,40,79,1,13,14,29,21,32,53,15,7,9,30,44,97
15106,Skyler Williams,2009,2009,Lamar,Southland,26,410,35,67,30,45,5,22,22,35,10,41,51,42,26,3,32,48,97
15107,Kaleb Allison,2018,2019,Mississippi Valley State,SWAC,53,360,42,91,42,91,0,0,12,37,41,33,74,3,7,3,33,62,96
15108,Aguek Arop,2019,2019,San Diego State,MWC,31,452,37,83,34,68,3,15,19,31,34,49,83,30,17,18,26,48,96
15109,Wil Bathurst,2016,2016,Cornell,Ivy,25,371,38,104,30,74,8,30,12,24,10,49,59,12,12,9,32,44,96
15110,Darius Beane,2019,2019,Southern Illinois,MVC,32,494,32,81,20,44,12,37,20,27,30,61,91,26,18,4,25,14,96
15111,Twany Beckham,2009,2013,Total,SEC,68,558,38,108,37,95,1,13,19,39,14,75,89,72,31,3,62,45,96
15112,Rylan Bergersen,2018,2019,Brigham Young,WCC,50,289,30,69,18,32,12,37,24,37,1,34,35,16,6,5,12,30,96
15113,Kamali Chambers,2016,2019,Boston University,Patriot,69,436,30,87,18,42,12,45,24,37,6,26,32,33,10,1,18,41,96
15114,Wes Dipprey,2009,2009,Cal Poly,Big West,28,617,39,89,36,81,3,8,15,19,48,86,134,14,25,10,25,56,96
15115,Jon Doss,2016,2016,St. Francis (NY),NEC,24,344,34,97,11,21,23,76,5,11,12,37,49,13,7,2,11,31,96
15116,Dan Fotu,2019,2019,Saint Mary's (CA),WCC,34,468,32,81,11,30,21,51,11,16,17,71,88,15,8,5,17,40,96
15117,Isiah Graves,2017,2017,Morgan State,MEAC,29,305,29,87,22,57,7,30,31,44,8,26,34,33,19,4,29,42,96
15118,Elias Harden,2018,2019,Xavier,Big East,47,443,31,88,12,29,19,59,15,24,1,24,25,19,9,3,28,37,96
15119,Rey Idowu,2019,2019,Illinois State,MVC,33,342,40,67,40,67,0,0,16,28,32,53,85,7,6,4,15,44,96
15120,Roshun Jackson,2009,2010,Texas State,Southland,42,401,38,130,35,99,3,31,17,28,32,20,52,22,25,7,33,79,96
15121,Jeffrey Kennings,2011,2012,Florida A&M,MEAC,50,786,38,140,30,95,8,45,12,24,13,34,47,74,38,2,90,95,96
15122,Marcus Lawrence,2008,2010,Total,Total,53,614,37,89,22,43,15,46,7,12,10,43,53,79,21,1,42,43,96
15123,Greg LeSage,2010,2011,Green Bay,Horizon,50,517,34,77,34,77,0,0,28,39,49,68,117,14,17,18,30,81,96
15124,Tommy McDonnell,2012,2015,New Hampshire,AEC,78,815,36,91,32,79,4,12,20,34,64,132,196,51,32,3,50,80,96
15125,Andrew Moemeka,2017,2018,Wyoming,MWC,55,512,40,67,40,67,0,0,16,25,47,80,127,11,26,19,35,97,96
15126,Malik Montoya,2016,2017,Seattle,WAC,21,404,36,84,25,50,11,34,13,18,9,31,40,39,28,0,23,27,96
15127,Bryce Moragne,2018,2019,Florida A&M,MEAC,49,465,41,107,39,97,2,10,12,17,25,45,70,17,18,8,24,53,96
15128,Kameron Murrell,2016,2017,George Mason,A-10,53,497,27,129,7,39,20,90,22,28,15,43,58,19,10,3,21,48,96
15129,Alex Paquin,2015,2017,American,Patriot,52,420,36,75,27,48,9,27,15,28,9,37,46,15,9,0,23,54,96
15130,Jason Pimentel,2012,2015,Total,Total,36,397,38,83,36,78,2,5,18,35,35,62,97,8,12,9,27,53,96
15131,Keith Pinckney,2015,2018,Total,Total,60,429,40,105,37,86,3,19,13,28,4,21,25,29,16,0,37,30,96
15132,Keynan Pittman,2015,2016,Alcorn State,SWAC,33,433,42,76,42,76,0,0,12,33,27,49,76,3,9,12,20,75,96
15133,Tyrei Randall,2018,2018,Rider,MAAC,32,243,29,70,9,23,20,47,18,26,4,31,35,5,12,8,12,29,96
15134,Koron Reed,2010,2012,Hampton,MEAC,57,524,43,71,43,71,0,0,10,31,32,42,74,4,9,23,13,76,96
15135,Esmir Rizvic,2008,2009,Texas Tech,Big 12,41,494,37,74,37,74,0,0,22,48,36,43,79,9,15,11,23,85,96
15136,Legend Robertin,2016,2018,Total,Total,57,442,40,73,40,72,0,1,16,39,33,55,88,1,3,55,28,96,96
15137,Chad Ross,2014,2015,Utah Valley,WAC,51,486,37,98,30,75,7,23,15,25,18,66,84,13,14,6,33,66,96
15138,Mitchell Smith,2017,2019,Missouri,SEC,41,419,35,73,27,52,8,21,18,33,23,69,92,13,13,9,28,55,96
15139,Troy Stancil,2016,2016,Jackson State,SWAC,33,322,34,96,16,30,18,66,10,19,11,23,34,5,9,5,14,38,96
15140,Josiah Strong,2019,2019,Navy,Patriot,31,324,34,90,17,43,17,47,11,12,5,19,24,30,9,1,20,27,96
15141,Shomari Triggs,2015,2015,Coppin State,MEAC,26,323,33,108,20,52,13,56,17,27,8,21,29,18,15,2,25,31,96
15142,P.J. Turner,2009,2009,Texas-Rio Grande Valley,Ind,20,582,30,75,27,61,3,14,33,49,3,35,38,93,26,3,71,52,96
15143,Isaiah Whaley,2018,2019,Connecticut,AAC,53,497,37,64,37,64,0,0,22,37,42,49,91,10,14,35,17,64,96
15144,Kenneth Alexander,2008,2008,Cal State Fullerton,Big West,32,349,36,74,35,71,1,3,22,31,31,40,71,4,14,8,12,50,95
15145,Geno Artison,2017,2018,Tulsa,AAC,47,443,33,107,15,40,18,67,11,17,19,66,85,16,12,11,13,33,95
15146,Doug Chappell,2014,2015,Fairfield,MAAC,26,342,27,93,9,38,18,55,23,41,6,28,34,14,8,0,31,44,95
15147,Jack Clark,2019,2019,La Salle,A-10,9,242,28,68,12,29,16,39,23,30,13,26,39,10,9,2,10,20,95
15148,Jordan Finn,2011,2012,Nevada,WAC,59,478,26,62,20,41,6,21,37,52,11,31,42,26,12,1,42,68,95
15149,Will Foster,2008,2010,Gonzaga,WCC,67,437,43,79,43,79,0,0,9,40,35,72,107,8,6,45,31,50,95
15150,Josh Gomez,2012,2016,Total,Total,75,409,40,89,37,80,3,9,12,23,28,53,81,7,11,21,28,81,95
15151,Kris Harris,2009,2010,Illinois-Chicago,Horizon,32,382,36,111,30,86,6,25,17,40,18,28,46,25,11,0,25,32,95
15152,Matthew Herasme,2019,2019,Marist,MAAC,31,543,29,76,22,37,7,39,30,41,22,68,90,14,18,1,17,47,95
15153,Joe Hill,2009,2012,American,Patriot,59,366,32,93,1,8,31,85,0,0,7,22,29,18,6,2,16,40,95
15154,Kevin Holston,2019,2019,Alabama State,SWAC,29,548,34,142,24,81,10,61,17,31,17,53,70,73,30,1,63,57,95
15155,Jon Hood,2010,2014,Kentucky,SEC,86,425,32,95,16,40,16,55,15,19,24,42,66,17,13,3,13,35,95
15156,Thomas Huerter Jr.,2017,2019,Siena,MAAC,60,679,35,83,24,45,11,38,14,23,25,76,101,39,13,20,37,66,95
15157,Payton Hulsey,2014,2014,Western Kentucky,Sun Belt,31,418,26,64,21,49,5,15,38,55,26,59,85,46,18,3,38,41,95
15158,Krzysztof Janiszewski,2008,2010,Georgia Southern,Southern,68,399,42,93,42,92,0,1,11,26,34,43,77,9,4,15,34,73,95
15159,Greg Jones,2018,2019,Lipscomb,A-Sun,42,446,33,113,19,48,14,65,15,17,11,32,43,24,14,5,27,38,95
15160,Gershom Jordan,2009,2009,Tennessee State,OVC,27,238,38,65,38,65,0,0,19,34,25,39,64,2,4,7,17,59,95
15161,Byron Joynes,2008,2008,Rutgers,Big East,31,617,34,60,34,60,0,0,27,57,63,106,169,12,15,17,39,87,95
15162,Barry Latham,2011,2011,Bryant,NEC,30,722,31,87,27,66,4,21,29,43,32,67,99,51,16,16,22,72,95
15163,Max Martino,2012,2015,Northern Iowa,MVC,91,627,34,97,12,30,22,67,5,12,18,59,77,12,19,2,26,84,95
15164,Jon Mason,2008,2008,Florida A&M,MEAC,31,,33,104,17,44,16,60,13,14,12,26,38,24,21,0,26,19,95
15165,Jeremy Mayfield,2008,2008,Alabama-Birmingham,CUSA,22,315,39,85,39,84,0,1,17,33,40,46,86,7,5,6,12,30,95
15166,Montana Mayfield,2014,2015,NJIT,Ind,24,364,29,71,18,39,11,32,26,31,4,30,34,48,6,1,32,37,95
15167,David Merritt,2008,2009,Michigan,Big Ten,55,690,32,82,12,31,20,51,11,15,9,46,55,53,18,0,35,65,95
15168,Glenn Nelson,2008,2008,North Carolina A&T,MEAC,26,293,30,67,15,33,15,34,20,22,4,23,27,23,14,0,38,25,95
15169,Brian Patrick,2017,2018,Kansas State,Big 12,49,328,34,87,12,19,22,68,5,9,7,18,25,12,8,2,10,35,95
15170,Joey Quigley,2013,2014,Sacramento State,Big Sky,57,489,33,101,28,82,5,19,24,42,30,64,94,17,19,20,24,41,95
15171,Nikola Rakicevic,2016,2017,Buffalo,MAC,41,348,37,82,29,54,8,28,13,28,27,31,58,17,12,4,18,21,95
15172,Danny Smith,2010,2010,Morgan State,MEAC,34,618,34,97,31,81,3,16,24,51,11,40,51,96,19,1,58,46,95
15173,T.J. Topercer,2008,2010,Navy,Patriot,59,555,32,95,21,41,11,54,20,31,32,59,91,17,19,0,39,101,95
15174,Grant Vermeer,2014,2017,Navy,Patriot,46,374,38,88,24,39,14,49,5,8,17,35,52,29,16,0,26,26,95
15175,John Walker III,2019,2019,Texas A&M,SEC,29,384,32,70,25,47,7,23,24,40,23,45,68,17,12,6,29,34,95
15176,Shaquille Walters,2018,2019,Total,Total,31,435,34,84,27,58,7,26,20,32,3,47,50,23,7,4,26,35,95
15177,Hondo Webb,2013,2013,Lamar,Southland,28,411,37,73,36,63,1,10,20,26,31,42,73,27,10,4,54,55,95
15178,Jean Michel Yotio,2008,2009,Central Florida,CUSA,57,440,36,82,36,81,0,1,23,41,36,43,79,15,16,10,38,91,95
15179,Nick Aldridge,2008,2008,Western Carolina,Southern,5,162,39,98,33,81,6,17,10,18,9,17,26,16,6,3,17,12,94
15180,Diamon Alexander,2011,2012,Alabama A&M,SWAC,45,397,31,112,16,49,15,63,17,29,14,29,43,14,14,6,22,38,94
15181,Bobby Arthur-Williams,2019,2019,Milwaukee,Horizon,31,513,36,90,28,57,8,33,14,30,37,55,92,20,11,8,38,71,94
15182,Radwan Bakkali,2018,2018,Jacksonville,A-Sun,28,304,35,82,33,77,2,5,22,28,23,44,67,11,3,3,34,41,94
15183,Nassir Barrino,2017,2017,San Diego,WCC,30,536,38,99,38,93,0,6,18,42,12,54,66,37,18,0,33,56,94
15184,Alonzo Campbell,2017,2019,Total,Total,36,334,37,74,37,72,0,2,20,32,22,32,54,4,6,17,22,60,94
15185,Drew Conner,2008,2008,IUPUI,Summit,32,728,37,84,37,83,0,1,20,35,43,59,102,41,31,11,31,113,94
15186,Ishmail Jabbie,2016,2018,Maryland-Baltimore County,AEC,44,277,29,67,20,43,9,24,27,38,15,25,40,13,13,1,21,31,94
15187,Chad Jackson,2011,2011,James Madison,CAA,33,575,32,79,29,69,3,10,27,42,22,63,85,31,18,3,33,40,94
15188,Mel Johnson,2008,2008,Youngstown State,Horizon,30,418,33,99,21,58,12,41,16,29,19,45,64,29,30,11,25,38,94
15189,Elisha Justice,2011,2012,Louisville,Big East,54,416,31,84,21,42,10,42,22,37,5,34,39,42,17,0,26,51,94
15190,Ricky Lamb,2010,2011,Mississippi Valley State,SWAC,38,357,34,102,21,46,13,56,13,20,15,27,42,16,16,6,31,38,94
15191,Michael Matlock,2016,2017,Mississippi Valley State,SWAC,38,589,34,90,34,90,0,0,26,60,52,104,156,20,22,4,24,63,94
15192,Avery Merriex,2008,2010,Air Force,MWC,61,761,34,85,26,65,8,20,18,28,11,43,54,43,16,2,39,74,94
15193,Richie Mitchell,2017,2017,Marist,MAAC,29,336,30,96,21,63,9,33,25,26,4,29,33,26,13,0,24,29,94
15194,Yves Pons,2018,2019,Tennessee,SEC,59,535,39,76,30,48,9,28,7,17,21,56,77,22,12,17,27,59,94
15195,Bryant Purvis,2012,2012,Grambling,SWAC,28,563,33,130,27,84,6,46,22,33,23,68,91,15,7,2,42,47,94
15196,Jaylan Robertson,2017,2017,Coastal Carolina,Sun Belt,26,356,35,90,22,53,13,37,11,19,5,26,31,30,17,1,30,31,94
15197,Jeremy Roscoe,2019,2019,Akron,MAC,31,345,31,89,10,26,21,63,11,12,9,54,63,16,8,3,15,32,94
15198,SK Shittu,2019,2019,Central Arkansas,Southland,30,267,34,100,32,91,2,9,24,29,16,50,66,1,5,9,33,36,94
15199,Charles Standifer,2011,2015,Total,Total,32,364,33,112,23,73,10,39,18,37,12,45,57,16,13,5,23,32,94
15200,Greg Summers,2019,2019,Navy,Patriot,26,378,30,93,30,82,0,11,34,45,27,61,88,16,8,4,25,32,94
15201,Gene Swindle,2010,2013,Total,Total,49,552,35,76,35,76,0,0,24,40,38,67,105,9,8,14,32,92,94
15202,Jachai Taylor,2017,2018,Murray State,OVC,36,270,37,93,25,49,12,44,8,19,10,26,36,3,5,2,13,21,94
15203,Jordan Weathers,2011,2014,Norfolk State,MEAC,67,461,33,101,26,60,7,41,21,37,23,34,57,20,15,0,25,35,94
15204,Drew Allen,2009,2010,Southern Utah,Summit,53,572,31,94,11,21,20,73,11,14,8,26,34,28,12,1,34,47,93
15205,Greg Andrade,2013,2015,Central Connecticut State,NEC,45,578,30,84,18,46,12,38,21,34,21,60,81,19,12,13,17,37,93
15206,Rich Audu,2013,2014,Siena,MAAC,43,467,30,100,13,50,17,50,16,18,4,21,25,14,8,1,33,40,93
15207,Gjio Bain,2008,2008,Southern Mississippi,CUSA,28,502,43,59,43,59,0,0,7,26,40,94,134,5,8,47,13,46,93
15208,Nadi Beciri,2017,2019,Fairleigh Dickinson,NEC,55,299,30,76,24,58,6,18,27,42,34,51,85,11,13,12,29,60,93
15209,Major Canady,2014,2017,Drexel,CAA,51,669,30,99,22,63,8,36,25,47,9,65,74,56,17,1,28,70,93
15210,Jordan Carrier,2008,2008,Bethune-Cookman,MEAC,25,474,34,91,12,27,22,64,3,4,2,27,29,42,12,1,34,24,93
15211,Mykel Cleveland,2011,2011,Southern Illinois,MVC,29,546,35,87,35,84,0,3,23,38,17,32,49,64,19,10,42,71,93
15212,Drew Cobb,2019,2019,Long Beach State,Big West,33,590,38,74,37,64,1,10,16,25,31,87,118,43,19,5,23,50,93
15213,Justin Coleman,2012,2012,Marshall,CUSA,17,268,37,81,31,50,6,31,13,23,13,30,43,5,5,4,13,19,93
15214,Gilles Dierickx,2012,2015,Total,Total,57,642,42,102,42,102,0,0,9,13,40,55,95,18,8,25,50,114,93
15215,Chris Egi,2015,2018,Harvard,Ivy,55,492,33,71,33,71,0,0,27,70,33,55,88,21,17,26,34,69,93
15216,Kaosi Ezeagu,2019,2019,Texas-El Paso,CUSA,29,360,37,65,37,65,0,0,19,40,31,67,98,3,9,23,36,76,93
15217,Maricus Glenn,2017,2018,Savannah State,MEAC,61,568,37,72,37,68,0,4,19,39,48,76,124,16,16,16,36,129,93
15218,Dylan Hastings,2018,2019,Lafayette,Patriot,53,583,34,100,22,51,12,49,13,25,29,100,129,24,9,36,26,83,93
15219,Matt Hill,2009,2011,Texas,Big 12,80,721,33,78,33,78,0,0,27,51,58,103,161,15,8,32,26,73,93
15220,Cole Holmstrom,2008,2008,Indiana State,MVC,27,321,31,105,12,43,19,62,12,14,8,15,23,19,8,2,14,28,93
15221,Spencer Krannitz,2013,2015,Central Michigan,MAC,45,299,33,108,16,34,17,74,10,13,13,30,43,3,4,5,9,36,93
15222,Robert Lewis,2018,2018,Texas Southern,SWAC,16,310,31,77,14,33,17,44,14,24,2,31,33,11,3,3,12,23,93
15223,Ronald Lucas,2019,2019,Delaware State,MEAC,31,398,36,81,31,68,5,13,16,26,20,46,66,6,10,15,29,81,93
15224,Devin McNeil,2012,2012,Samford,Southern,26,337,33,91,20,50,13,41,14,19,9,29,38,40,15,4,34,30,93
15225,D'Juan Miller,2015,2015,Illinois-Chicago,Horizon,20,514,35,115,28,87,7,28,16,27,13,40,53,80,22,2,43,40,93
15226,Obi Momah,2015,2017,Marist,MAAC,49,271,31,76,28,67,3,9,28,43,25,51,76,8,6,9,23,53,93
15227,David Nickelberry,2018,2018,Memphis,AAC,33,360,38,92,30,60,8,32,9,16,13,43,56,31,12,5,31,27,93
15228,Derek Webster Jr.,2018,2019,Citadel,Southern,55,422,37,65,36,63,1,2,18,40,39,61,100,26,13,17,28,54,93
15229,Zay Williams,2019,2019,Troy,Sun Belt,30,287,31,63,28,52,3,11,28,39,22,45,67,5,5,25,21,45,93
15230,Jeremy Adams,2014,2014,Grand Canyon,WAC,16,300,25,79,24,67,1,12,41,61,20,22,42,10,6,1,15,38,92
15231,Nikola Baran,2008,2008,Northwestern,Big Ten,30,404,31,104,18,46,13,58,17,25,8,24,32,35,12,7,31,57,92
15232,Louis Barraza,2009,2010,Albany (NY),AEC,24,239,29,90,6,18,23,72,11,13,8,4,12,14,8,3,23,39,92
15233,Cameron Benford,2018,2019,Purdue-Fort Wayne,Summit,58,543,39,92,39,91,0,1,14,30,66,90,156,14,19,22,22,113,92
15234,Theodore Boyomo,2012,2015,Howard,MEAC,77,744,36,64,36,64,0,0,20,39,49,115,164,10,14,11,42,128,92
15235,Tyquan Brown,2011,2011,UC-Riverside,Big West,30,441,39,77,39,77,0,0,14,37,49,72,121,13,18,17,33,52,92
15236,Karamoko Cisse,2018,2019,Rider,MAAC,48,312,28,54,28,54,0,0,36,67,30,42,72,5,10,6,21,71,92
15237,Chad Culbreath,2016,2016,Murray State,OVC,23,254,35,92,23,49,12,43,10,18,7,20,27,32,16,0,24,38,92
15238,Chike Ekweozor,2008,2008,Southern,SWAC,30,294,33,73,33,73,0,0,26,50,24,41,65,7,6,7,25,63,92
15239,Blake Foeman,2011,2013,Denver,Total,64,554,32,77,20,31,12,46,16,25,9,31,40,31,4,7,34,61,92
15240,Andre Frederick,2015,2016,Robert Morris,NEC,51,540,42,71,42,71,0,0,8,22,30,39,69,5,19,32,27,63,92
15241,Ron Freeman,2016,2019,Total,Total,25,270,32,103,23,53,9,50,19,30,9,43,52,9,12,3,16,31,92
15242,Isaac Gordon,2009,2011,Texas-El Paso,CUSA,76,603,27,74,14,32,13,42,25,32,10,66,76,36,16,3,32,43,92
15243,Andrew Green,2008,2008,Cal State Fullerton,Big West,31,408,36,78,36,78,0,0,20,27,36,42,78,15,16,3,20,66,92
15244,Tevin Hall,2010,2011,Louisiana Tech,WAC,38,435,28,65,22,50,6,15,30,40,4,49,53,33,16,0,34,40,92
15245,Evan Hinson,2017,2019,South Carolina,SEC,46,407,30,98,19,51,11,47,21,35,13,39,52,11,11,4,26,45,92
15246,Chad Holley,2012,2012,Mount St. Mary's,NEC,28,383,30,90,19,46,11,44,21,25,4,21,25,26,14,0,38,48,92
15247,DeAngelo Jackson,2009,2010,North Carolina-Greensboro,Southern,53,489,40,94,40,94,0,0,12,25,41,38,79,3,9,9,26,82,92
15248,Jermaine Jackson,2009,2010,Rider,MAAC,50,589,35,74,35,72,0,2,22,38,36,71,107,22,19,32,45,101,92
15249,Mar'Qywell Jackson,2016,2016,Duquesne,A-10,25,263,29,80,10,24,19,56,15,24,14,37,51,9,4,3,12,39,92
15250,Gabe Kindred,2011,2011,Loyola (IL),Horizon,24,282,30,68,25,53,5,15,27,36,10,29,39,24,16,0,28,35,92
15251,Milos Knezevic,2010,2013,Bradley,MVC,70,333,31,83,14,26,17,57,13,19,13,51,64,8,9,1,24,60,92
15252,RA Kpedi,2018,2019,Vermont,AEC,39,329,32,60,32,60,0,0,28,49,26,37,63,6,4,6,18,39,92
15253,Tanner Lancona,2014,2015,Saint Louis,A-10,43,393,34,88,26,48,8,40,16,32,13,39,52,17,12,4,18,36,92
15254,Jawaun Newton,2019,2019,Evansville,MVC,30,431,27,80,17,36,10,44,28,36,9,59,68,18,11,6,21,42,92
15255,Madiaw Niang,2019,2019,Florida Atlantic,CUSA,31,423,32,105,22,60,10,45,18,25,30,76,106,10,9,5,14,50,92
15256,Yalim Olcay,2017,2019,Western Carolina,Southern,56,412,35,76,35,75,0,1,22,43,30,61,91,7,7,2,29,80,92
15257,Montraz Oliver,2017,2019,Maryland-Eastern Shore,MEAC,43,369,30,96,23,61,7,35,25,34,19,37,56,15,11,1,19,23,92
15258,Will Paul,2009,2009,Stanford,Pac-10,23,302,35,72,21,42,14,30,8,13,10,21,31,16,4,6,13,64,92
15259,Kashif Pratt,2009,2009,Iona,MAAC,14,286,36,89,24,43,12,46,8,15,6,23,29,16,6,2,20,39,92
15260,Daylen Robinson,2013,2013,Texas Tech,Big 12,30,495,31,110,25,69,6,41,24,35,7,33,40,58,27,0,53,46,92
15261,Cassidy Ryan,2015,2016,Canisius,MAAC,44,291,38,94,27,66,11,28,5,8,13,28,41,15,7,3,21,54,92
15262,Joseph Smoyer,2017,2018,Portland,WCC,40,371,32,56,31,54,1,2,27,48,15,54,69,9,6,23,14,65,92
15263,Rodrick Stewart,2008,2008,Kansas,Big 12,33,383,35,71,30,55,5,16,17,28,35,39,74,47,13,2,27,29,92
15264,Paul Wayne,2008,2008,Cal State Northridge,Big West,20,285,26,64,26,62,0,2,40,48,3,24,27,46,29,1,30,38,92
15265,Donald Williams,2013,2013,Maryland-Eastern Shore,MEAC,27,322,34,149,19,73,15,76,9,15,7,14,21,5,13,1,33,15,92
15266,Erik Williams,2010,2013,Total,Total,45,321,37,97,32,73,5,24,13,22,28,45,73,6,6,2,14,36,92
15267,Jabrille Williams,2012,2015,Binghamton,AEC,69,589,39,86,31,55,8,31,6,14,28,75,103,9,10,11,28,57,92
15268,Tao Xu,2013,2014,San Francisco,WCC,36,427,34,80,34,80,0,0,24,36,16,23,39,7,7,4,39,79,92
15269,Julius Allgood,2009,2009,Texas-Rio Grande Valley,Ind,27,280,36,74,33,56,3,18,16,23,18,33,51,13,4,1,24,54,91
15270,Marvin Binney,2013,2013,Duquesne,A-10,29,368,32,73,17,34,15,39,12,13,4,25,29,19,15,0,21,30,91
15271,Michael Brown,2014,2015,Navy,Patriot,49,437,33,87,27,68,6,19,19,31,35,30,65,11,9,2,22,59,91
15272,Cliff Clinkscales,2008,2008,DePaul,Big East,30,776,31,79,24,58,7,21,22,35,8,27,35,123,20,0,34,28,91
15273,John Comfort,2009,2012,Princeton,Ivy,53,289,32,86,14,29,18,57,9,17,9,28,37,9,2,2,15,21,91
15274,Jordan Davis,2011,2011,Monmouth,NEC,14,396,28,74,12,34,16,40,19,28,7,42,49,47,19,4,23,24,91
15275,Tim Dixon,2012,2014,Georgia,SEC,84,728,38,89,38,89,0,0,15,24,37,94,131,21,14,20,34,39,91
15276,Lucas Faggiano,2009,2009,Long Island University,NEC,15,364,28,66,19,42,9,24,26,33,4,32,36,45,20,1,33,27,91
15277,Marquell Fraser,2017,2019,Total,Total,24,267,33,70,32,63,1,7,24,38,13,44,57,27,10,1,23,20,91
15278,Darius Harper,2017,2018,Miami (OH),MAC,36,383,41,92,41,92,0,0,9,29,22,46,68,2,7,8,33,62,91
15279,Quaran Jones,2017,2017,Eastern Michigan,MAC,24,180,31,48,31,48,0,0,29,41,16,18,34,7,13,6,8,27,91
15280,Rashad Lewis,2017,2017,Mercer,Southern,32,400,29,103,11,34,18,69,15,21,7,34,41,70,23,0,23,46,91
15281,Ryan McCoy,2012,2015,Total,Total,91,691,31,96,14,42,17,54,12,22,20,64,84,39,19,16,60,115,91
15282,Blake McLimans,2011,2014,Total,Total,76,415,37,107,25,44,12,63,5,6,28,45,73,9,6,26,12,34,91
15283,LeShaun Murphy,2011,2011,Southern Illinois-Edwardsville,Ind,27,285,34,86,32,80,2,6,21,40,15,35,50,20,10,1,31,21,91
15284,Onyekachukwu Odi,2013,2014,Florida A&M,MEAC,63,636,34,100,34,100,0,0,23,67,65,87,152,6,10,62,51,151,91
15285,Danny Ogele,2018,2019,Navy,Patriot,31,294,37,90,35,78,2,12,15,29,21,52,73,15,2,7,31,26,91
15286,David Palmer,2008,2009,Iowa,Big Ten,33,234,29,66,19,40,10,26,23,34,11,35,46,0,3,6,15,35,91
15287,Kevin Phillip,2009,2010,Drexel,CAA,36,413,43,85,43,85,0,0,5,12,31,77,108,6,12,15,14,77,91
15288,Mike Samuels,2015,2015,Eastern Michigan,MAC,34,385,32,60,32,60,0,0,27,42,42,79,121,7,14,15,27,96,91
15289,Jarrod Simmons,2018,2019,Pennsylvania,Ivy,44,312,30,64,22,41,8,23,23,34,29,51,80,18,5,11,17,56,91
15290,Jason Smith,2012,2012,Texas A&M-Corpus Christi,Southland,28,275,29,86,23,64,6,22,27,39,5,48,53,18,8,2,33,16,91
15291,Maurice Smith,2017,2019,Western Carolina,Southern,61,518,35,110,30,94,5,16,16,38,50,96,146,31,20,6,50,61,91
15292,Patrick Smith,2016,2018,Southern,SWAC,33,363,36,78,33,69,3,9,16,29,24,41,65,9,8,4,32,57,91
15293,Marcel Thompson,2017,2017,Grambling,SWAC,30,259,33,85,12,22,21,63,4,9,4,12,16,7,4,1,11,27,91
15294,Dezmyn Trent,2014,2015,Boise State,MWC,31,215,32,85,18,44,14,41,13,25,15,40,55,4,6,3,16,22,91
15295,Derrick Walker,2018,2019,Tennessee,SEC,64,458,38,66,38,66,0,0,15,44,37,70,107,16,9,10,27,71,91
15296,Andrew Young,2013,2013,Texas A&M,SEC,32,419,32,90,32,89,0,1,27,38,34,59,93,8,6,12,24,47,91
15297,Brandon Allen,2014,2018,Florida State,ACC,75,323,33,73,15,27,18,46,6,6,10,23,33,16,10,4,22,48,90
15298,Trae Bryant,2016,2018,Total,Total,29,414,29,95,13,33,16,62,16,20,7,45,52,33,10,4,29,31,90
15299,Elijah Buchanan,2019,2019,Manhattan,MAAC,32,422,32,120,26,78,6,42,20,45,12,44,56,36,16,4,39,71,90
15300,Jeremiah Buford,2019,2019,Nicholls State,Southland,26,362,31,75,12,31,19,44,9,11,14,27,41,17,11,1,19,35,90
15301,William Bullard,2008,2008,Texas A&M-Corpus Christi,Southland,23,365,30,93,16,43,14,50,16,20,23,25,48,21,10,1,27,49,90
15302,Joey Calcaterra,2019,2019,San Diego,WCC,32,397,33,86,23,54,10,32,14,19,1,28,29,24,9,5,16,29,90
15303,Tim Cameron,2017,2019,Total,Total,27,236,27,67,23,45,4,22,32,46,22,34,56,26,13,5,20,25,90
15304,Mackenzie Casey,2009,2010,South Dakota State,Summit,28,398,32,84,29,55,3,29,23,26,8,18,26,41,13,4,29,43,90
15305,Nolan Dennis,2010,2011,Baylor,Big 12,40,336,31,72,24,45,7,27,21,42,7,26,33,16,17,9,31,48,90
15306,Matt Dentlinger,2019,2019,South Dakota State,Summit,33,387,36,64,36,61,0,3,18,25,43,44,87,12,6,6,14,44,90
15307,Zach Dickerson,2014,2016,Total,Total,45,609,33,80,24,47,9,33,15,20,4,36,40,45,5,4,33,60,90
15308,Ramon Eaton,2012,2014,Total,Total,41,429,30,89,30,81,0,8,30,44,35,45,80,7,12,3,33,47,90
15309,Wendell Faines,2012,2013,Idaho,WAC,50,456,35,80,35,80,0,0,20,32,36,58,94,10,4,22,36,90,90
15310,Taelyr Gatlin,2019,2019,Denver,Summit,28,466,35,88,21,43,14,45,6,10,4,29,33,40,10,3,35,36,90
15311,Kamau Gordon,2008,2009,Niagara,MAAC,59,489,35,68,35,68,0,0,20,37,43,55,98,18,17,13,34,146,90
15312,Johnnie Harris,2008,2008,New Mexico,MWC,33,403,40,63,40,63,0,0,10,24,31,31,62,13,6,4,22,60,90
15313,Mark Holmes,2010,2011,Mississippi Valley State,SWAC,51,348,34,112,21,78,13,34,9,16,21,34,55,4,7,3,10,58,90
15314,Bobby Jackson,2018,2019,Grambling,SWAC,33,317,34,75,32,63,2,12,20,40,26,43,69,5,2,6,16,35,90
15315,Dezmond James,2015,2016,Air Force,MWC,39,419,31,101,25,65,6,36,22,36,8,42,50,26,10,1,23,31,90
15316,Ra'Shad James,2012,2012,Iona,MAAC,29,224,36,69,32,56,4,13,14,20,17,29,46,9,11,2,5,28,90
15317,Theron Jenkins,2010,2010,Texas Tech,Big 12,31,284,34,81,33,72,1,9,21,32,19,43,62,15,17,6,24,48,90
15318,Miles Lester,2018,2018,Rice,CUSA,29,359,25,78,5,25,20,53,20,27,4,32,36,46,8,0,32,18,90
15319,Jermaine Lippert,2013,2014,Detroit Mercy,Horizon,60,408,36,60,34,54,2,6,16,29,26,41,67,20,21,12,32,98,90
15320,Rodney Meadows,2008,2008,Prairie View,SWAC,28,293,29,96,21,63,8,33,24,35,7,22,29,10,2,1,29,38,90
15321,Donovan Mitchell,2017,2018,Wake Forest,ACC,34,345,32,65,17,30,15,35,11,15,14,54,68,6,9,8,21,60,90
15322,Aleksandar Popovic,2008,2009,Maryland-Eastern Shore,MEAC,31,608,36,113,36,113,0,0,18,41,54,89,143,12,7,26,38,69,90
15323,Larry Robinson III,2019,2019,New Orleans,Southland,30,269,28,76,17,40,11,36,23,36,10,17,27,17,12,1,15,27,90
15324,Levan Shengelia,2011,2014,Total,Total,50,421,31,71,31,71,0,0,28,55,37,45,82,12,11,12,28,74,90
15325,Alex Smith,2008,2009,William & Mary,CAA,22,216,31,71,26,60,5,11,23,36,26,27,53,4,4,4,7,24,90
15326,Sasha Stefanovic,2019,2019,Purdue,Big Ten,36,417,30,77,5,16,25,61,5,14,3,37,40,16,20,4,25,43,90
15327,Eloy Vargas,2009,2012,Total,SEC,80,524,31,89,31,86,0,3,28,53,57,82,139,6,9,36,21,74,90
15328,Luka Vasic,2018,2018,Charlotte,CUSA,24,405,28,73,12,33,16,40,18,32,8,55,63,21,9,0,25,41,90
15329,Matthew Wallace,2009,2011,Total,Total,38,303,31,101,12,27,19,74,9,10,5,16,21,15,10,1,29,32,90
15330,Chris Andrews,2008,2009,Yale,Ivy,30,572,29,79,16,41,13,38,18,26,6,37,43,80,34,0,61,46,89
15331,Mitchell Bouie,2011,2011,South Dakota,GWC,27,241,40,73,40,73,0,0,9,31,18,34,52,11,5,2,24,26,89
15332,Carlin Bremner,2012,2014,Total,Total,36,311,33,109,17,52,16,57,7,12,7,13,20,20,8,0,17,15,89
15333,Tim Broom,2015,2016,Citadel,Southern,46,439,28,79,19,47,9,32,24,45,25,20,45,70,24,0,47,94,89
15334,Josh Caldwell,2019,2019,Army,Patriot,27,353,36,103,30,68,6,35,11,18,16,45,61,24,20,1,19,45,89
15335,Josh Cassaday,2009,2010,South Dakota State,Summit,42,393,31,72,27,54,4,18,23,40,45,61,106,26,14,3,32,65,89
15336,Maurice Commander,2019,2019,Chattanooga,Southern,23,405,33,97,19,45,14,52,9,12,5,38,43,35,10,1,21,22,89
15337,Davante Cooper,2016,2019,Total,Total,63,436,39,74,39,74,0,0,11,27,15,59,74,12,3,19,35,58,89
15338,Justin Dahl,2017,2019,Northern Iowa,MVC,42,322,38,81,38,81,0,0,13,24,23,59,82,12,11,19,28,35,89
15339,Javonte Douglas,2015,2015,Old Dominion,CUSA,25,255,33,74,31,67,2,7,21,38,18,48,66,19,5,5,17,36,89
15340,Wally Ellenson,2013,2016,Total,Total,47,364,35,99,27,61,8,38,11,22,29,55,84,14,11,4,14,55,89
15341,Tim Gill,2015,2015,Jacksonville,A-Sun,23,369,28,74,28,73,0,1,33,55,36,27,63,5,5,5,18,51,89
15342,Lee Goldsbrough,2011,2014,Providence,Big East,97,802,34,78,29,62,5,16,16,28,66,90,156,24,21,6,51,97,89
15343,Jack Hansen,2019,2019,IUPUI,Horizon,31,287,27,81,14,40,13,41,22,25,15,34,49,11,6,4,12,30,89
15344,Adrian Hunter,2009,2009,Central Michigan,MAC,28,341,29,80,9,24,20,56,11,17,7,35,42,10,5,0,19,26,89
15345,Anthony Johnson,2014,2016,Eastern Illinois,OVC,68,399,32,75,24,50,8,25,17,27,9,45,54,17,7,0,23,49,89
15346,Chad Johnson,2012,2015,Lipscomb,A-Sun,91,727,23,82,7,23,16,59,27,34,16,72,88,50,26,1,39,108,89
15347,DeRias Johnson,2017,2019,Southern,SWAC,46,389,31,119,15,48,16,71,11,26,16,43,59,35,16,3,30,48,89
15348,Gene Johnson,2008,2011,Morgan State,MEAC,85,505,38,85,38,84,0,1,13,17,36,60,96,7,14,7,15,75,89
15349,Matthew Johnson,2016,2019,Southern Utah,Big Sky,57,323,28,78,8,24,20,54,13,20,9,25,34,9,7,1,10,42,89
15350,Bryan Knapp,2018,2019,Cornell,Ivy,43,381,34,81,24,55,10,26,11,14,7,18,25,14,8,0,27,32,89
15351,Quincy Lawson,2010,2012,Loyola Marymount,WCC,37,356,39,76,39,74,0,2,11,24,33,37,70,12,18,13,14,23,89
15352,Sam Mader,2013,2013,Northern Illinois,MAC,25,384,37,88,35,81,2,7,13,18,20,25,45,10,9,12,20,38,89
15353,Logan Magnusson,2010,2011,Brigham Young,MWC,58,497,33,77,23,49,10,28,13,24,32,77,109,28,9,0,21,54,89
15354,Jerron Martin,2014,2018,Total,Total,37,336,31,86,15,31,16,55,11,15,4,24,28,33,10,0,24,23,89
15355,Patrick Mwamba,2019,2019,Texas-Arlington,Sun Belt,27,388,33,82,26,52,7,30,16,30,22,46,68,18,26,5,31,49,89
15356,Bryce Nickels,2016,2016,Youngstown State,Horizon,23,319,36,79,36,77,0,2,17,38,24,53,77,11,11,17,28,41,89
15357,Victor Ohia Obioha,2019,2019,Pepperdine,WCC,26,287,36,47,36,47,0,0,17,29,14,39,53,6,5,22,12,51,89
15358,Cliff Palsson,2011,2011,Maryland,ACC,32,324,30,66,18,37,12,29,17,22,23,43,66,25,10,2,19,37,89
15359,Byron Pickens,2010,2011,Tennessee Tech,OVC,47,474,37,95,37,92,0,3,15,33,34,46,80,16,20,16,31,94,89
15360,Christian Rohlehr,2019,2019,St. Francis (NY),NEC,29,291,34,66,34,66,0,0,21,43,44,47,91,3,9,32,19,51,89
15361,Wyatt Sikora,2015,2015,Stetson,A-Sun,31,365,33,72,31,58,2,14,21,32,23,41,64,5,2,21,15,29,89
15362,Cassius Smits-Francisco,2019,2019,Idaho,Big Sky,26,423,39,64,39,64,0,0,11,33,32,68,100,10,6,10,23,62,89
15363,Desmond Stephens,2008,2008,Utah State,WAC,34,401,25,83,10,27,15,56,24,33,7,21,28,57,16,1,48,60,89
15364,Joseph Swift,2011,2011,Maryland-Eastern Shore,MEAC,28,386,32,82,31,79,1,3,24,49,14,17,31,47,32,0,51,38,89
15365,Anthony Taylor,2012,2013,Longwood,Total,32,357,29,91,26,77,3,14,28,46,10,20,30,24,10,0,50,16,89
15366,Cliff Thomas Jr.,2017,2019,High Point,Big South,37,224,33,47,33,47,0,0,23,39,18,45,63,2,2,17,17,26,89
15367,Fletcher Tynen,2019,2019,Boston University,Patriot,32,428,33,68,29,51,4,17,19,33,15,44,59,11,6,2,22,43,89
15368,Ibn Williams,2019,2019,Coppin State,MEAC,31,379,33,105,21,60,12,45,11,14,9,30,39,34,13,0,39,32,89
15369,Chris Britt-Black,2011,2011,Grambling,SWAC,32,487,36,72,36,72,0,0,16,55,42,69,111,7,14,10,40,77,88
15370,Justin Brown,2019,2019,Chattanooga,Southern,25,271,36,65,36,64,0,1,16,24,31,32,63,10,6,12,19,38,88
15371,Jerome Davis,2008,2009,Jackson State,SWAC,36,323,27,75,9,22,18,53,16,23,9,28,37,22,22,1,19,14,88
15372,Jocolby Davis,2010,2010,East Tennessee State,A-Sun,32,647,34,75,32,63,2,12,18,38,11,41,52,78,41,4,69,62,88
15373,Samba Diallo,2019,2019,Massachusetts,A-10,25,423,34,79,30,62,4,17,16,34,26,58,84,13,9,2,25,50,88
15374,Ray Dorsey,2013,2014,Texas State,Total,55,505,29,74,21,48,8,26,22,43,7,38,45,38,13,0,22,35,88
15375,David Ellis,2008,2008,Nevada,WAC,33,434,36,80,33,65,3,15,13,14,23,50,73,17,2,15,18,52,88
15376,Keandre Fair,2018,2018,Coppin State,MEAC,27,387,29,87,4,11,25,76,5,8,1,29,30,18,21,0,9,25,88
15377,Desmond Griffin,2009,2009,Southern,SWAC,18,,32,97,21,55,11,42,13,22,11,23,34,11,7,4,33,27,88
15378,Cornelio Guibunda,2008,2008,American,Patriot,33,451,33,56,33,56,0,0,22,31,34,79,113,12,8,35,20,79,88
15379,Hollis Hill,2011,2011,Texas A&M-Corpus Christi,Southland,31,304,27,92,14,43,13,49,21,30,8,15,23,21,16,0,35,37,88
15380,Sean Hoggs,2018,2018,Maryland-Eastern Shore,MEAC,32,442,29,95,7,21,22,74,8,13,8,33,41,14,7,1,18,20,88
15381,Bijon Jones,2009,2009,Southeast Missouri State,OVC,29,707,22,93,15,57,7,36,37,47,9,48,57,73,19,3,75,57,88
15382,Bobby Lee,2010,2010,Southern,SWAC,19,212,34,99,23,43,11,56,9,14,13,21,34,5,14,3,15,11,88
15383,Jake Lliteras,2012,2013,Oral Roberts,Total,54,454,28,91,9,26,19,65,13,19,6,41,47,27,19,4,28,44,88
15384,Nelson Maxwell,2016,2017,Cleveland State,Horizon,42,421,31,74,22,59,9,15,17,22,9,30,39,27,17,2,34,62,88
15385,DJ McDonald,2019,2019,UC-Riverside,Big West,30,509,29,90,9,27,20,63,10,13,8,20,28,36,11,0,20,39,88
15386,Shawn Moore,2013,2014,UC-Santa Barbara,Big West,52,520,40,67,38,58,2,9,6,12,32,40,72,27,7,1,21,37,88
15387,Nick Mosley,2008,2009,Houston,CUSA,46,394,29,63,29,63,0,0,30,41,49,43,92,6,13,14,13,67,88
15388,Modou Niang,2008,2010,Utah State,WAC,47,353,32,57,32,57,0,0,24,42,26,50,76,12,4,25,33,69,88
15389,Miles Norris,2019,2019,Oregon,Pac-12,27,283,34,63,28,38,6,25,14,28,13,38,51,4,14,7,9,45,88
15390,Jared Pearre,2019,2019,Cal State Northridge,Big West,30,395,38,58,38,58,0,0,12,24,30,51,81,18,14,16,19,56,88
15391,Rodrigo Peggau,2009,2011,Duquesne,A-10,44,381,32,73,30,60,2,13,22,44,34,58,92,7,12,1,31,75,88
15392,C.J. Portz,2008,2008,UC-Davis,Big West,31,450,33,77,27,57,6,20,16,21,10,29,39,25,4,14,38,72,88
15393,Erik Poulsen,2018,2018,San Francisco,WCC,25,225,32,95,20,43,12,52,12,22,17,30,47,7,3,5,15,36,88
15394,John Rinaldi,2014,2017,Binghamton,AEC,103,808,33,69,33,64,0,5,22,40,42,110,152,55,32,3,39,114,88
15395,Eddie Spencer,2008,2008,Central Michigan,MAC,31,441,27,74,15,32,12,42,22,29,29,50,79,14,10,9,30,66,88
15396,Walter Thompson,2008,2008,Portland,WCC,23,241,35,90,22,51,13,39,5,12,2,30,32,12,4,0,19,22,88
15397,Matt Titchenal,2009,2012,Cal Poly,Big West,37,300,32,91,17,46,15,45,9,18,8,17,25,8,1,1,13,30,88
15398,Joe Tuss,2014,2016,Air Force,MWC,41,395,32,117,22,65,10,52,14,28,16,48,64,20,6,1,24,46,88
15399,Adam Weir,2015,2016,Canisius,MAAC,52,473,29,119,9,36,20,83,10,18,18,30,48,29,16,5,14,60,88
15400,Jason Battle,2008,2009,Cornell,Ivy,57,493,31,67,30,62,1,5,24,31,13,48,61,35,18,2,29,42,87
15401,Dorien Brown,2008,2008,Jacksonville State,OVC,9,176,36,69,36,68,0,1,15,43,17,31,48,5,5,9,14,22,87
15402,Romelo Burrell,2019,2019,Central Michigan,MAC,35,385,24,63,22,46,2,17,37,57,32,52,84,8,5,14,18,48,87
15403,Jalen Carey,2019,2019,Syracuse,ACC,25,304,29,74,25,51,4,23,25,40,6,33,39,25,16,4,41,12,87
15404,Mike Davis,2019,2019,Murray State,OVC,27,397,32,76,18,28,14,48,9,16,22,54,76,16,10,5,17,58,87
15405,Chris Dees,2014,2015,St. Bonaventure,A-10,63,566,41,98,41,97,0,1,5,13,45,79,124,9,19,16,17,96,87
15406,Brandon Dison,2008,2010,Louisiana,Sun Belt,34,394,36,77,36,77,0,0,15,20,12,34,46,15,19,1,18,31,87
15407,Stephon Drane,2011,2013,Western Kentucky,Sun Belt,51,284,35,67,35,66,0,1,17,31,20,31,51,1,16,2,18,63,87
15408,James Erger,2010,2013,Bowling Green State,MAC,106,677,32,101,19,38,13,63,10,18,25,44,69,32,21,9,26,50,87
15409,B.J. Ford,2008,2009,South Alabama,Sun Belt,46,334,30,92,8,26,22,66,5,8,5,15,20,21,9,0,16,16,87
15410,Lionel Foster,2009,2010,Little Rock,Sun Belt,49,728,22,54,19,37,3,17,40,60,7,66,73,121,29,1,67,62,87
15411,Richie Frohlich,2009,2010,Texas-San Antonio,Southland,36,289,35,59,35,58,0,1,17,35,35,41,76,1,7,6,16,59,87
15412,Dennis Green,2014,2014,Eastern Illinois,OVC,16,219,25,67,24,58,1,9,36,53,11,23,34,15,8,1,20,23,87
15413,Malcolm Henderson,2016,2016,Cal State Fullerton,Big West,30,453,33,63,33,63,0,0,21,40,40,52,92,4,6,4,17,63,87
15414,Billy Jackson,2015,2015,Mississippi Valley State,SWAC,32,441,28,101,22,63,6,38,25,41,16,22,38,24,17,1,36,45,87
15415,Jay Knuth,2015,2015,Loyola (IL),MVC,32,289,23,63,12,37,11,26,30,34,13,19,32,8,7,1,19,32,87
15416,Collin Luther,2015,2018,Elon,CAA,83,651,28,85,15,32,13,53,18,27,36,68,104,33,17,2,27,79,87
15417,Gino Myers-Kyles,2008,2008,Eastern Illinois,OVC,26,330,29,61,19,42,10,19,19,30,5,29,34,6,8,2,14,26,87
15418,Sebastian Norman,2012,2015,Lamar,Southland,69,479,29,74,29,73,0,1,29,44,34,66,100,4,9,23,19,70,87
15419,Chris Richardson,2011,2012,Tennessee-Martin,OVC,61,812,26,97,20,66,6,31,29,49,10,35,45,64,24,3,78,88,87
15420,Isaiah Robinson,2016,2016,Houston Baptist,Southland,27,351,37,60,37,59,0,1,13,23,27,72,99,20,8,54,13,51,87
15421,Sammy Schafer,2009,2010,Air Force,MWC,26,384,29,64,26,50,3,14,26,43,13,39,52,27,5,10,22,45,87
15422,Mike Shaw,2012,2016,Total,Total,66,638,32,94,26,71,6,23,17,41,53,102,155,27,28,17,50,106,87
15423,Amir Smith,2016,2018,Total,CUSA,52,371,38,74,38,74,0,0,11,24,35,58,93,3,8,36,14,59,87
15424,Mike Turner,2013,2015,Houston Baptist,Total,37,189,29,70,7,16,22,54,7,11,4,11,15,7,3,2,13,11,87
15425,Trey Washington,2014,2014,Wyoming,MWC,29,281,27,69,10,18,17,51,16,27,1,24,25,19,2,0,17,23,87
15426,Pierre-Marie Altidor Cespedes,2008,2008,Marshall,CUSA,26,702,28,83,13,33,15,50,15,25,8,42,50,72,26,3,46,56,86
15427,Rontrell Bailey,2012,2012,Arkansas-Pine Bluff,SWAC,28,505,28,63,23,45,5,18,25,39,28,43,71,28,10,1,30,36,86
15428,Michael Binns,2008,2008,Fordham,A-10,26,366,34,93,22,50,12,43,6,11,18,27,45,6,8,2,10,36,86
15429,Isaac Bonton,2018,2018,Montana State,Big Sky,11,205,31,86,23,64,8,22,16,21,4,27,31,15,9,2,25,30,86
15430,Anthony Boswell,2017,2017,Florida International,CUSA,28,504,30,94,16,44,14,50,12,14,12,38,50,13,8,5,21,43,86
15431,Malik Burnett,2018,2019,Troy,Sun Belt,38,356,31,93,18,48,13,45,11,21,8,33,41,36,7,5,35,26,86
15432,Pedro Castro,2019,2019,Texas-Arlington,Sun Belt,33,441,34,79,23,37,11,42,7,12,11,60,71,29,7,12,15,28,86
15433,Chris Clausen,2011,2011,North Dakota,GWC,28,369,26,77,14,31,12,46,22,31,16,45,61,24,3,4,12,64,86
15434,Kyle Copeland,2018,2019,Holy Cross,Patriot,43,370,32,83,14,25,18,58,4,7,12,28,40,17,17,1,14,35,86
15435,Andrew Darko,2008,2011,Texas A&M,Big 12,59,391,30,90,9,22,21,68,5,14,9,38,47,23,13,6,22,52,86
15436,Demar Dotson,2008,2008,Southern Mississippi,CUSA,29,321,36,63,36,63,0,0,14,30,54,49,103,1,6,7,14,66,86
15437,Devonaire Doutrive,2019,2019,Arizona,Pac-12,26,286,31,68,23,49,8,19,16,28,32,46,78,18,12,1,17,28,86
15438,Ted Friedman,2014,2018,Northern Iowa,MVC,109,774,34,69,32,65,2,4,16,48,57,60,117,22,8,15,29,107,86
15439,Khalil Fuller,2016,2018,North Texas,CUSA,48,374,34,67,34,66,0,1,18,45,35,46,81,3,6,1,28,55,86
15440,Gorjok Gak,2017,2018,Florida,SEC,44,339,37,58,37,58,0,0,12,38,44,49,93,3,4,15,19,49,86
15441,Kurt Hall,2015,2015,Toledo,MAC,32,208,25,53,24,51,1,2,35,42,27,21,48,4,2,0,14,29,86
15442,Brandon Holtz,2008,2009,Illinois State,MVC,41,299,26,68,3,9,23,59,11,14,7,19,26,19,5,1,13,23,86
15443,Brett Jolly,2015,2016,Saint Louis,A-10,48,483,23,76,21,55,2,21,38,54,17,33,50,16,10,18,30,92,86
15444,Simon Krych,2013,2014,Omaha,Summit,45,340,34,69,34,67,0,2,18,42,24,37,61,3,4,8,7,29,86
15445,Douglas Kurtz,2010,2011,Hawaii,WAC,50,364,34,63,34,63,0,0,18,29,31,49,80,4,8,8,35,74,86
15446,Cam Michael,2013,2013,Air Force,MWC,21,208,31,58,13,18,18,40,6,9,6,24,30,16,6,0,7,17,86
15447,Adrian Oliver,2008,2008,Alcorn State,SWAC,23,256,31,62,31,62,0,0,24,38,26,18,44,10,4,1,15,26,86
15448,Sam Perry,2008,2008,Clemson,ACC,28,305,26,60,26,60,0,0,34,51,31,32,63,18,25,8,23,49,86
15449,Tyrone Perry,2019,2019,Lafayette,Patriot,29,354,31,80,15,35,16,45,8,10,4,38,42,24,8,1,18,28,86
15450,Max Portmann,2018,2018,Maryland-Baltimore County,AEC,21,229,33,68,31,63,2,5,18,28,18,21,39,3,3,7,16,39,86
15451,Quasim Pugh,2009,2013,Total,Total,51,387,23,78,18,52,5,26,35,48,5,42,47,41,13,1,34,34,86
15452,Conor Smith,2009,2012,Richmond,A-10,49,266,28,77,11,20,17,57,13,14,5,32,37,10,8,1,15,37,86
15453,Terrell Thompson,2016,2016,Austin Peay,OVC,24,557,29,91,23,69,6,22,22,34,9,32,41,55,18,2,39,58,86
15454,Ricky Torres,2019,2019,Wichita State,AAC,37,563,37,107,33,62,4,45,8,12,11,57,68,90,15,3,37,36,86
15455,Al Turley,2008,2008,Albany (NY),AEC,30,351,32,66,32,66,0,0,22,41,29,40,69,6,6,15,31,54,86
15456,Taylor Walker,2012,2013,Loyola Marymount,WCC,22,356,30,82,19,47,11,35,15,21,11,20,31,15,7,1,35,46,86
15457,Trey Washington III,2016,2016,Wyoming,MWC,27,515,28,86,15,30,13,56,17,25,6,51,57,35,13,0,19,44,86
15458,Bobby Wehrli,2014,2016,Dayton,A-10,54,529,32,67,18,32,14,35,8,15,38,41,79,15,7,10,18,73,86
15459,James Williams,2014,2014,Texas-San Antonio,CUSA,26,308,31,98,11,21,20,77,4,10,3,21,24,13,4,1,17,38,86
15460,Trevon Woods,2015,2016,Long Island University,NEC,36,326,31,108,14,42,17,66,7,12,21,34,55,7,5,5,21,43,86
15461,Nathan Balch,2008,2008,Missouri-Kansas City,Summit,30,369,25,68,7,17,18,51,17,19,6,23,29,21,15,0,27,34,85
15462,David Best,2011,2012,North Carolina Central,Total,43,480,38,70,38,70,0,0,9,29,42,65,107,7,15,29,38,78,85
15463,Abdallah Boune,2010,2011,Texas Southern,SWAC,30,312,29,106,11,25,18,81,9,21,18,31,49,8,12,1,15,22,85
15464,Jacque Brown,2018,2019,North Carolina-Wilmington,CAA,32,313,32,86,24,58,8,28,13,23,4,17,21,36,15,1,25,26,85
15465,Daxton Carr,2019,2019,Cal Poly,Big West,25,444,28,71,11,18,17,53,12,19,12,61,73,12,10,5,13,60,85
15466,Felix Caspari,2009,2009,Idaho State,Big Sky,28,268,33,43,33,43,0,0,19,39,29,42,71,11,4,3,8,36,85
15467,George DeGroat,2009,2009,Hampton,MEAC,28,293,32,67,32,67,0,0,21,29,34,37,71,5,10,14,27,36,85
15468,Mamadou Diarra,2018,2019,Connecticut,AAC,33,320,35,64,35,64,0,0,15,30,32,47,79,0,4,23,14,71,85
15469,Ammanuel Diressa,2013,2014,Tennessee Tech,OVC,43,375,28,90,11,23,17,67,12,18,8,27,35,16,13,1,21,51,85
15470,Charleston Dobbs,2015,2016,Prairie View,SWAC,62,599,35,89,35,88,0,1,15,29,39,68,107,2,8,15,17,109,85
15471,William Douglas,2018,2019,Southern Methodist,AAC,57,648,22,99,7,40,15,59,26,34,31,49,80,40,29,4,42,85,85
15472,Renard Fields,2008,2009,Cleveland State,Horizon,55,367,34,58,34,58,0,0,17,34,31,36,67,5,5,12,15,69,85
15473,Kyle Fitzgerald,2008,2008,Harvard,Ivy,26,284,30,54,30,53,0,1,25,38,18,22,40,7,5,4,18,41,85
15474,Nick Fruendt,2009,2012,Northwestern,Big Ten,72,297,29,72,20,41,9,31,18,23,20,23,43,18,13,4,15,33,85
15475,Windale Glinton,2014,2014,Grambling,SWAC,27,385,36,77,36,75,0,2,13,19,28,39,67,5,11,10,20,84,85
15476,Rashawn Green,2016,2016,Alabama A&M,SWAC,19,248,30,72,8,15,22,57,3,6,3,15,18,9,5,0,9,26,85
15477,Alan Griffin,2019,2019,Illinois,Big Ten,29,234,30,78,16,32,14,46,11,18,23,25,48,12,8,7,27,21,85
15478,Tyler Hamilton,2016,2019,Pennsylvania,Ivy,48,385,28,79,22,51,6,28,23,35,15,41,56,17,20,3,22,68,85
15479,Jamill Harris,2011,2011,Chicago State,GWC,26,316,29,102,26,79,3,23,24,31,8,26,34,40,15,0,33,37,85
15480,Rydell Harris,2010,2011,Grambling,SWAC,45,476,30,83,30,78,0,5,25,49,27,56,83,22,20,2,47,72,85
15481,Thair Heath,2012,2014,Morgan State,MEAC,62,341,37,65,37,65,0,0,11,26,39,47,86,11,10,18,27,87,85
15482,Shawn Hempsey,2009,2012,Air Force,MWC,88,743,33,96,27,58,6,38,13,31,7,76,83,70,26,2,45,59,85
15483,Wesley Johnson,2015,2016,Charleston Southern,Big South,52,458,27,51,27,51,0,0,31,61,38,42,80,7,12,13,15,75,85
15484,Tevian Jones,2019,2019,Illinois,Big Ten,24,217,31,76,18,32,13,44,10,11,17,16,33,5,12,1,4,28,85
15485,Pierre Jordan,2009,2013,Total,ACC,88,692,35,115,26,69,9,46,6,9,9,67,76,53,25,5,49,89,85
15486,Tauriawn Knight,2019,2019,Utah State,MWC,24,211,30,71,27,54,3,17,22,27,6,23,29,20,6,2,22,23,85
15487,Matt Lindsey,2018,2019,Coastal Carolina,Sun Belt,25,383,27,97,8,31,19,66,12,18,7,28,35,18,19,1,21,22,85
15488,Rolando Little,2010,2010,Idaho State,Big Sky,25,393,32,69,32,69,0,0,21,39,25,38,63,8,7,19,21,46,85
15489,Artie Marine,2010,2011,Kennesaw State,A-Sun,42,337,24,80,9,31,15,49,22,38,24,29,53,12,13,1,14,38,85
15490,Treavon Martin,2019,2019,Southern Illinois-Edwardsville,OVC,26,380,35,65,35,65,0,0,15,26,13,52,65,14,10,12,27,70,85
15491,Andre McMillan,2008,2008,Jacksonville,A-Sun,26,,27,93,12,40,15,53,16,19,,,44,20,20,1,22,,85
15492,Anthony Mitchell,2008,2011,Total,Total,32,291,33,88,32,72,1,16,18,31,23,50,73,11,7,8,38,59,85
15493,Glenn Morison,2019,2019,California Baptist,WAC,28,311,32,53,32,53,0,0,21,36,35,43,78,5,5,8,14,56,85
15494,Jordan Oakley,2019,2019,Eastern Kentucky,OVC,22,241,35,71,34,65,1,6,14,34,34,29,63,5,11,7,12,38,85
15495,Gus Okafor,2019,2019,Longwood,Big South,26,271,27,89,12,30,15,59,16,26,22,39,61,8,7,2,20,22,85
15496,Antonio Pope,2009,2009,Southeastern Louisiana,Southland,28,276,38,67,38,67,0,0,9,31,30,40,70,9,12,9,17,41,85
15497,Corey Raley-Ross,2011,2014,Buffalo,MAC,62,398,33,93,30,74,3,19,16,30,16,33,49,33,14,11,41,29,85
15498,Jeremy Sampson,2008,2008,Texas-El Paso,CUSA,30,334,32,77,18,33,14,44,7,16,21,56,77,6,3,12,18,69,85
15499,Charlie Swiggett,2008,2009,Milwaukee,Horizon,40,387,27,97,19,52,8,45,23,36,21,35,56,35,22,2,27,46,85
15500,Mantvydas Urmilevicius,2018,2019,Bryant,NEC,33,302,34,65,34,65,0,0,17,33,37,45,82,14,6,1,16,32,85
15501,Kenith Ward,2008,2009,Georgia Southern,Southern,58,806,34,83,34,83,0,0,17,37,45,65,110,19,17,8,28,125,85
15502,Aldrynn Wardell,2008,2008,McNeese State,Southland,28,253,32,70,32,68,0,2,21,29,31,33,64,10,6,5,25,51,85
15503,Evan Wardlow,2015,2017,Santa Clara,WCC,56,612,31,80,25,62,6,18,17,24,9,50,59,45,14,8,29,57,85
15504,Scott Weaver,2008,2008,Stephen F. Austin,Southland,31,343,28,68,15,29,13,39,16,27,35,49,84,16,7,5,17,36,85
15505,Tyler Williams,2015,2016,Brown,Ivy,37,439,28,103,17,48,11,55,18,27,4,22,26,37,9,0,35,54,85
15506,Michael Wolfe,2014,2017,Total,Total,53,241,27,60,24,44,3,16,28,37,12,21,33,8,4,5,8,22,85
15507,Gary Akbar,2015,2015,Kent State,MAC,32,429,31,68,31,68,0,0,22,50,34,50,84,27,13,8,38,68,84
15508,Khari Jabriel Allen,2019,2019,Alcorn State,SWAC,16,322,27,81,14,28,13,53,17,22,6,23,29,18,7,2,31,25,84
15509,Victor Bafutto,2019,2019,Mercer,Southern,30,238,35,65,35,64,0,1,14,28,26,25,51,1,6,28,20,44,84
15510,Rae-Vonn Banks,2010,2011,Southeast Missouri State,OVC,40,382,34,65,34,65,0,0,16,32,32,38,70,4,14,15,21,85,84
15511,Willem Brandwijk,2015,2017,Siena,MAAC,46,446,29,68,20,47,9,21,17,31,27,60,87,12,23,14,24,59,84
15512,Christian David,2018,2019,Butler,Big East,56,480,30,80,21,38,9,42,15,26,28,49,77,26,16,15,26,55,84
15513,Jonathon Dixon,2008,2008,Prairie View,SWAC,27,254,31,67,17,38,14,29,8,13,18,38,56,7,13,0,24,38,84
15514,Kameron Dunnican,2012,2014,Georgia Southern,Southern,68,594,36,67,36,67,0,0,12,28,36,71,107,13,15,33,44,109,84
15515,Cantavio Dutreil,2019,2019,North Alabama,A-Sun,31,303,32,64,32,64,0,0,20,29,36,72,108,0,8,20,12,57,84
15516,Tre Evans,2018,2018,Fordham,A-10,13,335,29,79,24,50,5,29,21,31,0,31,31,27,11,0,16,34,84
15517,Nate Gehring,2015,2017,Pepperdine,WCC,40,397,36,62,36,62,0,0,12,26,23,62,85,11,11,12,24,45,84
15518,Herbert Graham,2013,2015,Purdue-Fort Wayne,Summit,31,195,29,65,10,14,19,51,7,11,6,31,37,9,10,3,13,19,84
15519,Kieran Hayward,2017,2019,Total,Total,50,382,28,100,3,19,25,81,3,6,12,29,41,16,7,5,17,55,84
15520,Cortlan Henry,2013,2014,Mississippi Valley State,SWAC,50,525,32,97,26,72,6,25,14,17,29,16,45,13,20,0,29,74,84
15521,Desmond Hubert,2012,2015,North Carolina,ACC,113,729,36,73,36,73,0,0,12,53,74,79,153,14,12,48,35,80,84
15522,Billy Ingram,2014,2015,Alabama State,SWAC,31,259,31,80,18,34,13,46,9,16,13,20,33,8,6,2,18,34,84
15523,John Isaac,2012,2012,Louisiana State,SEC,31,441,30,89,22,61,8,28,16,21,8,29,37,33,5,3,30,37,84
15524,Fahim Jenneto,2019,2019,Delaware State,MEAC,13,271,31,74,17,39,14,35,8,14,11,29,40,10,3,5,21,44,84
15525,Horace McGloster,2008,2009,Houston,CUSA,44,341,30,74,22,39,8,35,16,23,26,30,56,13,8,15,7,59,84
15526,Earl McLaurin,2013,2015,Navy,Patriot,62,644,23,73,10,36,13,37,25,40,13,53,66,80,26,2,42,51,84
15527,Daniel Mercer,2009,2010,North Carolina-Wilmington,CAA,45,529,40,65,40,65,0,0,4,20,31,45,76,13,5,2,10,71,84
15528,Tony Neysmith,2008,2012,Total,Total,81,771,36,91,36,85,0,6,12,40,15,63,78,68,32,6,70,56,84
15529,Lassi Nikkarinen,2018,2019,Montana State,Big Sky,53,594,26,67,16,32,10,35,22,32,10,33,43,52,22,0,33,81,84
15530,Jonny Rice,2009,2010,Belmont,A-Sun,40,211,28,67,10,16,18,51,10,11,9,11,20,11,8,0,22,19,84
15531,Andrew Scocca,2013,2016,Bryant,NEC,63,547,27,64,27,63,0,1,30,45,37,76,113,25,4,15,26,84,84
15532,Jachai Simmons,2018,2018,New Mexico,MWC,25,341,33,81,19,38,14,43,4,8,14,27,41,18,18,7,14,29,84
15533,Marquill Smith,2016,2017,San Francisco,WCC,29,174,25,67,8,18,17,49,17,22,4,22,26,8,5,3,10,10,84
15534,Erik Stenger,2013,2014,Xavier,Total,55,440,34,63,34,63,0,0,16,45,40,60,100,8,12,16,22,68,84
15535,Blake Truman,2018,2019,Idaho State,Big Sky,46,386,32,84,18,39,14,45,6,9,21,41,62,13,9,1,24,50,84
15536,Karrington Wallace,2019,2019,Central Connecticut State,NEC,28,379,36,77,35,73,1,4,11,17,24,51,75,8,8,12,19,41,84
15537,D'Angelo West,2016,2019,Total,Total,55,341,26,104,6,20,20,84,12,18,4,22,26,18,4,1,15,31,84
15538,K.C. Whitaker,2012,2012,Alabama-Birmingham,CUSA,30,330,23,103,3,21,20,82,18,23,8,30,38,18,7,0,17,14,84
15539,Kyle White,2008,2008,Delaware State,MEAC,30,471,28,68,24,50,4,18,24,35,19,33,52,41,19,7,36,40,84
15540,Demario Williams,2009,2010,Middle Tennessee,Sun Belt,46,427,30,103,24,77,6,26,18,26,14,47,61,29,17,2,35,38,84
15541,Enosch Wolf,2011,2013,Connecticut,Big East,36,336,40,70,40,70,0,0,4,10,33,54,87,14,8,20,23,55,84
15542,Chuma Awaji,2008,2008,UC-Irvine,Big West,11,181,27,72,19,38,8,34,21,26,4,15,19,6,12,1,13,18,83
15543,Alex Bates,2011,2015,Total,Total,84,827,34,65,34,64,0,1,15,40,58,79,137,13,24,37,34,139,83
15544,Mike Battle,2008,2008,Central Florida,CUSA,19,238,27,63,7,13,20,50,9,13,5,28,33,8,5,0,15,33,83
15545,Mike Broghammer,2010,2012,Notre Dame,Big East,47,251,37,72,36,68,1,4,8,28,29,29,58,10,8,12,13,44,83
15546,Chris Collins,2015,2019,Texas A&M,SEC,72,861,26,109,10,25,16,84,15,21,7,68,75,69,23,4,36,79,83
15547,Mamadou Datt,2012,2013,Duquesne,A-10,44,445,36,80,36,79,0,1,11,30,39,53,92,7,9,5,29,83,83
15548,Mike Davis,2008,2009,Alabama-Birmingham,CUSA,59,716,27,91,17,43,10,48,19,36,19,61,80,25,21,3,36,64,83
15549,T.J. Diop,2012,2013,Seattle,Total,44,356,33,78,33,76,0,2,17,27,23,54,77,14,9,5,28,64,83
15550,Nathan Dodge,2015,2016,Army,Patriot,29,222,28,64,5,7,23,57,4,6,2,19,21,8,13,0,13,17,83
15551,Matt Dorlack,2008,2011,Eastern Illinois,OVC,101,538,31,62,31,62,0,0,21,49,71,62,179,20,8,26,48,94,83
15552,Grehlon Easter,2019,2019,Lamar,Southland,30,310,29,86,15,47,14,39,11,18,12,13,25,16,22,2,12,35,83
15553,Mike Edwards,2009,2009,Sacramento State,Big Sky,18,254,37,63,37,63,0,0,9,14,9,33,42,3,7,19,23,35,83
15554,Jordan Foster,2018,2019,Lamar,Southland,51,373,30,50,30,50,0,0,23,45,35,60,95,5,6,41,36,87,83
15555,Warren Fuselier,2010,2010,Louisiana-Monroe,Sun Belt,23,423,33,90,30,84,3,6,14,25,5,16,21,36,14,0,44,28,83
15556,Nate Garvey,2018,2019,Howard,MEAC,40,237,27,84,6,19,21,65,8,15,3,13,16,13,7,3,9,20,83
15557,Chris Griffin,2011,2014,Total,Total,29,309,27,82,18,48,9,34,20,26,19,52,71,9,14,12,25,25,83
15558,Sam Harris,2008,2008,Old Dominion,CAA,32,334,36,79,36,79,0,0,11,24,17,50,67,12,3,37,26,45,83
15559,Brandon Hassell,2008,2008,Penn State,Big Ten,30,392,31,70,31,69,0,1,21,36,52,43,95,12,17,10,16,50,83
15560,Vincent Hunter,2008,2008,Arkansas,SEC,30,263,27,64,12,23,15,41,14,17,14,39,53,6,8,8,20,36,83
15561,Tyrie Jackson,2018,2018,Virginia Tech,ACC,28,202,25,58,19,34,6,24,27,37,12,30,42,11,7,1,15,22,83
15562,Mike LeBlanc,2015,2018,Princeton,Ivy,59,414,27,90,8,21,19,69,10,13,10,45,55,22,12,4,16,41,83
15563,A.J. Lynch,2013,2016,Total,Total,36,488,30,118,19,68,11,50,12,27,11,34,45,59,16,5,54,39,83
15564,Emmanuel Matey,2014,2015,Morgan State,MEAC,55,595,25,77,23,64,2,13,31,59,12,44,56,91,19,0,57,57,83
15565,Devontae Morgan,2013,2016,Total,Total,54,317,30,65,28,57,2,8,21,52,11,31,42,25,14,5,14,50,83
15566,Adrian Nelson,2019,2019,Northern Kentucky,Horizon,30,251,34,57,34,57,0,0,15,24,28,46,74,10,5,2,20,27,83
15567,Kaylim Noel,2011,2011,Alabama State,SWAC,23,208,29,59,17,31,12,28,13,25,8,20,28,8,4,3,14,13,83
15568,Khadim Samb,2019,2019,Idaho,Big Sky,21,333,27,59,20,45,7,14,22,32,10,40,50,10,7,2,24,42,83
15569,John Robert Simon,2014,2017,Wichita State,MVC,85,323,22,56,9,21,13,35,26,39,8,24,32,36,15,0,23,35,83
15570,Larenz Stalcup,2017,2018,Louisiana,Sun Belt,53,279,31,74,31,74,0,0,21,31,21,38,59,14,6,16,16,65,83
15571,Josh Steel,2016,2017,Duquesne,A-10,31,278,28,60,8,20,20,40,7,10,5,23,28,21,8,0,17,39,83
15572,Darryl Stewart,2018,2018,New Hampshire,AEC,23,310,31,95,19,45,12,50,9,16,7,19,26,28,8,1,29,32,83
15573,Qavotstaraj Waddell,2008,2008,Chattanooga,Southern,25,296,36,62,36,62,0,0,11,28,28,47,75,8,7,12,13,44,83
15574,Chaed Wellian,2013,2014,Tennessee State,OVC,34,265,33,60,19,26,14,34,3,4,8,35,43,4,5,2,13,39,83
15575,Daniel West,2011,2011,Rhode Island,A-10,19,330,19,63,8,24,11,39,34,48,6,36,42,60,20,1,35,37,83
15576,Gregory Womack,2012,2012,Maryland-Eastern Shore,MEAC,26,317,32,88,16,33,16,55,3,7,6,30,36,11,11,1,23,34,83
15577,Carlos Wright,2008,2008,Tennessee-Martin,OVC,30,597,28,96,16,51,12,45,15,25,15,28,43,102,19,2,47,47,83
15578,Eric Anderson,2015,2018,Yale,Ivy,50,359,30,75,25,57,5,18,17,33,19,47,66,12,10,7,16,26,82
15579,Joseph Battle,2017,2019,Total,Total,26,262,25,46,25,46,0,0,32,42,13,22,35,10,5,1,19,30,82
15580,JC Bonny,2014,2014,Troy,Sun Belt,27,303,23,60,15,30,8,30,28,39,8,18,26,8,5,0,26,22,82
15581,E.J. Boyce,2017,2017,San Jose State,MWC,21,272,26,66,3,7,23,59,7,8,0,12,12,13,8,1,10,14,82
15582,K.J. Brown,2011,2013,Binghamton,AEC,31,338,22,76,9,34,13,42,25,42,3,21,24,18,13,0,29,40,82
15583,Ian Carter,2017,2019,Dartmouth,Ivy,31,248,32,68,25,43,7,25,11,23,14,32,46,8,9,6,19,32,82
15584,Samuel Chaput,2019,2019,Monmouth,MAAC,32,399,25,73,22,60,3,13,29,44,2,22,24,31,15,0,25,34,82
15585,Richard Clark,2009,2011,St. Francis (NY),NEC,53,319,29,85,14,37,15,48,9,14,11,33,44,6,4,11,12,29,82
15586,Rodney Culver,2017,2017,Ohio,MAC,31,316,30,67,25,53,5,14,17,31,10,35,45,17,9,6,35,37,82
15587,Pape Diop,2019,2019,Southeastern Louisiana,Southland,27,286,29,59,24,45,5,14,19,30,25,54,79,10,9,2,19,36,82
15588,Cortney Dunn,2008,2011,Boston College,ACC,80,890,31,70,31,70,0,0,20,41,35,97,132,17,7,41,30,114,82
15589,Dominik Fragala,2018,2019,Niagara,MAAC,29,191,26,67,11,21,15,46,15,20,6,7,13,7,3,1,4,13,82
15590,Joe Garza,2017,2018,New Mexico State,WAC,49,365,22,65,4,12,18,53,20,21,1,24,25,18,5,0,19,35,82
15591,Joseph Gripper,2017,2017,Coppin State,MEAC,31,376,25,77,25,68,0,9,32,54,8,26,34,49,22,3,44,47,82
15592,Nick Haywood,2010,2011,Houston,CUSA,50,454,23,90,8,30,15,60,21,33,6,21,27,22,11,0,22,37,82
15593,Josh Huntley,2017,2017,Stephen F. Austin,Southland,32,271,34,69,34,69,0,0,14,21,26,38,64,3,5,4,38,43,82
15594,ChaRunn Jones,2010,2010,Texas-Rio Grande Valley,GWC,27,371,28,87,4,6,24,81,2,2,1,20,21,25,8,0,21,23,82
15595,Abu Kigab,2018,2019,Oregon,Pac-12,45,418,32,86,26,53,6,33,12,27,21,45,66,26,15,7,23,56,82
15596,Aljaz Kunc,2019,2019,Washington State,Pac-12,31,358,30,67,18,33,12,34,10,13,10,45,55,13,13,8,23,48,82
15597,Marcale Lotts,2018,2019,Canisius,MAAC,51,443,37,62,37,62,0,0,8,25,46,41,87,9,6,4,36,84,82
15598,Tom Maayan,2013,2014,Seton Hall,Big East,43,864,30,83,20,48,10,35,12,29,12,56,68,128,52,2,115,89,82
15599,Wade Martin,2016,2019,Louisiana-Monroe,Sun Belt,44,381,29,103,14,42,15,61,9,11,10,40,50,12,5,2,19,31,82
15600,Julian McClurkin,2008,2009,North Carolina A&T,MEAC,34,501,36,77,36,76,0,1,10,24,48,42,90,24,13,11,28,62,82
15601,Ray Murdock,2008,2008,San Diego,WCC,14,321,26,78,14,37,12,41,18,21,13,31,44,20,5,7,21,31,82
15602,Anthony Nelson,2019,2019,Seton Hall,Big East,34,357,30,86,24,66,6,20,16,23,4,29,33,62,12,2,27,29,82
15603,Tyrone Nesby IV,2019,2019,Wagner,NEC,25,287,29,97,11,29,18,68,6,9,12,26,38,9,15,4,10,34,82
15604,Keion Palmer,2011,2011,Jacksonville,A-Sun,23,216,31,56,31,56,0,0,20,36,12,25,37,2,5,26,17,34,82
15605,Isaiah Poor Bear-Chandler,2019,2019,Wichita State,AAC,31,254,30,60,27,51,3,9,19,28,24,35,59,9,4,8,14,36,82
15606,Jarred Vanderbilt,2018,2018,Kentucky,SEC,14,238,29,68,29,67,0,1,24,38,46,64,110,14,6,11,15,37,82
15607,Sergej Vucetic,2016,2017,Evansville,MVC,35,307,28,61,28,61,0,0,26,38,15,38,53,7,1,16,28,48,82
15608,Ibi Watson,2017,2018,Michigan,Big Ten,45,219,31,83,20,34,11,49,9,15,11,18,29,9,9,1,7,11,82
15609,Brendan Adams,2019,2019,Connecticut,AAC,31,394,25,83,13,32,12,51,19,24,11,27,38,22,6,1,13,31,81
15610,Christian Adams,2016,2018,Coastal Carolina,Total,52,536,28,92,24,71,4,21,21,33,9,50,59,27,17,4,46,60,81
15611,Brandon Allen,2012,2012,Alabama A&M,SWAC,19,245,29,76,18,40,11,36,12,22,16,26,42,12,9,2,13,35,81
15612,Cole Bergan,2019,2019,Northern Colorado,Big Sky,26,308,30,56,30,52,0,4,21,36,17,46,63,27,10,13,36,51,81
15613,Jordan Carter,2008,2008,George Mason,CAA,27,454,26,73,15,41,11,32,18,25,8,43,51,45,15,4,35,18,81
15614,Roman Davis,2017,2019,University of California,Pac-12,55,362,31,95,29,85,2,10,17,46,24,69,93,11,5,3,20,60,81
15615,Moriba De Freitas,2013,2013,Pepperdine,WCC,30,584,32,63,32,63,0,0,17,34,56,86,142,21,17,26,31,86,81
15616,Cheick Diallo,2016,2016,Kansas,Big 12,27,202,33,58,33,58,0,0,15,27,17,51,68,1,7,23,17,38,81
15617,Shola Diop,2012,2013,Winthrop,Big South,48,335,33,52,33,51,0,1,15,29,24,36,60,3,5,4,24,39,81
15618,Nick Doyle,2013,2014,Delaware State,MEAC,41,368,33,95,26,61,7,34,8,14,8,24,32,33,3,0,26,21,81
15619,Coleman Edwards,2016,2017,New Orleans,Southland,41,420,27,90,10,34,17,56,10,16,2,33,35,29,13,1,23,64,81
15620,Ahmad Fields,2014,2016,Total,Total,22,190,25,61,19,46,6,15,25,41,10,46,56,11,3,1,14,26,81
15621,Rashawn Fredericks,2019,2019,Cincinnati,AAC,35,358,29,81,21,47,8,34,15,20,29,49,78,8,10,5,12,28,81
15622,Darius Garland,2019,2019,Vanderbilt,SEC,5,139,29,54,18,31,11,23,12,16,2,17,19,13,4,2,15,7,81
15623,Deion Giddens,2012,2015,Cornell,Ivy,67,508,33,62,33,62,0,0,15,23,58,42,100,4,11,30,11,65,81
15624,Jalen Jackson,2017,2017,Tennessee-Martin,OVC,28,256,21,59,7,27,14,32,25,34,4,20,24,34,17,2,25,22,81
15625,Jamar Jenkins,2008,2009,Radford,Big South,36,298,26,80,16,38,10,42,19,31,15,17,32,14,9,4,19,38,81
15626,Robert Knar,2015,2018,Total,Total,52,307,28,66,20,41,8,25,17,21,3,39,42,21,6,0,8,8,81
15627,Marin Kukoc,2012,2012,Pennsylvania,Ivy,33,329,29,78,10,26,19,52,4,6,14,38,52,21,6,4,21,53,81
15628,Ryan Layman,2018,2018,Bryant,NEC,30,429,32,77,20,36,12,41,5,10,20,55,75,10,8,5,19,33,81
15629,Milade Lola-Charles,2009,2012,Hampton,MEAC,80,786,31,87,31,87,0,0,19,42,62,67,129,3,20,36,53,122,81
15630,Steven Miro,2010,2014,Florida International,Total,43,401,27,70,21,53,6,17,21,28,9,30,39,21,14,0,20,34,81
15631,Payton Moore,2019,2019,Rice,CUSA,31,341,27,72,23,46,4,26,23,49,9,27,36,28,14,3,36,41,81
15632,Jimmy Nichols,2019,2019,Providence,Big East,30,346,33,75,28,55,5,20,10,22,25,43,68,15,6,27,24,35,81
15633,Tavian Pomlee,2014,2014,South Dakota,Summit,24,239,29,71,16,27,13,44,10,12,22,23,45,8,16,2,19,34,81
15634,Anthony Pratt,2016,2016,Eastern Kentucky,OVC,29,304,34,52,34,51,0,1,13,28,23,50,73,10,3,12,18,60,81
15635,Danny Puente,2008,2008,Texas-Rio Grande Valley,Ind,31,332,25,64,2,8,23,56,8,9,4,11,15,42,8,2,20,23,81
15636,Colin Russell,2016,2019,Total,Total,78,589,30,75,30,75,0,0,21,50,60,57,117,13,15,7,30,113,81
15637,Jerome Simmons,2014,2015,North Carolina A&T,MEAC,46,401,35,67,35,67,0,0,11,20,27,54,81,2,3,12,16,86,81
15638,Jake Straughan,2016,2017,Idaho,Big Sky,33,182,25,55,1,3,24,52,7,11,0,11,11,8,4,0,5,15,81
15639,Conor Voss,2014,2017,Columbia,Ivy,72,345,29,57,29,57,0,0,23,39,34,50,84,17,4,23,27,47,81
15640,Justin Wesley,2010,2014,Total,Total,95,654,25,61,24,54,1,7,30,57,46,72,118,12,15,20,32,125,81
15641,Ryan Wiersma,2008,2009,Eastern Kentucky,OVC,59,817,34,84,34,83,0,1,13,33,68,73,141,96,35,26,50,111,81
15642,Cole Wilder,2008,2010,Radford,Big South,54,335,19,71,5,24,14,47,29,37,5,22,27,27,8,0,34,43,81
15643,Dylan Alderson,2018,2019,Toledo,MAC,56,540,28,71,17,36,11,35,13,22,16,54,70,29,18,0,28,35,80
15644,Isaiah Anderson,2018,2018,South Carolina Upstate,A-Sun,27,303,35,71,33,64,2,7,8,17,26,41,67,10,10,9,14,40,80
15645,Terry Anderson,2008,2008,Northern Colorado,Big Sky,27,347,26,62,22,45,4,17,24,41,6,37,43,42,22,2,34,51,80
15646,Darren Avery,2008,2009,Middle Tennessee,Sun Belt,37,494,27,74,19,49,8,25,18,32,20,31,51,15,11,0,25,51,80
15647,Cory Calvert,2013,2018,Total,Total,50,375,29,98,21,49,8,49,14,20,9,42,51,40,7,0,29,32,80
15648,Conor Clifford ,2013,2013,UC-Irvine,Big West,32,251,33,67,33,66,0,1,14,19,19,35,54,5,3,15,22,47,80
15649,Brandon Cutler,2011,2011,Stephen F. Austin,Southland,20,212,30,62,30,61,0,1,20,26,20,30,50,6,5,3,13,36,80
15650,Antoine Dade,2008,2008,Texas-San Antonio,Southland,29,385,29,70,29,70,0,0,22,48,47,56,103,6,10,11,30,45,80
15651,Ryan Davis,2019,2019,Vermont,AEC,24,245,31,80,25,52,6,28,12,13,24,20,44,7,1,6,10,39,80
15652,Zach En'Wezoh,2013,2014,Columbia,Ivy,41,334,38,73,38,72,0,1,4,17,23,34,57,16,14,12,30,73,80
15653,Andrew Fleming,2008,2010,Long Beach State,Big West,76,540,34,68,34,68,0,0,12,24,44,75,119,9,5,35,22,89,80
15654,Yannick Formbor,2008,2011,Drexel,CAA,70,461,30,55,30,55,0,0,20,32,37,81,118,14,6,4,22,64,80
15655,Benjamin Fumey,2009,2009,Valparaiso,Horizon,18,283,36,83,35,77,1,6,7,16,20,34,54,5,11,0,25,33,80
15656,Kyle Haber,2015,2017,Brown,Ivy,37,385,27,72,14,31,13,41,13,22,16,28,44,12,12,3,17,21,80
15657,J.J. Hirst,2008,2008,Stetson,A-Sun,31,407,29,65,21,39,8,26,14,22,23,42,65,6,11,8,19,72,80
15658,Glenn Hollaway,2016,2017,Alabama State,SWAC,53,510,33,66,32,59,1,7,13,20,39,60,99,13,3,24,17,71,80
15659,Marquel Ingram,2016,2017,Bethune-Cookman,MEAC,28,348,25,77,11,30,14,47,16,18,11,35,46,21,8,0,28,35,80
15660,Walter Jones,2016,2017,Texas-Rio Grande Valley,WAC,50,562,31,91,25,64,6,27,12,25,28,72,100,31,22,7,40,105,80
15661,Carl Josey,2008,2010,Virginia Military Institute,Big South,65,561,33,85,26,56,7,29,7,18,53,83,136,17,20,6,44,84,80
15662,Grant Leiendecker,2008,2011,Butler,Horizon,67,267,24,86,4,12,20,74,12,15,2,12,14,14,7,3,18,37,80
15663,Leroy Lutu,2009,2010,Hawaii,WAC,46,292,34,78,32,65,2,13,10,26,16,18,34,16,11,0,25,45,80
15664,Keshon Montague,2017,2019,Total,Total,39,488,27,75,9,24,18,51,8,11,2,33,35,36,7,1,22,42,80
15665,Anthony Polite,2018,2019,Florida State,ACC,31,322,26,68,15,22,11,46,17,22,16,33,49,20,19,1,18,39,80
15666,Ryan Preston,2018,2019,Rhode Island,A-10,42,292,36,66,36,63,0,3,8,15,25,52,77,7,10,17,10,51,80
15667,Matt Shamis,2008,2010,Lehigh,Patriot,50,343,30,82,24,66,6,16,14,20,7,24,31,26,5,0,24,30,80
15668,Jamie Smalligan,2008,2008,West Virginia,Big East,37,434,27,89,16,29,11,60,15,21,32,35,67,30,12,2,20,58,80
15669,Justin Smith,2014,2016,Idaho State,Big Sky,47,390,27,72,20,49,7,23,19,30,21,46,67,7,8,3,19,61,80
15670,Cory Stanton,2011,2011,Clemson,ACC,33,351,29,84,21,46,8,38,14,21,6,15,21,25,20,2,21,50,80
15671,Charles Tabet,2009,2010,South Alabama,Sun Belt,46,515,27,61,27,61,0,0,26,44,66,55,121,6,8,22,25,80,80
15672,Jalen Variste,2016,2016,Tennessee-Martin,OVC,28,383,31,78,29,70,2,8,16,28,4,39,43,36,22,0,14,34,80
15673,Brandon Walker,2008,2008,Loyola Marymount,WCC,28,320,25,81,13,36,12,45,18,30,12,32,44,20,9,1,26,25,80
15674,Brian White,2019,2019,Northwestern State,Southland,11,252,30,83,18,43,12,40,8,12,3,12,15,25,11,0,15,18,80
15675,Colby Wollenman,2012,2016,Michigan State,Big Ten,81,442,32,56,32,56,0,0,16,29,32,70,102,26,4,8,30,61,80
15676,Richard Wonnell,2011,2013,Toledo,MAC,82,829,29,57,29,56,0,1,22,44,57,81,138,12,19,13,26,112,80
15677,Torez Young,2010,2010,Grambling,SWAC,19,295,25,80,21,61,4,19,26,38,9,26,35,15,14,0,44,34,80
15678,Justin Ahrens,2019,2019,Ohio State,Big Ten,25,239,25,61,6,12,19,49,10,11,4,40,44,8,6,5,14,23,79
15679,Winslo Barry,2014,2015,Incarnate Word,Southland,47,296,34,74,34,74,0,0,11,40,35,65,100,3,5,16,10,56,79
15680,Michael Boone,2008,2009,UC-Davis,Big West,34,188,30,49,30,49,0,0,19,27,20,25,45,9,1,17,26,42,79
15681,Dawson Carper,2019,2019,Hawaii,Big West,26,210,33,52,33,52,0,0,13,32,18,41,59,8,5,5,16,36,79
15682,Alex Carr,2015,2016,Utah Valley,WAC,58,682,28,105,7,27,21,78,2,9,8,92,100,23,21,4,30,95,79
15683,Paris Carter,2008,2008,New Mexico State,WAC,13,225,25,80,9,21,16,59,13,18,4,18,22,17,7,0,31,27,79
15684,Jalen Crutchfield,2019,2019,Stetson,A-Sun,24,235,28,67,10,16,18,51,5,7,2,20,22,8,1,0,6,17,79
15685,Silvio De Sousa,2018,2018,Kansas,Big 12,20,175,32,47,32,47,0,0,15,21,33,41,74,4,1,3,18,33,79
15686,Drue Drinnon,2019,2019,New Mexico,MWC,27,376,26,65,16,33,10,32,17,31,12,19,31,62,11,2,28,41,79
15687,Asa Duvall,2015,2018,Lipscomb,A-Sun,63,409,25,80,11,25,14,55,15,30,4,31,35,21,8,2,11,21,79
15688,Jermaine Edmonds,2015,2015,Montana,Big Sky,9,225,28,68,15,27,13,41,10,15,1,28,29,12,10,3,9,17,79
15689,Malik Eichler,2017,2018,Detroit Mercy,Horizon,42,307,28,59,19,41,9,18,14,24,14,32,46,1,7,5,13,56,79
15690,Alex Etherington,2015,2015,Indiana State,MVC,26,383,27,75,11,20,16,55,9,15,7,29,36,14,16,1,21,51,79
15691,Austin Fadal,2019,2019,Eastern Washington,Big Sky,21,277,30,98,21,53,9,45,10,16,4,31,35,11,6,0,16,31,79
15692,Rantavious Gilbert,2013,2015,Appalachian State,Total,44,262,32,69,32,69,0,0,15,23,29,34,63,6,4,19,15,36,79
15693,Nick Groce,2010,2011,Maryland-Baltimore County,AEC,30,470,30,76,25,56,5,20,14,16,6,12,18,35,11,0,22,26,79
15694,Jure Gunjima,2015,2015,Purdue-Fort Wayne,Summit,30,243,33,71,25,39,8,32,5,7,10,40,50,13,5,3,14,20,79
15695,Eric Hunter Jr.,2019,2019,Purdue,Big Ten,36,455,27,89,17,43,10,46,15,21,16,34,50,39,13,3,21,37,79
15696,Obi Ikeakor,2009,2010,New Orleans,Sun Belt,30,322,31,62,31,61,0,1,17,21,13,32,45,3,6,4,24,55,79
15697,Kurt Karis,2014,2018,Total,Total,72,595,28,85,28,72,0,13,23,39,22,49,71,53,34,2,45,80,79
15698,Sedee Keita,2017,2019,Total,Total,51,585,30,89,30,87,0,2,19,38,32,71,103,13,16,31,26,89,79
15699,Mark Kostelac,2018,2019,Akron,MAC,37,409,35,69,35,69,0,0,9,16,22,39,61,10,10,15,33,98,79
15700,Fred Landers,2012,2013,North Florida,A-Sun,31,302,31,80,23,49,8,31,9,15,13,30,43,11,6,4,11,39,79
15701,Dan Loney,2011,2013,Western Michigan,MAC,73,443,29,46,29,46,0,0,21,37,42,82,124,15,6,3,26,71,79
15702,Nikola Marijan,2016,2017,South Alabama,Sun Belt,38,414,31,71,31,71,0,0,17,36,37,51,88,8,9,17,39,101,79
15703,Bertrand Nkali,2016,2017,Houston,AAC,55,570,25,49,25,49,0,0,29,50,66,55,121,5,9,56,17,106,79
15704,Jimmy Paige,2015,2016,Siena,MAAC,39,336,24,52,24,43,0,9,31,42,35,33,68,8,6,6,13,30,79
15705,Olamide Pederson,2019,2019,Youngstown State,Horizon,29,353,28,55,26,49,2,6,21,37,36,63,99,6,9,30,21,74,79
15706,Brandon Porter,2019,2019,Wyoming,MWC,31,288,27,73,12,30,15,43,10,15,8,27,35,5,10,3,29,59,79
15707,Jahvon Quinerly,2019,2019,Villanova,Big East,24,228,28,83,16,35,12,48,11,15,2,18,20,22,5,0,19,18,79
15708,Bennie Rhodes,2011,2011,Fresno State,WAC,19,184,28,66,25,46,3,20,20,29,17,23,40,6,4,0,11,24,79
15709,Taylor Rohde,2009,2010,Arizona State,Pac-10,46,339,29,60,28,49,1,11,20,38,19,26,45,7,5,1,13,43,79
15710,Austin Rotroff,2019,2019,Duquesne,A-10,19,252,28,52,25,45,3,7,20,26,16,30,46,4,2,10,13,44,79
15711,Boubacar Sylla,2008,2010,Total,Total,32,313,28,68,28,68,0,0,23,41,29,57,86,2,6,26,25,47,79
15712,Lewis Thomas,2012,2013,UC-Santa Barbara,Big West,52,565,28,88,15,48,13,40,10,18,33,77,110,29,9,14,31,36,79
15713,Travis Trim,2013,2015,Maryland-Eastern Shore,MEAC,72,689,31,92,27,78,4,14,13,30,29,63,92,68,37,4,50,94,79
15714,Calvin Whipple,2019,2019,Fairfield,MAAC,24,333,28,73,7,12,21,61,2,2,10,30,40,10,5,2,6,30,79
15715,Mike Balogun,2014,2014,Southern Illinois,MVC,26,214,24,68,7,11,17,57,13,15,2,12,14,10,4,0,5,15,78
15716,Ngor Barnaba,2017,2017,Utah State,MWC,25,292,29,87,21,49,8,38,12,18,12,56,68,18,3,5,16,34,78
15717,Maciej Bender,2017,2018,West Virginia,Big 12,58,466,31,77,30,68,1,9,15,31,46,51,97,15,11,19,19,57,78
15718,Kyle Brown,2017,2019,Texas A&M-Corpus Christi,Southland,80,676,21,61,18,56,3,5,33,53,12,37,49,62,47,1,62,78,78
15719,David Buchannon,2010,2010,Florida A&M,MEAC,21,250,27,64,15,31,12,33,12,19,4,16,20,26,12,1,33,31,78
15720,Chris Busch,2009,2009,Eastern Washington,Big Sky,18,278,28,75,23,53,5,22,17,35,18,28,46,9,1,13,14,31,78
15721,Remy Cofield,2008,2009,Pennsylvania,Ivy,27,256,22,57,18,36,4,21,30,37,12,17,29,9,12,2,22,27,78
15722,Rogdrick Craig,2008,2009,Texas Tech,Big 12,38,232,32,97,23,57,9,40,5,12,8,25,33,12,7,0,21,37,78
15723,Jamaal David,2018,2018,Charleston Southern,Big South,21,313,24,59,14,30,10,29,20,29,17,37,54,26,7,7,31,25,78
15724,Lawrence Dixon,2008,2009,Holy Cross,Patriot,40,332,30,77,21,54,9,23,9,18,13,30,43,13,11,1,22,40,78
15725,Brandon Durham,2011,2011,Seattle,Ind,27,403,31,60,31,60,0,0,16,42,47,42,89,10,6,7,31,71,78
15726,Scott Friel,2010,2010,Southern Utah,Summit,28,509,30,71,28,60,2,11,16,27,15,45,60,60,23,5,74,36,78
15727,Brendon Ganaway,2017,2018,Southern,SWAC,39,360,21,53,14,36,7,17,29,37,7,12,19,42,10,0,29,39,78
15728,Micah Goss,2017,2017,Norfolk State,MEAC,30,375,28,91,15,40,13,51,9,14,18,14,32,9,5,0,13,44,78
15729,Tanner Groves,2019,2019,Eastern Washington,Big Sky,28,241,30,72,25,59,5,13,13,20,21,39,60,7,2,18,21,57,78
15730,Larry Handy,2008,2009,Arkansas State,Sun Belt,31,232,33,59,33,59,0,0,12,20,20,28,48,8,3,1,20,24,78
15731,Jason Hawthorne,2013,2014,Western Illinois,Summit,39,355,30,67,18,31,12,36,6,13,5,34,39,18,12,1,22,22,78
15732,Russell Hill,2012,2012,Southern,SWAC,22,188,32,93,29,64,3,29,11,14,4,22,26,5,5,2,16,15,78
15733,Brandon Huffman,2018,2019,North Carolina,ACC,55,165,32,57,32,57,0,0,14,28,28,37,65,3,2,11,13,26,78
15734,Kyle Hunt,2011,2011,Middle Tennessee,Sun Belt,19,223,28,58,28,55,0,3,22,35,22,33,55,2,6,3,17,26,78
15735,Louis Johnson,2008,2008,Western Illinois,Summit,25,328,25,68,25,66,0,2,28,41,21,43,64,11,6,3,17,45,78
15736,C.J. Keyser,2017,2018,Wichita State,Total,43,247,26,64,23,47,3,17,23,29,11,20,31,19,8,4,21,48,78
15737,John Knight III,2019,2019,Utah State,MWC,10,177,27,67,26,65,1,2,23,36,6,33,39,12,12,5,15,17,78
15738,Tommy Kurth,2010,2012,Valparaiso,Horizon,44,692,23,67,8,19,15,48,17,30,6,54,60,49,25,2,41,58,78
15739,Shayar Lee,2009,2009,Northern Arizona,Big Sky,24,260,30,73,19,35,11,38,7,14,11,27,38,11,5,2,19,21,78
15740,Mouhammed Lo,2012,2012,Fairleigh Dickinson,NEC,22,308,28,55,28,53,0,2,22,39,16,38,54,15,12,7,26,45,78
15741,C.J. Morgan,2008,2008,Pacific,Big West,27,288,26,73,9,24,17,49,9,12,2,12,14,30,12,0,19,29,78
15742,Lynrick Moxey,2017,2018,Western Illinois,Summit,29,201,31,46,29,44,2,2,14,25,5,34,39,14,9,1,12,9,78
15743,Connor Murrell,2019,2019,Ohio,MAC,25,233,29,80,21,47,8,33,12,21,6,19,25,13,6,2,16,22,78
15744,Rylan Murry,2015,2015,Omaha,Summit,25,251,26,58,12,19,14,39,12,18,12,12,24,8,3,3,9,39,78
15745,Marius Myles,2013,2014,Alcorn State,SWAC,52,616,28,63,28,63,0,0,22,34,41,52,93,11,16,10,21,81,78
15746,Ayoub Nouhi,2019,2019,Texas-Arlington,Sun Belt,31,369,32,68,23,42,9,26,5,15,13,24,37,10,11,2,18,34,78
15747,Ike Obiagu,2018,2018,Florida State,ACC,34,364,33,57,33,57,0,0,12,38,33,54,87,2,7,71,25,60,78
15748,Nathan Parker,2010,2011,Wofford,Southern,38,261,30,64,27,55,3,9,15,23,22,43,65,11,11,7,32,38,78
15749,Brandon Peters,2011,2011,Western Kentucky,Sun Belt,12,279,28,77,21,53,7,24,15,23,8,24,32,23,11,2,28,21,78
15750,Matt Poches,2012,2013,Oakland,Summit,51,381,28,66,28,64,0,2,22,33,12,25,37,25,13,0,27,38,78
15751,Dwayne Polk,2008,2008,Saint Louis,A-10,31,765,27,81,16,42,11,39,13,29,5,47,52,65,17,7,37,48,78
15752,Jahbril Price-Noel,2019,2019,Pacific,WCC,25,353,25,81,19,52,6,29,22,29,7,44,51,32,5,1,32,31,78
15753,Christopher Rozier,2014,2014,Florida A&M,MEAC,27,227,28,106,20,68,8,38,14,20,16,45,61,3,6,6,10,36,78
15754,Carlton Smith,2010,2012,Navy,Patriot,50,300,30,52,30,52,0,0,18,31,31,21,52,3,9,9,12,46,78
15755,Nate Snodgrass,2013,2013,Northern Kentucky,A-Sun,25,434,25,79,6,26,19,53,9,11,5,25,30,32,9,1,17,24,78
15756,Chop Tang,2009,2009,Green Bay,Horizon,9,219,21,80,12,58,9,22,27,33,9,29,38,10,2,3,11,19,78
15757,Taelin Webb,2015,2015,Cal State Northridge,Big West,30,457,27,86,19,64,8,22,16,25,6,24,30,52,12,6,43,40,78
15758,Jalen Weber,2017,2017,Houston Baptist,Southland,29,348,24,69,15,40,9,29,21,29,4,18,22,36,12,0,30,46,78
15759,Boaz Williams,2016,2018,Total,Total,29,210,30,75,22,52,8,23,10,16,15,24,39,7,5,5,22,34,78
15760,Alonzo Young,2008,2008,Sacramento State,Big Sky,21,246,30,69,30,66,0,3,18,39,8,13,21,27,9,3,25,34,78
15761,Kaylan Anderson,2008,2009,Milwaukee,Horizon,48,356,24,65,22,49,2,16,27,44,15,34,49,14,13,2,23,34,77
15762,Corey Anthony,2009,2010,Alcorn State,SWAC,44,407,29,87,22,53,7,34,12,26,18,45,63,12,9,8,29,38,77
15763,Rich Baker,2008,2008,Hartford,AEC,19,403,24,63,6,23,18,40,11,12,10,34,44,29,9,1,31,25,77
15764,John Benkoske,2009,2012,Loyola (IL),Horizon,87,580,24,61,24,61,0,0,29,46,31,67,98,9,6,10,28,91,77
15765,Jalen Brown,2015,2017,Total,Total,61,356,23,70,6,19,17,51,14,28,10,48,58,10,10,4,18,34,77
15766,A.J. Caldwell,2019,2019,Chattanooga,Southern,23,316,28,74,9,22,19,52,2,3,7,33,40,18,5,2,14,26,77
15767,Nai Carlisle,2018,2018,San Jose State,MWC,19,331,26,61,21,49,5,12,20,27,7,28,35,36,9,0,22,34,77
15768,Ivan Cucak,2018,2019,Austin Peay,OVC,40,311,32,58,27,51,5,7,8,16,15,28,43,13,4,9,23,44,77
15769,D.C. Davis,2018,2019,Mississippi,SEC,38,417,24,58,16,29,8,29,21,30,16,33,49,26,10,0,13,27,77
15770,Paris Davis,2016,2016,Southern Utah,Big Sky,23,193,26,55,26,55,0,0,25,39,10,22,32,4,5,1,19,32,77
15771,Deris Duncan,2017,2018,Texas State,Sun Belt,49,313,25,71,16,39,9,32,18,23,16,32,48,12,8,3,15,17,77
15772,Ot Elmore,2016,2018,Total,Total,37,401,24,88,3,15,21,73,8,10,7,28,35,31,7,2,12,28,77
15773,Stephen Elmore,2013,2013,Citadel,Southern,30,411,30,65,29,60,1,5,16,42,22,80,102,20,8,6,36,56,77
15774,Tye Fagan,2019,2019,Georgia,SEC,31,355,32,63,28,51,4,12,9,9,16,31,47,22,6,6,29,14,77
15775,Luis Flores,2010,2013,Northern Arizona,Big Sky,63,312,26,66,11,24,15,42,10,20,8,21,29,19,5,0,23,23,77
15776,Nate Gause,2012,2012,Quinnipiac,NEC,22,229,30,100,18,49,12,51,5,10,8,20,28,5,7,9,10,23,77
15777,Andrew Gordon,2019,2019,West Virginia,Big 12,34,239,30,71,30,71,0,0,17,30,23,36,59,5,6,11,37,56,77
15778,Amari Goulbourne,2018,2019,Alabama A&M,SWAC,25,379,26,75,13,40,13,35,12,23,7,32,39,42,17,1,30,37,77
15779,Freddie Harris,2008,2008,Robert Morris,NEC,34,364,31,55,31,55,0,0,15,25,31,42,73,18,13,4,29,70,77
15780,Juwan Henderson,2015,2018,Alcorn State,SWAC,51,603,26,109,20,65,6,44,19,31,16,46,62,89,37,1,69,66,77
15781,Will Hornsby,2013,2013,Grambling,SWAC,22,440,26,97,19,51,7,46,18,34,11,31,42,48,13,2,57,31,77
15782,Brandon Houston,2018,2019,Alabama A&M,SWAC,37,244,30,72,26,51,4,21,13,16,4,15,19,10,4,0,12,20,77
15783,Willy Isiani,2019,2019,Detroit Mercy,Horizon,10,167,25,59,5,7,20,52,7,9,5,12,17,7,1,0,7,17,77
15784,Tyler Jenkins,2015,2016,Lehigh,Patriot,37,298,26,61,12,26,14,35,11,15,5,17,22,30,14,0,31,45,77
15785,Rob Johnson,2018,2018,Citadel,Southern,25,256,29,59,28,50,1,9,18,33,28,43,71,12,10,13,20,42,77
15786,Emil Kim,2010,2011,UC-Irvine,Big West,48,444,28,67,26,60,2,7,19,30,19,37,56,18,15,1,29,63,77
15787,Jamere King,2008,2008,Centenary (LA),Summit,21,,24,67,11,29,13,38,16,18,,,26,23,10,0,16,,77
15788,Zeldric King,2013,2013,Tulsa,CUSA,21,341,28,47,27,46,1,1,20,31,19,29,48,7,10,1,39,63,77
15789,Jaedon Ledee,2019,2019,Ohio State,Big Ten,26,171,18,47,18,44,0,3,41,55,18,27,45,6,3,6,12,27,77
15790,Jahnathan Maxwell,2019,2019,Iona,MAAC,31,318,29,77,17,27,12,50,7,13,14,43,57,16,10,4,18,51,77
15791,Paul McRoberts,2014,2014,Southeast Missouri State,OVC,13,228,31,56,22,32,9,24,6,13,13,15,28,15,15,3,9,32,77
15792,Holden Mobley,2012,2015,Belmont,Total,100,683,23,56,11,23,12,33,19,29,25,50,75,40,20,0,35,84,77
15793,Badara N'Diaye,2008,2008,Florida International,Sun Belt,27,363,31,96,31,96,0,0,15,32,28,57,85,14,10,21,29,53,77
15794,Ike Ngwudo,2014,2017,Dartmouth,Ivy,51,405,29,71,20,47,9,24,10,21,23,43,66,20,8,9,25,76,77
15795,Collin Nnamene,2019,2019,Mount St. Mary's,NEC,27,316,30,64,29,56,1,8,16,30,28,40,68,4,3,18,25,54,77
15796,Tracy O'Neal,2011,2012,North Carolina Central,Total,48,403,32,62,32,62,0,0,13,27,41,47,88,7,7,22,19,79,77
15797,Umur Peten,2010,2010,Binghamton,AEC,26,368,30,52,25,34,5,18,12,17,19,22,41,7,7,2,19,50,77
15798,Ryan Pettinella,2008,2008,Virginia,ACC,30,412,34,57,34,57,0,0,9,35,39,42,81,5,4,4,21,80,77
15799,Josh Pitts,2018,2019,Cal State Fullerton,Big West,44,256,31,56,31,56,0,0,15,32,31,22,53,6,3,2,18,71,77
15800,Ed Porter,2018,2019,Lehigh,Patriot,29,301,35,59,35,59,0,0,7,9,13,30,43,6,2,6,18,39,77
15801,Jordan Robertson,2012,2014,Total,Southern,30,307,33,69,33,66,0,3,11,23,18,37,55,7,8,7,20,33,77
15802,Adam Rodenberg,2008,2010,Total,Total,42,346,31,67,29,56,2,11,13,26,14,34,48,4,12,2,32,55,77
15803,Haroldas Saprykinas,2015,2016,UC-Irvine,Big West,45,178,23,56,6,15,17,41,14,23,7,14,21,4,2,0,7,10,77
15804,Nate Schulte,2011,2011,Southeast Missouri State,OVC,10,219,26,61,19,39,7,22,18,28,22,33,55,7,5,2,12,21,77
15805,Roosevelt Scott,2015,2015,Arizona State,Pac-12,20,243,27,61,24,45,3,16,20,31,9,33,42,11,12,0,23,32,77
15806,Matt Sellers,2013,2015,Wyoming,MWC,38,280,31,62,31,62,0,0,15,25,19,27,46,11,3,11,22,37,77
15807,Kevin Senghore-Peterson,2018,2019,Fairfield,MAAC,32,385,27,62,21,44,6,18,17,38,25,49,74,11,1,9,17,48,77
15808,Veer Singh,2016,2017,Seton Hall,Big East,39,351,24,85,5,18,19,67,10,15,10,40,50,5,3,1,17,52,77
15809,Damion Squire,2019,2019,UC-Davis,Big West,27,343,20,61,8,30,12,31,25,30,3,29,32,35,6,0,27,30,77
15810,Markus Starks,2013,2014,Chicago State,Total,54,560,30,89,28,84,2,5,15,26,23,71,94,6,6,5,31,69,77
15811,David Swartz,2010,2010,Centenary (LA),Summit,23,246,30,74,18,40,12,34,5,12,13,35,48,10,7,7,20,43,77
15812,Darnell Taylor,2015,2015,Fresno State,MWC,32,485,31,76,24,48,7,28,8,19,18,54,72,43,19,2,21,48,77
15813,Dion Waiters,2012,2012,Jacksonville State,OVC,24,385,22,63,22,50,0,13,33,47,22,42,64,46,29,1,30,46,77
15814,Jamal Watson,2017,2018,Mississippi Valley State,SWAC,38,400,34,89,34,89,0,0,9,27,34,63,97,15,7,7,23,64,77
15815,J.R. Weston,2010,2013,Stetson,A-Sun,51,343,26,81,11,24,15,57,10,21,17,28,45,21,5,2,21,43,77
15816,Jamir Andrews,2016,2017,Albany (NY),AEC,26,188,21,69,10,24,11,45,23,25,3,19,22,10,8,0,14,19,76
15817,Junior Ballard,2019,2019,Cal Poly,Big West,15,222,23,73,11,29,12,44,18,26,5,35,40,8,2,2,15,32,76
15818,James Banks,2017,2018,Texas,Big 12,46,492,30,66,30,66,0,0,16,33,33,72,105,7,9,50,31,77,76
15819,Zach Butler,2018,2018,Ohio,MAC,30,399,30,84,26,64,4,20,12,17,0,45,45,29,14,1,34,31,76
15820,Oliver Caballero,2008,2009,San Jose State,WAC,40,303,26,67,26,67,0,0,24,36,27,23,50,21,7,0,42,59,76
15821,Bryce Cashman,2015,2016,North Dakota,Big Sky,33,399,29,54,29,54,0,0,18,43,32,50,82,6,6,15,29,76,76
15822,Keith Clark,2008,2008,Oklahoma,Big 12,14,214,26,57,17,29,9,28,15,22,7,21,28,11,8,8,18,25,76
15823,David Cole,2018,2019,Robert Morris,NEC,35,348,25,59,25,59,0,0,26,41,26,26,52,3,7,4,21,78,76
15824,Brandon Cooks,2008,2008,Southern Mississippi,CUSA,20,229,31,58,31,58,0,0,14,32,19,38,57,8,6,6,8,19,76
15825,Mike Davis,2008,2008,Mississippi Valley State,SWAC,33,516,24,83,18,66,6,17,22,31,13,26,39,78,26,0,50,31,76
15826,Steve Dulley,2018,2019,Missouri-Kansas City,WAC,30,224,23,74,13,34,10,40,20,33,14,21,35,3,6,2,10,32,76
15827,Eladio Espinosa,2009,2011,Total,Total,41,576,29,70,29,58,0,12,18,36,44,71,115,14,9,11,33,73,76
15828,Zach Evans,2008,2010,Bucknell,Patriot,49,399,29,79,27,72,2,7,16,36,31,69,100,14,11,16,24,51,76
15829,Bryan Gee,2016,2017,Longwood,Big South,52,836,20,77,16,54,4,23,32,51,11,87,98,91,20,1,60,71,76
15830,Patrick Harding,2019,2019,Bryant,NEC,30,525,32,61,32,59,0,2,12,33,41,117,158,28,9,9,32,74,76
15831,Izais Hicks,2016,2017,Coppin State,MEAC,43,431,28,67,28,63,0,4,20,43,42,52,94,8,10,7,16,82,76
15832,Tuukka Jaakkola,2019,2019,Cal Poly,Big West,26,362,31,49,31,49,0,0,14,28,20,39,59,13,5,14,16,46,76
15833,Mahamadou Kaba-Camara,2017,2019,Cal State Northridge,Big West,66,601,35,63,35,63,0,0,6,28,33,76,109,2,8,31,16,120,76
15834,Mathis Keita,2011,2012,Gonzaga,WCC,39,284,29,56,25,41,4,15,14,26,4,33,37,21,16,3,18,27,76
15835,John Kelly,2008,2008,Iona,MAAC,28,272,34,70,34,69,0,1,8,16,33,49,82,11,8,9,31,33,76
15836,Reggie King,2010,2013,Winthrop,Big South,68,593,25,68,23,56,2,12,24,33,13,63,76,47,18,3,32,50,76
15837,Lekheythan Malone,2008,2008,Little Rock,Sun Belt,18,292,23,71,18,52,5,19,25,36,22,46,68,11,9,3,26,38,76
15838,Mark Matthews,2016,2016,North Carolina-Wilmington,CAA,23,204,28,68,20,40,8,28,12,17,12,25,37,13,10,1,11,14,76
15839,Harrison Meads,2018,2018,Pepperdine,WCC,23,300,31,51,31,51,0,0,14,22,18,30,48,1,5,5,11,40,76
15840,Josh Mendenhall,2013,2014,Western Carolina,Southern,45,394,32,70,32,70,0,0,12,17,31,41,72,10,9,19,26,56,76
15841,Abray Milson,2008,2008,Louisiana,Sun Belt,30,482,34,56,34,56,0,0,8,17,35,54,89,11,15,7,24,79,76
15842,Shawn Outen,2008,2008,Charleston Southern,Big South,24,375,31,78,31,78,0,0,14,26,34,41,75,5,10,13,29,54,76
15843,Malik Riddle,2019,2019,Morehead State,OVC,28,247,27,59,26,39,1,20,21,28,11,14,25,7,7,3,15,23,76
15844,Ronaldo Segu,2019,2019,Buffalo,MAC,36,315,29,73,19,45,10,28,8,11,8,23,31,35,6,2,29,28,76
15845,Bakari Smith,2009,2011,Maryland-Baltimore County,AEC,60,789,28,96,28,95,0,1,20,29,19,58,77,40,24,2,55,49,76
15846,Tay Spann,2009,2009,Marshall,CUSA,29,366,27,89,21,64,6,25,16,25,24,46,70,17,11,3,29,56,76
15847,Mitar Stanojevic,2017,2019,Texas-San Antonio,CUSA,47,266,30,60,29,44,1,16,15,26,28,30,58,10,5,1,18,24,76
15848,Anthony Swan,2015,2018,Total,Total,86,382,31,88,17,43,14,45,0,3,15,40,55,21,9,15,18,50,76
15849,Kyle Thomas,2008,2010,Total,Total,34,348,25,69,24,61,1,8,25,52,29,32,61,11,1,5,20,34,76
15850,Andy Van Vliet,2017,2018,Wisconsin,Big Ten,30,179,24,56,9,25,15,31,13,18,10,33,43,5,1,5,7,17,76
15851,Nick Walker,2009,2009,Texas Southern,SWAC,19,256,21,68,10,27,11,41,23,34,4,23,27,19,10,1,20,28,76
15852,J.C. Washington,2015,2015,Houston,AAC,27,457,33,74,31,72,2,2,8,19,36,47,83,11,11,11,19,66,76
15853,Eric Williams,2010,2011,Cal State Fullerton,Big West,49,320,20,49,12,31,8,18,28,33,8,28,36,26,15,1,25,57,76
15854,Kevin Anderson,2008,2008,Fordham,A-10,29,778,20,52,20,43,0,9,35,56,26,44,70,76,29,3,34,64,75
15855,Charlendez Brooks,2015,2018,Western Carolina,Southern,76,621,30,79,30,79,0,0,15,23,33,62,95,32,8,25,41,117,75
15856,Tre Brown,2018,2018,Coastal Carolina,Sun Belt,30,326,29,69,18,42,11,27,6,7,0,22,22,43,10,0,26,42,75
15857,William Brown,2019,2019,Jackson State,SWAC,28,315,26,75,15,53,11,22,12,31,2,21,23,18,15,1,25,38,75
15858,Rashawn Browne,2016,2016,New Mexico State,WAC,34,408,20,63,11,30,9,33,26,38,2,40,42,36,9,1,26,33,75
15859,Daniel Edozie,2014,2015,Iowa State,Big 12,40,286,25,43,25,43,0,0,25,39,33,44,77,8,5,9,9,36,75
15860,Myron Green,2010,2010,Ball State,MAC,27,394,21,74,15,52,6,22,27,37,17,27,44,18,5,1,21,28,75
15861,Myles Holley,2010,2010,Nebraska,Big 12,22,202,31,72,31,68,0,4,13,24,12,32,44,8,7,8,13,27,75
15862,Ugur Hortum,2016,2016,Grambling,SWAC,27,410,26,79,20,59,6,20,17,27,16,53,69,11,5,4,26,49,75
15863,Marcellus Jackson,2012,2012,Prairie View,SWAC,26,258,30,80,29,78,1,2,14,32,27,36,63,8,9,8,30,30,75
15864,Deante Johnson,2019,2019,Cleveland State,Horizon,29,469,31,91,31,84,0,7,13,31,37,80,117,23,15,16,29,45,75
15865,Ivan Johnson,2011,2011,Alabama State,SWAC,25,301,20,96,15,61,5,35,30,46,7,30,37,17,20,5,22,24,75
15866,Logan Jones,2009,2009,Valparaiso,Horizon,29,346,23,82,16,58,7,24,22,33,8,25,33,42,17,1,35,50,75
15867,Jesse Little,2018,2019,American,Patriot,31,451,30,54,29,48,1,6,14,28,35,44,79,20,11,21,25,65,75
15868,Dex Manswell,2008,2008,Missouri State,MVC,32,399,33,64,33,64,0,0,9,16,29,69,98,10,23,39,30,54,75
15869,Joshua Mason,2012,2013,Alabama State,SWAC,37,391,30,90,30,79,0,11,15,33,24,30,54,25,14,1,45,18,75
15870,Mason Maynard,2008,2008,Loyola Marymount,WCC,25,215,31,67,31,66,0,1,13,18,11,29,40,5,6,6,14,55,75
15871,Aalim Moor,2010,2013,San Jose State,WAC,65,359,32,73,22,49,10,24,1,3,3,22,25,29,10,3,21,40,75
15872,Zion Morgan,2017,2017,Nevada-Las Vegas,MWC,26,316,27,62,22,46,5,16,16,32,18,17,35,21,17,2,15,33,75
15873,Hugo Naurais,2012,2015,Wagner,NEC,67,457,32,93,27,62,5,31,6,17,36,72,108,8,13,14,32,67,75
15874,Ayotunde Oyeniyi,2011,2012,Fairleigh Dickinson,NEC,43,377,28,66,28,66,0,0,19,26,25,67,92,6,11,20,29,63,75
15875,Alvin Pegues,2009,2009,Bethune-Cookman,MEAC,30,517,23,73,23,70,0,3,29,48,18,37,55,44,42,2,44,34,75
15876,Paulius Ritter,2008,2008,Southern Methodist,CUSA,28,390,30,62,30,60,0,2,15,33,47,57,104,10,8,5,36,82,75
15877,Luke Rosinski,2017,2019,New Hampshire,AEC,54,435,25,71,24,68,1,3,24,46,46,68,114,12,9,7,31,53,75
15878,Stan Simpson,2010,2013,Total,Total,52,307,30,78,30,76,0,2,15,20,28,28,56,6,3,23,24,69,75
15879,Dante Treacy,2019,2019,Robert Morris,NEC,31,455,26,60,17,35,9,25,14,23,6,27,33,49,12,3,44,46,75
15880,Josh Turner,2012,2012,Niagara,MAAC,22,236,24,80,10,34,14,46,13,22,17,22,39,11,15,3,10,23,75
15881,Jake Verhagen,2014,2015,Eastern Illinois,OVC,47,342,27,72,6,11,21,61,0,0,7,32,39,11,12,7,4,30,75
15882,Sherron Wilson,2015,2017,Total,Total,46,436,25,99,15,59,10,40,15,25,22,32,54,23,13,2,25,58,75
15883,Jerome Alexander,2013,2014,Navy,Patriot,28,245,32,83,32,82,0,1,10,18,15,16,31,5,5,2,16,43,74
15884,Kevin Allen,2015,2015,Boise State,MWC,21,164,30,47,30,47,0,0,14,23,10,26,36,1,2,1,11,29,74
15885,Chance Anderson,2017,2019,Total,Total,47,315,32,58,32,53,0,5,10,20,29,61,90,9,9,10,21,70,74
15886,Jacobby Anderson,2012,2012,Chicago State,GWC,26,371,25,88,5,17,20,71,4,4,14,21,35,14,9,1,23,30,74
15887,Celio Araujo,2018,2019,Maine,AEC,55,825,19,62,9,26,10,36,26,34,4,50,54,88,35,3,51,70,74
15888,Keith Armstrong,2012,2015,Total,Total,54,461,32,74,32,74,0,0,10,27,37,42,79,4,16,5,18,63,74
15889,Chris Barnes,2017,2019,Total,Total,46,353,26,76,26,68,0,8,22,32,8,47,55,15,5,1,27,29,74
15890,Davis Bowne,2008,2008,Appalachian State,Southern,31,488,32,76,32,76,0,0,10,26,30,70,100,32,7,6,36,48,74
15891,Anthony Brown,2016,2016,Green Bay,Horizon,29,324,22,53,16,41,6,12,24,36,5,32,37,19,15,0,19,32,74
15892,Ountae Campbell,2016,2019,Total,Total,31,554,28,75,19,35,9,40,9,17,24,52,76,27,18,4,22,40,74
15893,Michael Chandler,2015,2016,Southern Illinois-Edwardsville,OVC,47,451,34,54,34,53,0,1,6,21,50,43,93,9,7,58,9,58,74
15894,Ray Ray Chase,2011,2011,Southern,SWAC,27,360,25,51,25,51,0,0,24,45,19,49,68,11,8,12,24,38,74
15895,Mate Colina,2019,2019,Hawaii,Big West,27,209,29,47,29,47,0,0,16,22,12,28,40,4,3,5,15,37,74
15896,Jon Ander Cuadra,2016,2019,Campbell,Big South,23,125,29,46,24,34,5,12,11,18,10,26,36,3,2,5,9,16,74
15897,Jayde Dawson,2014,2014,Fairleigh Dickinson,NEC,29,219,26,79,19,45,7,34,15,26,7,23,30,15,8,0,23,33,74
15898,Sam Fernley,2009,2012,Fairleigh Dickinson,NEC,63,590,22,82,4,17,18,65,12,18,9,41,50,34,12,1,21,61,74
15899,K.J. Gilmore,2018,2018,Little Rock,Sun Belt,27,334,31,99,28,82,3,17,9,10,9,20,29,26,5,2,24,25,74
15900,LeVentrice Gray,2011,2011,Jacksonville State,OVC,30,347,24,48,24,47,0,1,26,36,20,33,53,6,4,9,11,59,74
15901,Nick Hinton,2012,2013,Texas State,Total,43,341,30,95,23,74,7,21,7,21,17,30,47,7,6,11,31,72,74
15902,Geoff Hogan,2009,2011,Tulane,CUSA,69,548,29,87,26,67,3,20,13,18,31,35,66,10,8,6,16,58,74
15903,Zach House,2009,2012,Total,Total,55,460,28,79,28,79,0,0,18,34,31,69,100,7,9,37,27,80,74
15904,Michael Hutchins,2015,2015,Alabama A&M,SWAC,29,436,25,71,16,33,9,38,15,20,20,48,68,18,4,5,16,73,74
15905,Justin Johnson,2019,2019,Jackson State,SWAC,25,315,33,87,33,81,0,6,8,16,16,46,62,13,7,4,25,38,74
15906,Chase Kammerer,2011,2014,Air Force,MWC,59,373,25,59,23,48,2,11,22,42,26,37,63,32,10,7,25,58,74
15907,Diyaaldin Kelley,2011,2011,Maryland-Eastern Shore,MEAC,22,257,30,60,30,60,0,0,14,28,17,38,55,1,8,14,30,71,74
15908,Marcus King-Stockton,2008,2008,Colorado,Big 12,30,530,29,57,29,55,0,2,16,42,31,68,99,20,13,47,27,86,74
15909,Shane Lawal,2008,2008,Oakland,Summit,26,335,33,59,33,59,0,0,8,22,63,32,95,13,12,34,18,57,74
15910,Matt McFadden,2009,2010,William & Mary,CAA,28,355,31,77,21,38,10,39,2,11,6,23,29,23,10,2,32,16,74
15911,Sead Odzic,2008,2009,Illinois State,MVC,50,628,25,62,23,43,2,19,22,33,10,36,46,56,12,1,44,72,74
15912,Jan Petrovcic,2012,2013,Southeastern Louisiana,Southland,43,605,30,84,29,76,1,8,13,35,73,89,162,23,24,13,43,73,74
15913,Darelle Porter,2017,2017,St. Francis (NY),NEC,26,267,27,85,19,52,8,33,12,19,21,37,58,8,15,10,15,35,74
15914,Andrew Rebol,2011,2011,Centenary (LA),Summit,29,334,23,57,23,56,0,1,28,41,23,42,65,10,13,16,26,80,74
15915,Tyler Reynolds,2011,2011,Fairleigh Dickinson,NEC,28,387,28,106,16,46,12,60,6,15,15,23,38,19,6,2,12,32,74
15916,Roland Robins,2008,2008,Texas Southern,SWAC,18,,33,73,32,70,1,3,7,17,24,38,62,10,3,1,12,35,74
15917,Lazaro Rojas,2018,2019,Fresno State,MWC,35,237,27,52,27,51,0,1,20,32,21,39,60,6,5,11,27,30,74
15918,Chad Rykhoek,2017,2017,Memphis,AAC,15,212,31,57,31,55,0,2,12,34,12,22,34,11,5,8,16,38,74
15919,Branden Sheppard,2016,2016,Louisiana Tech,CUSA,31,411,35,52,35,52,0,0,4,18,33,42,75,8,10,7,17,44,74
15920,Josh Soto,2013,2013,Louisiana,Sun Belt,27,285,25,74,9,30,16,44,8,17,10,28,38,4,7,1,14,35,74
15921,Ryan Sterling,2008,2011,Loyola (IL),Horizon,59,225,25,80,11,32,14,48,10,14,5,17,22,11,9,2,19,13,74
15922,Malik Toppin,2016,2016,Central Connecticut State,NEC,23,227,32,59,32,58,0,1,10,19,16,29,45,5,3,17,9,36,74
15923,Matt Turner,2018,2018,Santa Clara,WCC,18,218,23,77,5,24,18,53,10,18,3,7,10,14,1,2,8,28,74
15924,Antonio Vrankovic,2016,2019,Duke,ACC,49,269,28,47,28,47,0,0,18,31,37,41,78,18,3,12,17,45,74
15925,Taylor Wagener,2010,2013,Wofford,Southern,60,264,19,56,2,7,17,49,19,29,6,31,37,17,12,2,25,27,74
15926,Jake Wasko,2009,2010,Maryland-Baltimore County,AEC,46,582,31,73,31,73,0,0,12,27,39,61,100,22,8,22,26,102,74
15927,Morakinyo Williams,2008,2011,Total,Total,38,363,31,82,31,82,0,0,12,22,35,54,89,7,3,5,28,49,74
15928,Rahim Williams,2017,2017,Youngstown State,Horizon,21,352,26,73,20,47,6,26,16,24,9,33,42,15,8,13,25,17,74
15929,Kobe Wilson,2017,2019,Alcorn State,SWAC,60,627,27,72,22,47,5,25,15,33,48,118,166,27,23,24,33,58,74
15930,Szymon Wojcik,2019,2019,Missouri State,MVC,14,209,27,67,17,28,10,39,10,11,8,39,47,4,4,12,20,30,74
15931,Kene Anusionwu,2009,2010,Bethune-Cookman,MEAC,49,351,29,57,29,57,0,0,15,29,35,44,79,2,2,17,11,42,73
15932,Dante Bailey,2017,2017,Tennessee-Martin,OVC,29,223,24,68,9,17,15,51,10,14,7,23,30,8,2,2,10,21,73
15933,Tyrone Brown,2012,2012,Georgia Southern,Southern,30,246,32,53,32,53,0,0,9,14,17,18,35,5,6,6,20,28,73
15934,Sterling Christy,2016,2017,Radford,Big South,37,460,27,84,23,62,4,22,15,27,32,68,100,31,9,13,35,63,73
15935,Aron Cohen,2008,2008,Pennsylvania,Ivy,26,395,21,71,6,20,15,51,16,20,5,39,44,42,13,0,38,28,73
15936,Austin Cox,2015,2016,Arkansas-Pine Bluff,SWAC,42,337,27,57,19,34,8,23,11,17,16,45,61,10,19,3,23,23,73
15937,Jonathan DeWane,2017,2018,Air Force,MWC,31,134,26,50,19,37,7,13,14,20,8,22,30,7,5,3,4,15,73
15938,Marcus Fillyaw,2014,2014,Southern Illinois,MVC,21,470,28,64,19,34,9,30,8,11,8,31,39,48,24,2,29,40,73
15939,Bradley George,2017,2017,Denver,Summit,30,289,27,52,17,32,10,20,9,14,8,17,25,25,5,2,30,26,73
15940,Donald Gipson,2017,2019,Loyola Marymount,WCC,42,324,29,100,20,51,9,49,6,10,12,33,45,24,16,5,21,44,73
15941,Shannon Givens,2010,2010,Drexel,CAA,27,253,28,64,17,40,11,24,6,13,2,25,27,18,7,1,13,21,73
15942,Andres Iarrazabel,2008,2009,Tennessee-Martin,OVC,46,502,26,63,26,63,0,0,21,42,41,51,92,20,7,17,16,53,73
15943,Phillip Johnson,2014,2017,Incarnate Word,Southland,93,537,28,68,25,55,3,13,14,23,10,34,44,15,10,4,23,46,73
15944,Anthony Mack,2019,2019,Miami (FL),ACC,28,431,26,88,8,23,18,65,3,4,6,23,29,19,12,4,14,28,73
15945,Christian Negron,2018,2019,Loyola (IL),MVC,46,261,28,58,28,58,0,0,17,31,16,54,70,10,6,5,20,37,73
15946,Nate Perry,2011,2012,Youngstown State,Horizon,35,258,23,65,5,14,18,51,9,14,5,18,23,14,8,0,20,33,73
15947,Jacolby Satterwhite,2008,2008,Prairie View,SWAC,25,345,24,59,23,54,1,5,24,42,5,27,32,49,32,3,46,42,73
15948,Ryan Schrotenboer,2010,2012,Wagner,NEC,57,408,32,57,32,56,0,1,9,17,21,44,65,15,7,3,25,50,73
15949,Stan Scott,2018,2019,Oakland,Horizon,43,302,29,61,29,61,0,0,15,23,13,41,54,26,15,6,39,32,73
15950,Landon Shipley,2009,2009,Illinois State,MVC,23,186,19,48,4,11,15,37,20,26,0,17,17,23,8,2,14,15,73
15951,Avery Sullivan,2018,2019,Lamar,Southland,43,304,27,58,27,56,0,2,19,32,31,36,67,10,16,5,22,54,73
15952,Cole Swider,2019,2019,Villanova,Big East,21,201,24,64,11,18,13,46,12,19,10,16,26,12,3,1,9,26,73
15953,Ali Tew,2016,2017,Niagara,MAAC,52,366,27,73,27,73,0,0,19,44,39,44,83,3,6,21,35,66,73
15954,Stephen Vassor,2016,2018,Old Dominion,CUSA,65,385,31,50,31,50,0,0,11,14,30,48,78,12,4,6,21,72,73
15955,Bronson Verhines,2014,2014,Southern Illinois,MVC,27,366,32,61,32,61,0,0,9,16,23,53,76,8,6,8,13,59,73
15956,Andre Wilkins,2008,2010,Cornell,Ivy,60,304,30,71,30,69,0,2,13,23,25,30,55,5,16,3,24,26,73
15957,C.J. Williams,2016,2016,Stephen F. Austin,Southland,31,299,27,62,27,61,0,1,19,38,22,61,83,31,8,1,28,45,73
15958,Phillip Adams,2008,2009,South Carolina State,MEAC,27,342,25,76,19,47,6,29,16,27,13,37,50,22,11,2,1,49,72
15959,Nigel Ajere,2010,2010,Cleveland State,Horizon,12,190,27,66,27,66,0,0,18,22,12,36,48,6,10,5,16,31,72
15960,Braeden Anderson,2013,2016,Total,Total,46,466,18,65,18,64,0,1,36,59,33,58,91,7,9,6,21,72,72
15961,Tramar Beaman,2011,2012,North Carolina Central,Total,49,252,21,54,8,20,13,34,17,24,10,17,27,16,16,3,18,20,72
15962,T.J. Berry,2011,2011,Houston Baptist,GWC,10,170,24,48,12,20,12,28,12,19,10,11,21,4,6,1,7,16,72
15963,Shaquille Boga,2012,2012,Milwaukee,Horizon,32,265,29,88,23,71,6,17,8,18,5,35,40,37,15,1,34,22,72
15964,Matt Brennan,2008,2009,Coastal Carolina,Big South,40,325,31,53,30,49,1,4,9,22,21,44,65,12,11,19,16,31,72
15965,Gabe Brown,2019,2019,Michigan State,Big Ten,31,242,23,56,7,16,16,40,10,13,9,24,33,4,2,4,2,14,72
15966,Nathan Clark,2008,2009,UC-Davis,Big West,49,443,27,84,18,40,9,44,9,12,11,25,36,14,4,1,20,30,72
15967,Ben Daniels,2011,2011,Houston Baptist,GWC,20,288,25,75,10,22,15,53,7,11,19,37,56,9,7,2,19,28,72
15968,Justin Dotson,2014,2015,Stephen F. Austin,Southland,40,201,23,75,16,39,7,36,19,31,12,30,42,12,13,3,21,29,72
15969,Zach Elcano,2013,2015,American,Patriot,48,443,28,57,28,57,0,0,16,30,13,41,54,24,7,14,39,57,72
15970,Brandon Evans,2008,2009,Longwood,Ind,42,257,26,45,26,45,0,0,20,35,34,45,79,5,12,38,14,36,72
15971,Caleb Fuller,2019,2019,UC-Davis,Big West,24,293,26,61,19,39,7,22,13,18,7,42,49,15,6,2,22,27,72
15972,Parrish Grant,2010,2010,La Salle,A-10,25,438,23,57,12,19,11,38,15,26,2,28,30,44,13,2,32,29,72
15973,Isaiah Hart,2019,2019,Austin Peay,OVC,20,274,25,67,10,23,15,44,7,12,7,20,27,16,11,2,11,34,72
15974,Sammy Hernandez,2008,2009,Florida Atlantic,Sun Belt,45,456,31,78,30,65,1,13,9,17,41,53,94,22,8,4,23,58,72
15975,Pierce Hibma,2008,2008,Creighton,MVC,33,418,29,76,18,33,11,43,3,6,26,21,47,11,11,1,8,37,72
15976,Jacob Holland,2019,2019,Detroit Mercy,Horizon,26,247,25,70,19,52,6,18,16,29,14,13,27,4,9,3,15,27,72
15977,Ben Kone,2017,2018,Oregon State,Pac-12,39,385,23,86,16,63,7,23,19,28,21,61,82,5,7,4,28,60,72
15978,Jeff Laidig,2013,2016,Belmont,OVC,124,689,18,84,5,22,13,62,23,27,20,74,94,37,17,6,27,89,72
15979,Grant Leach,2016,2017,Missouri-Kansas City,WAC,45,368,23,62,5,10,18,52,8,12,2,19,21,14,6,0,10,38,72
15980,Troy Long,2011,2011,Southern Illinois,MVC,19,263,24,85,8,28,16,57,8,11,3,17,20,9,6,1,13,18,72
15981,Jesse Lopez,2014,2017,Sam Houston State,Southland,51,236,27,57,24,48,3,9,15,21,21,32,53,9,5,6,9,31,72
15982,Spencer Mathis,2015,2016,Northern Colorado,Big Sky,32,345,28,74,26,61,2,13,14,29,22,34,56,17,6,6,15,63,72
15983,Quate McKinzie,2017,2017,Buffalo,MAC,17,260,28,44,19,27,9,17,7,11,19,53,72,10,7,12,9,44,72
15984,David Mitchell,2019,2019,Brown,Ivy,31,406,25,67,23,42,2,25,20,31,22,55,77,20,15,3,18,84,72
15985,Lazar Nikolic,2018,2018,Colorado,Pac-12,31,480,27,71,19,37,8,34,10,21,11,61,72,30,9,5,28,59,72
15986,Eividas Petrulis,2011,2014,Saint Mary's (CA),WCC,57,176,23,56,5,10,18,46,8,14,6,17,23,11,2,0,18,11,72
15987,Nevell Provo,2016,2018,Loyola (MD),Patriot,59,501,26,102,11,32,15,70,5,8,8,30,38,38,15,2,30,51,72
15988,Jorge Redmon,2012,2012,Texas-Arlington,Southland,11,184,24,60,9,25,15,35,9,15,3,11,14,20,11,0,13,17,72
15989,Chandler Savage,2013,2014,Arkansas-Pine Bluff,SWAC,43,550,26,63,26,53,0,10,20,33,10,50,60,34,34,2,33,47,72
15990,Drejon Scott,2010,2010,NJIT,GWC,11,292,24,89,8,28,16,61,8,13,6,21,27,19,7,0,20,12,72
15991,Tariq Silver,2019,2019,Eastern Michigan,MAC,22,207,27,61,14,28,13,33,5,15,2,13,15,8,8,1,13,20,72
15992,Wes Slajchert,2019,2019,Dartmouth,Ivy,30,390,24,67,11,24,13,43,11,14,4,22,26,26,16,5,22,40,72
15993,Richie Spiller,2014,2014,Florida A&M,MEAC,29,331,22,73,12,45,10,28,18,30,11,21,32,33,22,5,37,56,72
15994,DeUndrae Spraggins,2008,2008,Utah State,WAC,27,358,21,59,12,25,9,34,21,29,6,21,27,30,21,2,26,41,72
15995,Ronald Strother Jr.,2016,2017,Mississippi Valley State,SWAC,48,339,28,88,22,54,6,34,10,17,19,24,43,5,8,12,17,20,72
15996,Rob Thomas,2008,2008,Bucknell,Patriot,16,295,30,63,24,48,6,15,6,14,15,23,38,17,7,2,21,37,72
15997,Amara Thompson,2010,2012,Total,Total,37,299,26,55,24,48,2,7,18,37,11,33,44,40,8,3,50,29,72
15998,Elijah Watson,2015,2015,Texas-Rio Grande Valley,WAC,29,581,24,61,24,52,0,9,24,51,10,37,47,89,19,1,48,66,72
15999,Greg White-Pittman,2015,2017,North Texas,CUSA,49,305,19,59,19,48,0,11,34,68,8,13,21,11,10,0,23,48,72
16000,Chris Whitehead,2014,2014,Fordham,A-10,29,343,28,55,28,54,0,1,16,28,16,21,37,29,16,4,19,36,72
16001,Jasen Williams,2008,2008,Rice,CUSA,7,186,21,60,12,31,9,29,21,26,0,16,16,18,7,1,23,16,72
16002,Osa Wilson,2019,2019,Southern,SWAC,21,218,30,57,30,56,0,1,12,20,31,32,63,7,11,5,23,38,72
16003,Mubashar Ali,2018,2019,Southern,SWAC,26,182,23,56,23,55,0,1,25,39,16,30,46,3,2,7,17,26,71
16004,Rashed Anthony,2015,2018,Total,Total,119,779,27,50,27,50,0,0,17,25,38,73,111,13,13,34,40,186,71
16005,John Baker,2014,2015,Incarnate Word,Southland,38,256,25,53,25,53,0,0,21,31,18,41,59,0,4,2,6,27,71
16006,Steven Beo,2017,2019,Total,Total,34,376,26,69,16,35,10,34,9,22,9,35,44,27,11,0,16,41,71
16007,Shawn Bowen,2008,2010,Stetson,A-Sun,76,537,25,89,13,45,12,44,9,18,24,45,69,27,11,0,34,46,71
16008,Marius Chawa,2009,2010,Savannah State,Ind,26,310,26,61,24,51,2,10,17,33,18,29,47,5,12,1,17,48,71
16009,Jalon Clark,2019,2019,Texas A&M-Corpus Christi,Southland,26,215,29,60,27,48,2,12,11,23,12,26,38,9,5,0,19,16,71
16010,Corey Copeland,2011,2012,Missouri State,MVC,51,385,27,84,15,38,12,46,5,9,3,33,36,18,5,2,11,24,71
16011,Lu Dovonou,2008,2009,Gardner-Webb,Total,38,286,27,56,27,52,0,4,17,33,29,34,63,13,3,4,31,61,71
16012,Kevaughn Ellis,2019,2019,Florida Atlantic,CUSA,30,381,25,79,10,27,15,52,6,9,13,34,47,17,8,6,19,51,71
16013,Anthony Estes,2012,2012,North Carolina A&T,MEAC,23,172,29,64,24,55,5,9,8,12,17,21,38,4,4,4,24,34,71
16014,Karim Ezzeddine,2019,2019,New Mexico,MWC,17,291,24,58,21,40,3,18,20,27,26,36,62,15,10,10,24,39,71
16015,Trevor Fuller,2011,2011,San Diego,WCC,22,266,30,65,30,65,0,0,11,19,16,28,44,3,2,15,15,32,71
16016,Shandon Goldman,2017,2019,Total,Total,25,298,23,68,14,36,9,32,16,31,17,49,66,13,3,11,20,41,71
16017,Austin Grandstaff,2016,2018,Total,Total,30,265,25,88,6,14,19,74,2,4,3,13,16,16,5,1,18,17,71
16018,Elijah Harkless,2019,2019,Cal State Northridge,Big West,19,257,20,49,17,39,3,10,28,55,8,37,45,38,16,2,31,39,71
16019,Dante Harvey,2009,2010,Chattanooga,Southern,42,305,27,80,23,51,4,29,13,28,18,39,57,8,8,4,28,54,71
16020,Tim Hasbargen,2015,2017,Cleveland State,Horizon,40,271,23,56,12,23,11,33,14,19,11,23,34,11,9,1,15,19,71
16021,Allen Hester,2008,2008,Ohio,MAC,27,341,25,87,13,31,12,56,9,16,6,24,30,16,17,1,17,25,71
16022,Travis Hester,2015,2015,Saint Peter's,MAAC,20,165,21,54,0,3,21,51,8,8,3,13,16,11,1,1,13,9,71
16023,Isaiah Jackson,2008,2008,Texas A&M-Corpus Christi,Southland,23,308,22,62,19,49,3,13,24,32,11,27,38,8,9,6,29,38,71
16024,Jordan Jackson,2015,2016,Florida A&M,MEAC,40,470,28,77,28,77,0,0,15,31,32,57,89,11,6,11,35,65,71
16025,Tony Jackson,2018,2018,Missouri-Kansas City,WAC,20,265,24,64,8,16,16,48,7,12,9,24,33,8,10,6,10,36,71
16026,Shimeek Johnson,2010,2010,Fairfield,MAAC,29,333,30,80,22,46,8,34,3,12,16,52,68,12,9,6,13,29,71
16027,Charles Jones Jr,2019,2019,Utah,Pac-12,27,319,25,71,11,26,14,45,7,13,3,21,24,18,6,0,20,26,71
16028,Milos Klimovic,2008,2008,Binghamton,AEC,17,248,25,75,6,14,19,61,2,4,7,17,24,9,4,1,6,18,71
16029,Yasin Kolo,2012,2014,Total,Total,17,162,23,48,19,35,4,13,21,31,14,24,38,4,4,5,14,15,71
16030,Mike Kurtz,2011,2012,UC-Davis,Big West,31,320,27,67,17,36,10,31,7,10,11,36,47,12,6,25,15,45,71
16031,Dre'Sean Looney,2015,2015,Jackson State,SWAC,19,265,24,70,15,37,9,33,14,16,5,15,20,25,8,0,23,34,71
16032,Brendan Medley-Bacon,2019,2019,Coppin State,MEAC,30,313,24,53,23,49,1,4,22,42,26,59,85,7,2,16,38,63,71
16033,Ben Mills,2011,2014,Colorado,Total,58,235,29,62,28,61,1,1,12,21,22,42,64,5,4,3,17,17,71
16034,Garrett Moon,2014,2015,Eastern Washington,Big Sky,57,361,32,66,30,60,2,6,5,15,40,37,77,6,11,20,20,83,71
16035,Marquise Mosley,2019,2019,California Baptist,WAC,29,314,25,68,20,44,5,24,16,20,6,19,25,27,10,1,16,25,71
16036,Luke Nedrow,2019,2019,Marist,MAAC,29,266,26,56,13,24,13,32,6,12,14,28,42,14,3,6,21,57,71
16037,John Newman III,2019,2019,Clemson,ACC,34,407,28,72,19,44,9,28,6,11,15,44,59,15,12,5,19,31,71
16038,Logan Nutt,2008,2012,Total,Total,50,420,23,62,16,38,7,24,18,26,5,32,37,61,5,0,41,26,71
16039,Sommy Ogukwe,2011,2014,Liberty,Big South,71,487,28,56,28,55,0,1,15,36,43,81,124,6,14,34,37,100,71
16040,Bentiu Panoam,2019,2019,North Dakota,Summit,20,228,28,67,19,36,9,31,6,12,6,19,25,17,7,1,10,17,71
16041,Jalon Pipkins,2018,2018,Cal State Northridge,Big West,23,272,23,59,15,41,8,18,17,19,4,18,22,11,8,2,17,16,71
16042,Dakota Quinn,2016,2016,Samford,Southern,27,204,32,58,32,56,0,2,7,15,11,38,49,3,6,15,13,41,71
16043,Corey Redman,2016,2019,Central Michigan,MAC,64,247,23,59,2,9,21,50,4,6,22,26,48,5,10,1,7,43,71
16044,Martrevious Sanders,2012,2013,Alcorn State,SWAC,23,289,30,69,30,67,0,2,11,15,6,36,42,41,14,2,31,22,71
16045,Mike Terry ,2011,2012,Boston University,AEC,56,495,28,88,24,60,4,28,11,24,21,52,73,14,17,0,21,34,71
16046,De'Avion Washington,2019,2019,Indiana State,MVC,28,410,25,70,12,28,13,42,8,16,16,47,63,16,18,5,19,54,71
16047,Brandon Williams,2009,2010,Louisiana-Monroe,Sun Belt,40,696,24,102,17,56,7,46,16,25,10,51,61,94,21,1,53,67,71
16048,Tre Wood,2019,2019,Massachusetts,A-10,22,351,27,84,23,72,4,12,13,26,6,14,20,53,14,1,42,33,71
16049,Malik Albert,2016,2016,Creighton,Big East,27,220,26,59,25,45,1,14,17,24,4,24,28,27,12,4,18,10,70
16050,Nate Anderson,2012,2013,North Carolina-Wilmington,CAA,33,175,24,53,10,22,14,31,8,13,13,15,28,1,3,6,9,24,70
16051,Vin Baker Jr.,2018,2019,Boston College,ACC,41,289,24,75,14,22,10,53,12,14,11,28,39,9,7,3,22,29,70
16052,Glenn Baral,2014,2014,Stetson,A-Sun,28,320,25,90,8,27,17,63,3,5,4,21,25,12,11,1,10,25,70
16053,Isaac Bassey,2019,2019,Arkansas-Pine Bluff,SWAC,28,207,27,57,27,57,0,0,16,21,11,31,42,3,3,7,30,42,70
16054,Cory Brown,2011,2011,Cal State Bakersfield,Ind,28,388,27,49,25,45,2,4,14,17,25,37,62,3,8,24,23,76,70
16055,Adrian Burton,2011,2011,Eastern Michigan,MAC,24,264,25,78,20,56,5,22,15,29,6,24,30,32,17,1,25,26,70
16056,Will Chevalier,2018,2018,Green Bay,Horizon,26,210,23,65,5,15,18,50,6,6,9,24,33,2,2,3,7,19,70
16057,Dax Crum,2008,2008,Southern Utah,Summit,20,248,21,51,11,24,10,27,18,19,6,6,12,25,12,2,20,51,70
16058,Ryan Custer,2017,2017,Wright State,Horizon,32,315,22,67,12,31,10,36,16,26,26,23,49,13,11,6,12,54,70
16059,Eddie D'Haiti,2010,2010,Youngstown State,Horizon,28,319,24,59,24,58,0,1,22,38,36,46,82,13,9,18,29,56,70
16060,Caleb Dean,2011,2012,Western Michigan,MAC,34,162,28,61,27,59,1,2,13,20,14,21,35,1,1,2,11,28,70
16061,Jalen Duke,2017,2019,Tennessee State,OVC,27,223,28,52,20,30,8,22,6,10,5,13,18,4,11,4,8,22,70
16062,Wakefield Ellison,2010,2011,East Carolina,CUSA,46,371,24,80,15,44,9,36,13,20,17,18,35,13,8,4,20,23,70
16063,Mbiyimoh Ghogomu,2010,2011,Dartmouth,Ivy,50,538,29,85,29,79,0,6,12,30,28,36,64,16,12,9,30,66,70
16064,Sam Green,2017,2019,Drexel,CAA,27,206,26,55,11,20,15,35,3,8,10,21,31,13,2,1,7,24,70
16065,Jordan Griffin,2010,2012,Coastal Carolina,Big South,61,306,25,95,11,33,14,62,6,12,13,32,45,18,7,0,13,32,70
16066,Marcus Hall,2018,2019,Howard,MEAC,29,362,29,41,29,41,0,0,12,25,31,44,75,16,4,3,14,73,70
16067,Ja'Cardo Hawkins,2017,2017,Tennessee Tech,OVC,28,293,30,71,27,54,3,17,7,19,27,57,84,18,10,16,17,47,70
16068,Cameron Henderson,2009,2010,Montana State,Big Sky,47,305,28,67,28,67,0,0,14,21,28,27,55,12,3,3,25,85,70
16069,Patrick Johnson,2010,2010,Texas Southern,SWAC,31,481,27,73,24,55,3,18,13,22,5,24,29,47,18,5,49,30,70
16070,Nizar Kapic,2013,2014,Rice,CUSA,27,296,25,75,11,32,14,43,6,10,6,21,27,12,6,2,13,33,70
16071,Tadas Kararinas,2018,2019,Drexel,CAA,44,302,25,59,16,34,9,25,11,12,15,24,39,8,2,10,11,45,70
16072,Ahmed Khalfan,2008,2009,Prairie View,SWAC,46,285,29,57,29,57,0,0,12,21,28,59,87,6,5,14,11,40,70
16073,Israel Kirk,2009,2010,Southeast Missouri State,OVC,45,514,29,68,29,67,0,1,12,30,46,47,93,12,17,6,21,62,70
16074,Kambi Laleye,2008,2010,Buffalo,MAC,61,488,29,75,29,74,0,1,12,30,46,52,98,24,4,12,38,104,70
16075,Nick Lopez,2010,2010,NJIT,GWC,28,352,24,53,22,42,2,11,20,33,25,54,79,15,14,5,29,53,70
16076,Taurean Marshall,2008,2008,Marshall,CUSA,19,263,24,52,12,21,12,31,10,14,6,27,33,33,18,2,13,28,70
16077,Franklin Milian,2012,2012,Canisius,MAAC,27,247,20,53,11,35,9,18,21,26,13,33,46,11,8,1,15,26,70
16078,Dominique Mpondo,2009,2010,Tennessee-Martin,OVC,43,425,26,64,26,64,0,0,18,29,39,75,114,8,6,32,23,57,70
16079,D.J. Myers,2019,2019,Western Carolina,Southern,30,475,26,56,26,56,0,0,18,33,16,55,71,20,14,4,47,73,70
16080,Matthew Owies,2017,2017,Hawaii,Big West,27,312,24,72,14,34,10,38,12,16,6,18,24,24,12,1,21,24,70
16081,Garrett Pascoe,2019,2019,Boston University,Patriot,29,477,26,86,15,39,11,47,7,11,3,30,33,55,11,2,30,58,70
16082,Ahyaro Phillips,2011,2012,Southern Mississippi,CUSA,29,248,31,64,29,62,2,2,6,13,31,39,70,8,3,10,23,54,70
16083,Shavar Reynolds,2018,2019,Seton Hall,Big East,50,286,19,72,13,38,6,34,26,30,12,25,37,20,17,1,11,42,70
16084,Bobby Riddell,2008,2009,Purdue,Big Ten,40,244,22,42,8,14,14,28,12,14,3,11,14,14,11,1,13,29,70
16085,Schuyler Rimmer,2014,2017,Total,Total,62,347,25,59,24,57,1,2,19,32,21,39,60,5,1,10,17,57,70
16086,Delbert Simpson,2008,2009,Baylor,Big 12,33,280,29,60,27,55,2,5,10,15,19,45,64,2,11,22,17,28,70
16087,Isaiah Stokes,2019,2019,Florida,SEC,26,185,28,61,28,57,0,4,14,21,9,16,25,11,5,2,20,38,70
16088,Alex Tiefenthaler,2008,2008,Portland State,Big Sky,21,239,21,60,2,10,19,50,9,18,6,29,35,7,9,0,11,35,70
16089,Stilman White,2012,2017,North Carolina,ACC,88,347,17,59,12,33,5,26,31,44,11,19,30,42,11,0,10,48,70
16090,Yilret Yiljep,2014,2019,American,Patriot,35,340,26,52,25,51,1,1,17,31,15,49,64,22,8,5,39,63,70
16091,Andrew Zelis,2016,2018,Northern Illinois,MAC,38,261,31,59,31,59,0,0,8,21,20,49,69,5,2,16,11,51,70
16092,Dylan Alexander,2014,2014,San Jose State,MWC,27,218,25,60,13,23,12,37,7,12,3,27,30,15,5,0,8,33,69
16093,Iakeem Alston,2015,2015,St. Bonaventure,A-10,29,307,24,67,23,60,1,7,20,39,5,24,29,42,19,0,30,26,69
16094,Patrick Bade,2010,2011,Purdue,Big Ten,58,414,25,76,24,72,1,4,18,30,33,57,90,6,8,15,26,80,69
16095,Hugh Barnett,2009,2010,Arkansas-Pine Bluff,SWAC,43,228,26,63,26,63,0,0,17,32,22,36,58,5,1,10,30,38,69
16096,Jordan Berry,2018,2019,Jackson State,SWAC,32,296,24,97,6,26,18,71,3,4,9,16,25,8,8,1,13,25,69
16097,Chris Brand,2012,2012,Alcorn State,SWAC,9,198,27,64,21,51,6,13,9,12,14,26,40,8,7,18,18,24,69
16098,Chris Brandon,2019,2019,Detroit Mercy,Horizon,28,475,31,51,31,48,0,3,7,20,42,63,105,9,10,17,17,45,69
16099,Jeff Coulanges,2019,2019,Wagner,NEC,20,221,22,50,13,22,9,28,16,20,17,22,39,10,7,1,13,37,69
16100,Seth Coy,2009,2009,East Tennessee State,A-Sun,24,259,29,49,29,49,0,0,11,21,11,36,47,7,9,11,12,25,69
16101,Dexter Gooding,2016,2019,High Point,Big South,50,215,24,74,7,13,17,61,4,7,4,31,35,12,10,2,14,21,69
16102,Eron Gordon,2017,2018,Seton Hall,Big East,48,321,27,64,20,36,7,28,8,17,10,29,39,29,7,0,17,38,69
16103,DeMarcus Grady,2011,2012,Northern Illinois,MAC,28,231,18,52,11,29,7,23,26,33,9,24,33,18,2,0,16,13,69
16104,Joel Green,2008,2008,Rider,MAAC,28,261,26,73,23,61,3,12,14,24,20,33,53,3,6,10,13,24,69
16105,Tim Hamilton,2008,2008,Arkansas-Pine Bluff,SWAC,25,481,27,60,25,50,2,10,13,21,36,37,73,13,12,3,25,36,69
16106,Lenell Henry,2018,2018,Northern Arizona,Big Sky,19,224,27,50,26,47,1,3,14,28,19,36,55,3,8,8,25,37,69
16107,Darryl Hicks,2016,2016,Boston College,ACC,24,349,27,78,15,37,12,41,3,7,10,15,25,19,11,2,23,26,69
16108,Tomas Jasiulionis,2008,2009,St. John's (NY),Big East,45,428,28,63,27,59,1,4,12,16,34,37,71,13,2,18,21,70,69
16109,Femi John,2010,2010,Saint Louis,A-10,17,290,24,71,16,42,8,29,13,16,14,33,47,9,7,0,19,36,69
16110,Ajiri Johnson,2019,2019,Rider,MAAC,25,194,26,47,26,46,0,1,17,29,24,16,40,3,4,7,18,24,69
16111,Lucas Kraljevic,2018,2019,Boston College,ACC,53,419,25,68,22,53,3,15,16,31,23,50,73,24,11,18,38,95,69
16112,Stuart Lagerson,2011,2014,Texas-Arlington,Total,67,590,27,60,27,59,0,1,15,30,20,87,107,10,10,43,25,82,69
16113,Eric Lawton,2012,2012,Little Rock,Sun Belt,29,286,22,62,19,41,3,21,22,28,4,17,21,13,10,1,24,25,69
16114,Serigne Mboup,2014,2015,Austin Peay,OVC,48,302,19,46,19,46,0,0,31,52,29,30,59,9,11,14,29,47,69
16115,Joe Miles,2008,2008,Loyola (MD),MAAC,15,246,25,78,16,42,9,36,10,19,6,16,22,24,11,1,28,21,69
16116,Marcus Mitchell,2019,2019,Mississippi Valley State,SWAC,18,218,26,62,24,52,2,10,15,29,11,35,46,7,10,10,19,28,69
16117,Beau Muhlbach,2008,2008,Texas A&M,Big 12,29,212,23,47,19,34,4,13,19,28,7,29,36,8,10,2,19,29,69
16118,Eliel Nsoseme,2018,2019,Cincinnati,AAC,62,527,26,59,26,59,0,0,17,52,52,102,154,9,12,30,22,62,69
16119,Ken Odiase,2018,2019,Chicago State,WAC,38,242,25,59,24,56,1,3,18,38,17,36,53,4,4,6,22,33,69
16120,Darrius Parker,2014,2014,Air Force,MWC,18,238,24,39,22,32,2,7,19,32,14,24,38,13,4,6,12,27,69
16121,Zach Pfaffenberger,2019,2019,Sacred Heart,NEC,31,245,29,66,29,66,0,0,11,16,15,32,47,1,12,6,12,50,69
16122,Matija Radovic,2018,2019,Hofstra,CAA,32,295,22,72,4,13,18,59,7,12,15,37,52,7,6,1,16,23,69
16123,Kyle Reid,2015,2016,Eastern Washington,Big Sky,59,347,27,48,27,47,0,1,15,30,22,47,69,10,13,13,14,66,69
16124,Zeke Richards,2019,2019,Santa Clara,WCC,29,298,26,49,26,49,0,0,17,29,21,28,49,4,4,6,16,54,69
16125,Adam Seiko,2019,2019,San Diego State,MWC,32,388,17,40,3,7,14,33,21,28,3,28,31,20,9,1,19,27,69
16126,John Sexton,2008,2008,William & Mary,CAA,28,282,21,52,3,12,18,40,9,17,3,25,28,8,5,3,12,32,69
16127,Kylia Sykes,2018,2018,North Carolina-Greensboro,Southern,35,355,27,50,20,28,7,22,8,13,21,24,45,21,20,9,20,53,69
16128,Joe Thompson,2018,2018,South Alabama,Sun Belt,26,298,23,60,21,47,2,13,21,36,23,45,68,4,6,8,17,37,69
16129,Ismaila Traore,2008,2009,Saint Peter's,MAAC,55,734,25,61,25,59,0,2,19,37,53,76,129,23,13,15,44,102,69
16130,Justin Wagner,2013,2013,Alabama A&M,SWAC,25,224,22,70,14,33,8,37,17,30,5,10,15,9,3,1,10,24,69
16131,Kyle Wright,2010,2010,Providence,Big East,25,241,22,60,8,17,14,43,11,13,14,28,42,15,5,6,6,22,69
16132,Mustafa Abdul-Hamid,2008,2010,UCLA,Pac-10,40,281,27,59,17,25,10,34,4,9,4,13,17,25,5,0,19,18,68
16133,Jonathan Allen,2014,2017,Pepperdine,WCC,48,528,24,59,12,27,12,32,8,17,16,58,74,20,18,3,24,73,68
16134,Jake Bodway,2015,2017,South Florida,AAC,65,516,24,89,19,63,5,26,15,21,18,19,37,29,14,1,29,65,68
16135,Ladarius Coleman,2015,2016,Southeast Missouri State,OVC,16,234,22,67,18,51,4,16,20,25,14,37,51,13,5,1,17,18,68
16136,Marquel DeLancey,2009,2010,Old Dominion,CAA,62,485,24,59,24,58,0,1,20,40,9,43,52,69,27,2,47,54,68
16137,Taylor Echols,2013,2015,Georgia,SEC,48,288,22,65,0,3,22,62,2,8,1,22,23,12,6,0,21,26,68
16138,Nate Gibbs,2011,2011,Fairleigh Dickinson,NEC,10,252,17,46,17,46,0,0,34,41,15,45,60,2,6,2,15,28,68
16139,Kadeem Green,2012,2013,Total,Total,23,179,27,37,27,37,0,0,14,25,11,35,46,2,4,5,8,31,68
16140,Ray Hall,2008,2011,Providence,Big East,56,346,30,61,30,61,0,0,8,29,47,48,95,6,4,1,15,41,68
16141,Alexander Harrington,2010,2011,St. Francis (NY),NEC,29,279,28,74,27,72,1,2,11,27,29,34,63,2,8,6,14,39,68
16142,Glen Izevbigie,2009,2010,Savannah State,Ind,53,412,27,67,27,67,0,0,14,34,29,37,66,7,3,12,38,73,68
16143,Jonathan Jean,2017,2018,Furman,Southern,46,407,25,57,22,41,3,16,15,23,5,42,47,60,21,0,28,48,68
16144,Eugene Jones Jr.,2017,2017,Alabama A&M,SWAC,24,313,26,83,25,68,1,15,15,22,14,34,48,13,5,3,17,38,68
16145,CJ Jones,2013,2014,Manhattan,MAAC,40,427,24,96,19,66,5,30,15,26,12,28,40,36,14,0,39,62,68
16146,Tariiq Jones,2018,2018,Detroit Mercy,Horizon,7,133,26,54,20,37,6,17,10,15,10,22,32,8,0,2,16,11,68
16147,Cartavious Kincade,2011,2013,Army,Patriot,41,256,23,57,20,42,3,15,19,27,20,34,54,19,11,4,17,37,68
16148,Alperen Kurnaz,2019,2019,Denver,Summit,27,295,22,63,12,37,10,26,14,18,21,50,71,10,8,1,20,34,68
16149,Matt LaGrone,2008,2008,Nevada,WAC,32,395,27,37,27,37,0,0,14,22,30,68,98,19,9,1,37,61,68
16150,Tola Lawal,2011,2011,Morgan State,MEAC,26,195,20,55,20,54,0,1,28,35,13,13,26,10,10,0,16,14,68
16151,Jeffery Lewis,2018,2018,Mississippi Valley State,SWAC,24,283,25,89,9,24,16,65,2,4,8,22,30,12,6,0,22,22,68
16152,Anthony Malhoit,2011,2012,Rhode Island,A-10,45,304,25,56,17,38,8,18,10,20,33,43,76,15,15,1,18,38,68
16153,Larry McGaughney,2012,2012,Fresno State,WAC,17,245,28,64,17,32,11,32,1,5,9,13,22,4,7,8,6,22,68
16154,Keron McKenzie,2008,2008,Savannah State,Ind,21,145,21,67,8,30,13,37,13,14,8,11,19,4,3,0,15,23,68
16155,Garvey Melmed,2015,2018,Maine,AEC,72,516,23,80,6,11,17,69,5,11,14,33,47,21,10,0,17,40,68
16156,Marquis Moore,2019,2019,Detroit Mercy,Horizon,20,388,19,57,11,30,8,27,22,29,30,54,84,16,17,3,10,30,68
16157,Ben Oberfeld,2014,2017,Bucknell,Patriot,43,264,26,54,26,54,0,0,16,26,25,35,60,2,1,4,10,45,68
16158,Trent Perry,2014,2016,Eastern Michigan,MAC,41,286,24,81,7,18,17,63,3,7,3,12,15,10,6,0,6,16,68
16159,Darrin Person Jr.,2019,2019,Cal State Bakersfield,WAC,30,251,24,50,24,50,0,0,20,31,25,27,52,6,4,9,14,59,68
16160,DeVantae Price,2017,2018,Eastern Illinois,OVC,27,213,21,49,20,46,1,3,25,41,21,31,52,10,9,1,17,24,68
16161,Austin Richie,2019,2019,Northern Illinois,MAC,28,267,25,81,12,27,13,54,5,5,4,27,31,8,9,3,8,13,68
16162,Spencer Rodgers,2019,2019,Troy,Sun Belt,22,255,24,68,5,13,19,55,1,3,0,13,13,11,8,0,15,23,68
16163,Mitch Roelke,2011,2014,Milwaukee,Horizon,59,287,20,53,3,12,17,41,11,17,2,12,14,19,6,1,17,21,68
16164,Antwond Roshell,2011,2011,Louisiana Tech,WAC,29,285,29,57,29,57,0,0,10,21,38,38,76,4,3,22,31,61,68
16165,Stephen Shockley,2010,2013,Longwood,Total,59,248,19,53,4,16,15,37,15,24,6,21,27,24,7,2,22,28,68
16166,Garrett Swanson,2012,2012,Idaho State,Big Sky,19,252,27,73,24,52,3,21,11,17,17,19,36,1,7,5,16,34,68
16167,Joonas Tahvanainen,2017,2018,Utah Valley,WAC,40,268,26,57,22,38,4,19,12,18,19,40,59,9,9,2,19,41,68
16168,Bush Wamukota,2015,2016,Wichita State,MVC,60,384,23,51,23,50,0,1,22,36,36,56,92,4,8,6,14,76,68
16169,John Bailey,2012,2014,Portland,WCC,56,295,25,72,23,66,2,6,15,26,21,29,50,16,9,9,19,40,67
16170,Max Banchy,2013,2013,New Orleans,Ind,25,354,24,63,9,19,15,44,4,5,8,20,28,11,9,0,27,26,67
16171,Destin Barnes,2017,2018,Boston University,Patriot,12,183,23,59,11,25,12,34,9,12,9,19,28,13,8,3,9,24,67
16172,Darius Baugh,2010,2010,Savannah State,Ind,11,214,23,76,11,45,12,31,9,12,10,17,27,8,7,0,18,21,67
16173,Miles Beatty,2008,2008,George Washington,A-10,14,172,22,58,13,28,9,30,14,19,5,11,16,15,4,0,16,9,67
16174,Victor Bermudez,2014,2015,Texas State,Sun Belt,46,347,24,100,9,28,15,72,4,12,5,20,25,26,5,0,17,34,67
16175,Joe Bryant Jr,2019,2019,Norfolk State,MEAC,28,236,26,68,21,48,5,20,10,16,10,30,40,18,9,1,28,27,67
16176,Lloyd Burgess,2016,2019,North Carolina-Greensboro,Southern,55,401,25,44,25,44,0,0,17,42,40,57,97,9,4,11,22,77,67
16177,David Cobb,2008,2008,South Carolina State,MEAC,17,248,23,64,23,63,0,1,21,33,38,39,77,18,4,12,22,41,67
16178,Johnny Cobb,2008,2008,Prairie View,SWAC,25,269,26,57,26,57,0,0,15,29,22,43,65,6,9,14,23,46,67
16179,Djibril Coulibaly,2009,2012,Manhattan,MAAC,55,452,31,91,31,90,0,1,5,13,28,59,87,5,6,14,25,64,67
16180,Josh Cummings,2008,2008,Bethune-Cookman,MEAC,10,167,24,53,15,29,9,24,10,17,2,9,11,9,7,1,23,14,67
16181,Lawrence Fejokwu,2015,2016,Coppin State,MEAC,57,552,25,64,25,63,0,1,17,44,45,68,113,8,18,32,34,115,67
16182,Jelani Floyd,2008,2012,Total,Total,45,472,24,89,20,68,4,21,15,28,17,31,48,16,14,8,30,83,67
16183,Devon Friend,2016,2016,Chicago State,WAC,20,304,28,57,28,57,0,0,11,26,23,36,59,4,13,8,23,41,67
16184,Artis Gant,2008,2008,Long Beach State,Big West,9,221,21,53,18,44,3,9,22,33,5,12,17,21,3,1,24,25,67
16185,Mike Harrell,2011,2015,Total,Total,73,646,24,93,22,76,2,17,17,28,7,46,53,72,28,2,47,67,67
16186,Sean Harris,2014,2015,Utah State,MWC,41,420,29,59,29,59,0,0,9,17,33,50,83,17,10,17,20,47,67
16187,Daniel Hill,2013,2015,Eastern Washington,Big Sky,54,421,17,62,12,34,5,28,28,41,9,28,37,47,15,0,38,49,67
16188,Moraye Ivy,2008,2008,Tennessee State,OVC,22,272,22,61,10,24,12,37,11,15,15,28,43,16,14,5,9,50,67
16189,D.J. Jackson,2018,2019,Southern Illinois-Edwardsville,OVC,32,296,24,56,21,42,3,14,16,27,25,35,60,7,7,1,11,32,67
16190,George Jackson,2010,2010,Coppin State,MEAC,22,356,21,79,15,52,6,27,19,26,6,20,26,29,13,1,43,30,67
16191,Clayton Le Sann,2017,2019,Holy Cross,Patriot,56,304,24,71,10,27,14,44,5,10,13,17,30,11,7,0,17,17,67
16192,Josh Marshall,2008,2010,Sacred Heart,NEC,28,210,31,72,29,60,2,12,3,11,18,19,37,2,9,6,6,19,67
16193,Raheem May-Thompson,2010,2011,Quinnipiac,NEC,49,338,28,76,28,76,0,0,11,30,23,24,47,12,8,11,20,61,67
16194,Jon McAllian,2010,2013,Maine,AEC,47,360,21,83,7,24,14,59,11,11,6,32,38,25,10,4,18,42,67
16195,Chris McCall,2011,2011,Montana State,Big Sky,26,197,22,57,11,29,11,28,12,17,12,26,38,6,4,1,14,24,67
16196,Robert Mischler,2013,2016,Cornell,Ivy,60,267,22,42,5,8,17,34,6,10,3,18,21,11,5,2,10,16,67
16197,Pete Nance,2019,2019,Northwestern,Big Ten,23,319,26,75,16,37,10,38,5,12,10,31,41,18,8,8,16,28,67
16198,Javier Nasarre,2010,2011,Oral Roberts,Summit,33,208,24,58,19,37,5,21,14,19,13,25,38,6,5,7,21,30,67
16199,Luke Neff,2017,2018,Denver,Summit,31,208,22,53,6,7,16,46,7,8,3,21,24,11,1,0,8,11,67
16200,Ejike Obinna,2018,2018,Vanderbilt,SEC,25,235,26,44,26,43,0,1,15,31,12,41,53,1,1,2,13,50,67
16201,Fendi Onobun,2008,2009,Arizona,Pac-10,51,374,27,49,27,49,0,0,13,28,22,30,52,12,6,6,13,68,67
16202,Russell Permenter,2008,2010,Total,Total,30,245,21,57,20,56,1,1,24,39,20,29,49,1,2,17,17,55,67
16203,Reggie Reed,2012,2013,Southern Illinois-Edwardsville,OVC,47,731,24,62,23,54,1,8,18,32,9,42,51,114,31,1,74,89,67
16204,Deion Rhea,2018,2018,Texas A&M-Corpus Christi,Southland,11,183,23,55,16,33,7,22,14,19,7,24,31,4,4,8,17,27,67
16205,Adrian Rodriguez,2018,2019,Texas-San Antonio,CUSA,30,266,28,44,28,41,0,3,11,16,26,45,71,10,2,8,18,38,67
16206,Corey Romich,2018,2019,Jacksonville,A-Sun,39,353,22,65,4,6,18,59,5,8,7,14,21,14,7,0,9,30,67
16207,Timmy Sellers,2019,2019,Charleston Southern,Big South,27,294,27,58,27,58,0,0,13,28,39,27,66,4,9,7,17,52,67
16208,Marquis Sloan,2011,2011,South Carolina Upstate,A-Sun,28,407,22,90,17,55,5,35,18,32,13,27,40,26,22,0,40,34,67
16209,Drew Speraw,2008,2010,Central Florida,CUSA,50,215,24,47,10,15,14,32,5,12,3,12,15,14,6,0,14,19,67
16210,Stanley Storm,2011,2013,Saint Francis (PA),NEC,61,378,24,53,24,53,0,0,19,30,21,23,44,8,2,8,23,53,67
16211,Gilbert Thomas Jr.,2017,2017,Murray State,OVC,22,246,30,46,30,44,0,2,7,18,30,30,60,5,10,6,8,36,67
16212,Adam Thomas,2009,2012,Miami (OH),MAC,44,320,24,52,21,33,3,19,16,26,24,36,60,3,5,7,7,42,67
16213,Cahli Thomas,2013,2016,Delaware State,MEAC,54,410,20,63,11,25,9,38,18,25,3,28,31,35,11,0,29,27,67
16214,Zach Walton,2019,2019,Drexel,CAA,7,154,25,52,19,31,6,21,11,14,7,25,32,15,5,2,12,11,67
16215,Chris Welker,2011,2011,Army,Patriot,30,319,25,62,12,20,13,42,4,5,12,31,43,11,5,0,20,31,67
16216,Keon Williams,2010,2010,Iona,MAAC,26,175,29,62,29,62,0,0,9,16,16,28,44,0,7,1,14,32,67
16217,Jake Wilson,2017,2019,Appalachian State,Sun Belt,59,355,24,55,24,55,0,0,19,52,37,78,115,8,5,32,30,54,67
16218,Bryce Workman,2019,2019,Jacksonville,A-Sun,27,218,26,57,26,57,0,0,15,25,22,36,58,7,6,2,14,33,67
16219,Ethan Wright,2019,2019,Princeton,Ivy,19,267,23,82,11,36,12,46,9,13,15,40,55,12,14,4,14,22,67
16220,Andre Applewhite,2014,2014,Mississippi State,SEC,12,214,17,41,14,32,3,9,29,43,20,27,47,16,10,1,20,29,66
16221,Trevon Ary-Turner,2018,2018,Weber State,Big Sky,18,185,23,48,10,17,13,31,7,11,0,16,16,12,1,1,13,24,66
16222,Sadarius Bowser,2019,2019,Charleston Southern,Big South,30,324,30,49,29,47,1,2,5,14,30,27,57,6,3,11,16,43,66
16223,Noah Bramlage,2016,2019,Princeton,Ivy,50,246,22,65,15,42,7,23,15,27,7,31,38,25,5,3,20,27,66
16224,Carl Brown,2018,2018,Cal State Northridge,Big West,17,184,23,58,11,27,12,31,8,10,7,16,23,4,3,0,7,29,66
16225,DeAndre' Bynum,2009,2009,Quinnipiac,NEC,26,445,20,82,16,59,4,23,22,44,26,23,49,16,7,2,20,40,66
16226,Levi Cook,2017,2017,DePaul,Big East,25,273,29,48,29,48,0,0,8,13,26,32,58,3,1,10,21,45,66
16227,Victor Curry,2019,2019,Morgan State,MEAC,26,267,21,56,21,55,0,1,24,35,28,52,80,4,17,5,17,41,66
16228,Jeremy Dunbar,2008,2009,Southeastern Louisiana,Southland,15,219,23,67,6,17,17,50,3,3,1,17,18,10,3,2,8,22,66
16229,Arin Dunn,2009,2010,Colorado State,MWC,36,387,21,60,10,32,11,28,13,20,1,37,38,18,17,0,19,28,66
16230,Wally Dunn,2009,2011,Texas Tech,Big 12,41,141,23,48,10,15,13,33,7,10,6,6,12,6,7,2,4,16,66
16231,Phillip Fayne,2008,2008,Duquesne,A-10,19,232,22,51,13,21,9,30,13,17,16,17,33,16,16,2,16,29,66
16232,Devonte Fuller,2016,2018,Western Carolina,Southern,28,99,19,42,14,29,5,13,23,28,7,17,24,6,3,0,8,6,66
16233,Jonathon Gac,2011,2012,Loyola (IL),Horizon,35,213,28,47,28,47,0,0,10,23,17,28,45,6,6,1,18,29,66
16234,Jordan Gaines,2017,2017,Savannah State,MEAC,26,232,26,67,21,48,5,19,9,20,12,36,48,1,8,7,20,33,66
16235,Justin Goode,2016,2016,Rutgers,Big Ten,30,431,20,55,8,16,12,39,14,17,3,32,35,20,8,1,10,37,66
16236,Max Gotzler,2008,2008,Boston University,AEC,26,350,20,44,19,41,1,3,25,33,25,30,55,7,9,3,19,68,66
16237,Jake Hammond,2015,2016,Nebraska,Big Ten,40,347,24,58,24,58,0,0,18,42,45,43,88,7,5,19,15,51,66
16238,Tre Hansbrough,2016,2016,Tennessee Tech,OVC,22,184,20,47,14,27,6,20,20,27,2,22,24,21,4,1,10,17,66
16239,Javonntie Jackson,2017,2018,Long Beach State,Big West,40,323,26,57,25,53,1,4,13,22,26,33,59,11,12,1,30,42,66
16240,Jonathan Jefferson,2012,2013,Alabama State,SWAC,38,407,21,86,19,59,2,27,22,36,35,51,86,10,12,6,23,47,66
16241,Chris Kanne,2008,2009,Loyola Marymount,WCC,44,300,22,84,6,20,16,64,6,9,11,15,26,18,5,0,12,9,66
16242,Pawel Kielbasa,2008,2011,Chicago State,Total,83,443,27,84,27,84,0,0,12,18,26,73,99,3,6,8,32,84,66
16243,Pedro Maciel,2013,2014,Nicholls State,Southland,50,595,21,60,5,11,16,49,8,13,2,37,39,59,17,1,34,94,66
16244,Parris Massey,2014,2014,Massachusetts-Lowell,AEC,27,311,28,47,28,47,0,0,10,21,19,51,70,7,6,27,6,29,66
16245,Cameron McCallum,2009,2010,Nicholls State,Southland,45,359,27,60,27,60,0,0,12,25,24,38,62,15,11,4,24,66,66
16246,James Morgan,2008,2009,San Francisco,WCC,52,493,24,49,24,49,0,0,18,43,41,67,108,10,11,12,38,106,66
16247,Cory O'Brien,2008,2008,Idaho State,Big Sky,31,310,21,56,18,38,3,18,21,28,9,26,35,22,2,2,18,35,66
16248,Neiman Owens,2008,2008,Texas Christian,MWC,30,443,24,63,19,44,5,19,13,22,28,59,87,36,20,2,34,48,66
16249,David Pierce,2019,2019,Coastal Carolina,Sun Belt,11,187,21,55,6,15,15,40,9,16,0,14,14,3,5,0,11,23,66
16250,Brandon Powell,2019,2019,Fairleigh Dickinson,NEC,32,306,17,54,5,18,12,36,20,28,4,29,33,21,16,0,15,34,66
16251,Najee Pritchett,2016,2016,South Carolina State,MEAC,32,259,22,68,10,17,12,51,10,26,13,19,32,10,2,4,4,18,66
16252,Eric Rippetoe,2014,2015,Southern Utah,Big Sky,23,184,23,54,11,24,12,30,8,13,7,12,19,5,5,1,12,24,66
16253,Matt Samuels,2009,2009,Oakland,Summit,29,234,24,52,24,49,0,3,18,36,12,14,26,30,6,0,26,25,66
16254,Solomon Tat,2008,2010,Virginia,ACC,46,262,22,49,22,47,0,2,22,33,14,31,45,10,8,0,21,32,66
16255,Brandon Ware,2008,2009,Dartmouth,Ivy,26,400,24,75,21,57,3,18,15,18,7,16,23,41,15,0,42,33,66
16256,Denis Agre,2009,2011,Pepperdine,WCC,40,385,28,58,28,58,0,0,9,17,38,44,82,8,7,12,15,60,65
16257,Geoffrey Allen,2011,2013,Total,Total,26,262,26,60,20,38,6,22,7,18,21,29,50,18,14,3,20,51,65
16258,Sterling Bailey,2012,2013,Nicholls State,Southland,33,263,22,55,8,16,14,39,7,15,8,20,28,6,4,2,19,26,65
16259,Vassy Banny,2009,2010,Montana,Big Sky,49,419,22,54,20,46,2,8,19,37,33,79,112,22,21,1,39,61,65
16260,Kharon Butcher,2012,2013,Tennessee State,OVC,29,360,20,60,8,16,12,44,13,24,8,35,43,24,15,1,23,44,65
16261,Carl Cobbins,2013,2013,Grambling,SWAC,25,236,25,71,20,50,5,21,10,22,23,16,39,10,13,1,19,28,65
16262,Davere Creighton,2018,2018,Mississippi Valley State,SWAC,27,210,19,71,11,33,8,38,19,31,13,31,44,5,5,0,11,31,65
16263,Roderick Davis,2015,2016,Wright State,Horizon,40,337,29,52,29,51,0,1,7,20,13,34,47,6,2,13,23,63,65
16264,Mamoudou Diarra,2018,2019,Cincinnati,AAC,27,183,24,62,22,58,2,4,15,20,16,35,51,8,6,13,8,18,65
16265,Da'Veed Dildy,2009,2010,Stanford,Pac-10,49,426,27,74,26,55,1,19,10,25,10,36,46,34,15,2,33,38,65
16266,Harold Doby,2011,2011,Georgia State,CAA,26,322,23,64,23,63,0,1,19,34,23,32,55,11,18,11,20,57,65
16267,Logan Dye,2019,2019,Samford,Southern,24,215,30,54,30,54,0,0,5,13,12,27,39,3,8,6,21,40,65
16268,Greg Eboigbodin,2018,2018,Illinois,Big Ten,30,318,27,49,27,49,0,0,11,25,33,40,73,8,11,11,16,63,65
16269,Jaamon Echols,2011,2011,Texas A&M-Corpus Christi,Southland,21,251,22,71,15,53,7,18,14,17,3,13,16,24,8,1,22,14,65
16270,Derrick Flowers,2018,2019,Jacksonville,A-Sun,40,375,20,55,6,19,14,36,11,19,14,31,45,14,8,1,15,33,65
16271,Matt Fraliex,2009,2009,Murray State,OVC,25,189,19,72,6,26,13,46,14,16,5,18,23,8,3,1,10,17,65
16272,Alanzo Frink,2019,2019,South Carolina,SEC,24,212,26,59,24,50,2,9,11,25,22,22,44,4,7,7,15,52,65
16273,Jan Grzelinski,2015,2015,Canisius,MAAC,32,501,25,84,16,47,9,37,6,10,8,11,19,60,11,0,42,32,65
16274,Nick Hamilton,2015,2018,University of California,Pac-12,47,491,21,65,16,46,5,19,18,27,27,36,63,24,16,1,32,60,65
16275,Branden Harrison,2009,2009,Eastern Michigan,MAC,24,262,28,72,25,54,3,18,6,12,11,33,44,7,5,16,14,21,65
16276,Darnell Jackson,2012,2012,Louisiana,Sun Belt,26,326,24,64,18,45,6,19,11,21,26,38,64,12,14,2,19,28,65
16277,Oscar Kao,2019,2019,Southeast Missouri State,OVC,20,163,24,46,11,23,13,23,4,4,2,11,13,21,6,0,14,15,65
16278,Brian Katz,2009,2012,Yale,Ivy,47,281,20,81,7,26,13,55,12,22,8,25,33,12,5,0,13,23,65
16279,Mike Kebler,2008,2011,Michigan State,Big Ten,75,457,23,53,23,49,0,4,19,25,13,38,51,26,11,6,17,35,65
16280,Milos Kleut,2010,2011,Lipscomb,A-Sun,53,335,25,45,25,45,0,0,15,19,30,34,64,1,2,9,23,67,65
16281,Herve Kouna,2009,2010,Dartmouth,Ivy,40,326,25,60,25,59,0,1,15,25,37,49,86,7,8,18,37,50,65
16282,Troy Leaf,2011,2011,UC-Santa Barbara,Big West,29,269,22,67,14,39,8,28,13,17,4,22,26,14,6,0,20,22,65
16283,Lloyd Neely,2013,2014,Oakland,Total,47,317,25,57,22,49,3,8,12,23,21,27,48,11,7,3,19,49,65
16284,Amanze Ngumezi,2019,2019,Georgia,SEC,31,203,22,64,16,42,6,22,15,28,13,14,27,6,0,4,13,34,65
16285,Niksa Nikolic,2019,2019,Iona,MAAC,23,292,29,48,29,48,0,0,7,16,32,24,56,9,7,20,25,42,65
16286,Clint Nwosuh,2013,2016,Total,Total,23,251,20,61,5,19,15,42,10,12,5,12,17,17,6,0,14,15,65
16287,Tony Osunsanmi,2008,2010,Cal State Northridge,Big West,76,661,23,50,23,50,0,0,19,28,92,112,204,12,21,12,24,103,65
16288,Taj Price,2017,2019,NJIT,A-Sun,34,160,21,44,19,38,2,6,21,26,16,28,44,8,5,6,11,34,65
16289,Malik Rhodes,2018,2018,Memphis,AAC,26,264,18,54,8,17,10,37,19,24,1,9,10,32,4,0,21,22,65
16290,Brian Seals,2009,2009,Fresno State,WAC,29,264,27,48,27,48,0,0,11,17,29,40,69,4,3,20,17,39,65
16291,Damien Sears,2018,2018,Jacksonville,A-Sun,16,260,30,53,30,52,0,1,5,22,20,38,58,6,14,6,14,42,65
16292,Vitaliy Shibel,2018,2019,Arizona State,Pac-12,49,383,21,64,8,13,13,51,10,12,13,53,66,17,5,9,16,86,65
16293,Clayton Sterling,2009,2009,Toledo,MAC,22,256,23,66,21,45,2,21,17,27,9,15,24,16,9,1,29,36,65
16294,Ryan Stipanovich,2018,2018,Bradley,MVC,27,271,19,39,5,12,14,27,13,13,15,25,40,17,17,3,22,26,65
16295,Cataurius Taylor,2010,2010,Tennessee-Martin,OVC,29,535,23,70,18,48,5,22,14,28,10,24,34,59,18,0,43,46,65
16296,Delonte Taylor,2011,2011,UC-Riverside,Big West,28,234,27,75,19,43,8,32,3,10,17,33,50,6,3,4,9,24,65
16297,Torrance Timothy,2008,2008,Howard,MEAC,30,440,25,95,12,30,13,65,2,5,5,31,36,13,7,2,35,16,65
16298,Joshua Tomaic,2018,2019,Maryland,Big Ten,46,301,24,40,17,24,7,16,10,18,22,41,63,8,0,9,15,31,65
16299,Greg Tucker,2013,2013,Chicago State,GWC,10,168,23,60,12,28,11,32,8,9,3,5,8,13,5,0,25,16,65
16300,Cordell Veira,2018,2019,Florida International,CUSA,52,395,23,70,15,39,8,31,11,29,5,47,52,35,10,6,16,31,65
16301,Dunnell Webb,2009,2009,Florida A&M,MEAC,24,,28,80,27,68,1,12,8,13,12,18,30,7,7,3,14,24,65
16302,Miles Wentzien,2018,2019,Northern Iowa,MVC,19,260,20,50,14,30,6,20,19,27,12,26,38,18,6,1,19,12,65
16303,Justin Whatley,2018,2019,East Carolina,AAC,27,330,28,63,22,43,6,20,3,8,15,25,40,12,8,6,22,59,65
16304,Tyrone Wooten,2016,2016,Louisiana,Sun Belt,24,175,23,56,20,39,3,17,16,26,8,27,35,16,7,3,18,20,65
16305,Precious Ayah,2018,2019,Miami (OH),MAC,41,317,23,51,21,45,2,6,16,25,28,56,84,6,13,13,11,45,64
16306,Tauron Bailey,2013,2013,Morgan State,MEAC,29,255,24,49,24,49,0,0,16,35,26,36,62,7,12,6,13,42,64
16307,Jemarl Baker Jr.,2019,2019,Kentucky,SEC,28,254,20,61,7,19,13,42,11,15,1,14,15,12,4,2,10,23,64
16308,Anson Bartlett,2009,2010,Louisiana Tech,WAC,35,345,19,47,19,46,0,1,26,38,7,29,36,16,31,0,18,28,64
16309,Brandon Baylor,2010,2011,Delaware State,MEAC,40,321,24,65,12,30,12,35,4,6,4,5,9,9,8,0,11,30,64
16310,David Bookman,2008,2010,Hartford,AEC,35,203,23,56,23,53,0,3,18,32,11,28,39,8,1,8,19,39,64
16311,Isaiah Bujdoso,2019,2019,Loyola (IL),MVC,30,396,24,54,20,39,4,15,12,19,5,28,33,20,22,0,21,38,64
16312,Andre Chatfield,2015,2018,Harvard,Ivy,49,389,23,54,16,27,7,27,11,15,11,37,48,19,20,3,22,40,64
16313,Alonzo Chatman,2017,2018,Morehead State,OVC,29,317,25,42,25,42,0,0,14,28,26,42,68,8,5,2,31,69,64
16314,Chris Coleman,2009,2009,Florida Atlantic,Sun Belt,21,236,25,37,25,37,0,0,14,21,28,25,53,1,3,5,3,43,64
16315,Kyle Cook,2008,2008,Bethune-Cookman,MEAC,31,613,24,75,18,41,6,34,10,17,22,57,79,23,15,12,33,45,64
16316,Marco Cooper,2008,2010,Total,Total,45,301,27,46,27,46,0,0,10,19,31,50,81,7,5,4,10,54,64
16317,Thiago Cordeiro,2008,2008,Dayton,A-10,27,215,23,43,23,43,0,0,18,33,20,25,45,1,0,16,14,32,64
16318,Daniel Cummings,2018,2019,Tennessee State,OVC,36,349,19,62,2,8,17,54,9,12,12,28,40,8,4,0,14,48,64
16319,Joel Davila,2008,2008,Savannah State,Ind,17,230,21,68,18,51,3,17,19,27,6,27,33,17,6,0,24,25,64
16320,Luke Devine,2008,2009,Fordham,A-10,38,606,30,59,30,59,0,0,4,9,47,58,105,9,13,6,18,74,64
16321,Franz Dorsainvil,2008,2009,Oregon,Pac-10,27,177,28,51,28,51,0,0,8,26,17,21,38,2,4,3,17,34,64
16322,Daniel Fisher,2010,2013,American,Patriot,66,430,25,59,25,57,0,2,14,23,21,33,54,17,5,2,26,61,64
16323,Tim Flowers,2008,2008,Milwaukee,Horizon,10,164,24,61,24,61,0,0,16,32,9,19,28,4,6,10,20,26,64
16324,Kevin Franceschi,2015,2015,Missouri-Kansas City,WAC,25,211,20,56,16,41,4,15,20,25,9,7,16,9,3,0,26,21,64
16325,Myles Franklin,2018,2019,Northeastern,CAA,44,346,18,55,9,23,9,32,19,32,9,21,30,24,3,0,21,37,64
16326,Williams Gabriel,2014,2015,New Hampshire,AEC,45,444,23,49,23,49,0,0,18,30,29,47,76,2,9,26,31,93,64
16327,Thomas Greer,2012,2014,Austin Peay,OVC,52,339,18,47,10,27,8,20,20,35,5,26,31,21,11,1,29,38,64
16328,Dan Guest,2011,2015,Total,Total,62,382,23,75,21,63,2,12,16,19,3,25,28,49,15,0,37,41,64
16329,Phil Guglielmo,2013,2014,Navy,Patriot,22,206,22,63,10,28,12,35,8,10,3,10,13,3,1,2,10,12,64
16330,Cris Hoopes,2008,2008,Southern Utah,Summit,18,212,25,52,25,52,0,0,14,22,16,25,41,7,5,4,12,28,64
16331,Drummond Jones,2009,2009,Mississippi Valley State,SWAC,26,327,26,79,26,72,0,7,12,15,18,32,50,5,14,1,24,27,64
16332,Evan Maschmeyer,2012,2015,Saint Joseph's,A-10,76,353,20,70,15,43,5,27,19,26,7,24,31,26,8,1,31,32,64
16333,Chris Merriewether,2008,2010,Kansas State,Big 12,89,748,16,53,15,42,1,11,31,45,44,61,105,48,26,9,53,109,64
16334,J.R. Moore,2008,2008,Portland State,Big Sky,27,237,23,58,23,58,0,0,18,28,12,32,44,13,4,8,19,44,64
16335,Ryan Paradise,2008,2008,Northern Illinois,MAC,6,145,22,68,11,28,11,40,9,13,3,6,9,9,9,1,17,13,64
16336,Nigel Peter-Denmon,2008,2009,Denver,Sun Belt,41,314,19,52,1,11,18,41,8,10,3,16,19,13,4,0,13,36,64
16337,Kyle Rhoades,2016,2017,Western Carolina,Southern,28,212,22,46,18,38,4,8,16,23,23,35,58,11,9,2,22,34,64
16338,Kaileb Rodriguez,2015,2016,Nevada,MWC,61,586,24,70,24,70,0,0,16,31,34,82,116,13,4,17,35,108,64
16339,Dzmitry Ryuny,2019,2019,San Francisco,WCC,17,123,20,43,3,5,17,38,7,8,2,18,20,5,2,4,6,11,64
16340,Dom Samac,2013,2014,Denver,Total,23,235,25,50,18,30,7,20,7,10,7,21,28,10,5,1,6,29,64
16341,Mike Schroback,2015,2018,Fairleigh Dickinson,NEC,88,342,19,72,7,27,12,45,14,22,2,18,20,26,9,0,30,25,64
16342,Antonio Spencer,2019,2019,Kennesaw State,A-Sun,32,437,29,53,29,52,0,1,6,19,38,76,114,8,10,27,9,65,64
16343,Khalill Spencer,2017,2019,Total,Total,34,288,29,49,29,48,0,1,6,14,24,35,59,6,13,4,22,60,64
16344,Antwan Walker,2018,2018,Georgetown,Big East,24,183,24,49,22,44,2,5,14,15,20,26,46,6,7,3,11,22,64
16345,Tye Wilburn,2017,2018,Wright State,Horizon,38,320,21,51,18,38,3,13,19,26,11,45,56,30,24,0,24,32,64
16346,Eric Adams,2008,2008,Jackson State,SWAC,12,200,20,71,5,22,15,49,8,10,0,14,14,16,7,0,24,24,63
16347,Curtis Allen,2008,2008,Oral Roberts,Summit,17,173,23,60,18,42,5,18,12,17,11,19,30,9,10,5,13,19,63
16348,Mack Anderson,2019,2019,Montana,Big Sky,28,236,27,41,27,41,0,0,9,20,10,34,44,6,1,5,17,53,63
16349,Ibrahim Appiah,2008,2009,High Point,Big South,46,338,22,49,17,40,5,9,14,19,11,41,52,25,10,2,16,19,63
16350,Rashad Austin,2008,2008,Bradley,MVC,29,273,25,42,25,42,0,0,13,23,26,35,61,5,5,6,22,54,63
16351,Leon Bahner,2015,2016,San Jose State,MWC,35,369,19,48,19,48,0,0,25,41,34,63,97,8,3,26,25,55,63
16352,James Barrett,2008,2008,Sam Houston State,Southland,8,129,24,54,19,32,5,22,10,14,14,21,35,7,6,3,10,15,63
16353,Iran Bennett,2019,2019,Marshall,CUSA,15,187,27,50,26,47,1,3,8,20,17,24,41,4,6,12,20,41,63
16354,Ryan Childress,2008,2009,Tennessee,SEC,29,252,23,65,20,45,3,20,14,22,26,40,66,18,8,6,17,34,63
16355,Kevin Chuisseu,2013,2015,Furman,Southern,58,445,22,59,22,58,0,1,19,51,31,70,101,7,8,9,28,66,63
16356,Blake Danielak,2014,2015,Drake,MVC,23,261,23,67,9,26,14,41,3,6,21,28,49,11,6,4,12,26,63
16357,Gerad Davis,2017,2017,Northern Colorado,Big Sky,9,123,21,43,20,39,1,4,20,28,11,24,35,8,1,0,11,20,63
16358,Abebe Demissie,2010,2010,Eastern Washington,Big Sky,12,162,19,48,16,31,3,17,22,39,14,32,46,19,5,7,14,20,63
16359,D'Montre Edwards,2013,2014,Tennessee,SEC,28,195,20,60,11,35,9,25,14,19,7,40,47,5,6,1,9,26,63
16360,Jordan Estada,2012,2012,Sacramento State,Big Sky,22,396,20,94,2,12,18,82,5,9,5,20,25,25,5,0,11,26,63
16361,Jalek Felton,2018,2018,North Carolina,ACC,22,213,24,62,13,27,11,35,4,6,2,18,20,35,8,2,24,11,63
16362,Adrien Garr,2008,2009,McNeese State,Southland,29,189,19,41,13,23,6,18,19,27,6,9,15,13,7,1,23,36,63
16363,Clay Gayman,2019,2019,Abilene Christian,Southland,31,155,22,48,14,29,8,19,11,18,14,16,30,8,7,3,17,13,63
16364,C.J. Giles,2008,2008,Oregon State,Pac-10,10,181,25,59,24,52,1,7,12,18,23,33,56,4,3,16,15,40,63
16365,Adrion Graves,2008,2008,Xavier,A-10,34,276,25,70,13,20,12,50,1,1,2,31,33,21,7,4,13,23,63
16366,Daniel Green,2012,2016,Total,Total,52,346,19,53,19,51,0,2,25,44,26,54,80,7,6,10,21,62,63
16367,Brian Haak,2008,2010,Northern Iowa,MVC,56,420,19,52,8,16,11,36,14,19,4,33,37,34,15,1,16,35,63
16368,Joe Hudson,2011,2011,Wyoming,MWC,22,225,21,80,5,12,16,68,5,6,1,17,18,7,9,0,9,25,63
16369,Logan Johnson,2019,2019,Cincinnati,AAC,31,225,23,49,20,37,3,12,14,20,15,23,38,21,11,7,19,24,63
16370,Antonio Kalpic,2012,2014,Campbell,Big South,42,306,25,45,25,45,0,0,13,18,17,39,56,6,5,9,21,62,63
16371,Nick Kerr,2012,2016,Total,Total,47,171,21,57,3,12,18,45,3,5,0,4,4,6,2,0,7,11,63
16372,Pete Kpan,2013,2014,McNeese State,Southland,46,268,22,41,22,40,0,1,19,28,33,32,65,7,3,6,10,31,63
16373,Bul Kuol,2019,2019,California Baptist,WAC,10,229,21,42,11,17,10,25,11,16,4,20,24,5,7,1,12,21,63
16374,Jason Loughry,2008,2008,Mount St. Mary's,NEC,29,350,29,56,29,56,0,0,5,9,17,49,66,7,9,7,21,57,63
16375,Ryan Majerle,2012,2012,Toledo,MAC,12,270,16,53,4,13,12,40,19,24,5,17,22,8,7,4,8,22,63
16376,Eric McCrary,2010,2010,Southeast Missouri State,OVC,23,204,23,47,16,29,7,18,10,13,6,28,34,11,5,3,15,45,63
16377,Cameron McGee,2017,2017,Lamar,Southland,18,127,16,44,9,23,7,21,24,32,3,9,12,23,8,0,8,15,63
16378,Peter Minchella,2008,2008,Colgate,Patriot,32,364,22,41,22,40,0,1,19,34,22,35,57,13,11,13,17,77,63
16379,Khalil Murphy,2012,2013,Total,Total,39,260,26,61,25,49,1,12,10,32,25,31,56,5,8,3,13,40,63
16380,Luke Norman,2015,2016,Eastern Illinois,OVC,46,459,21,40,7,10,14,30,7,11,2,35,37,24,7,1,16,35,63
16381,Demonte Ojinnaka,2017,2018,Indiana State,MVC,36,345,22,76,6,26,16,50,3,6,3,28,31,11,3,2,14,38,63
16382,Mike Owona,2014,2017,Total,Total,58,514,28,58,28,58,0,0,7,18,34,75,109,7,11,22,29,79,63
16383,Larry Savage,2012,2013,Delaware,CAA,50,422,28,84,26,66,2,18,5,17,30,50,80,8,12,13,18,35,63
16384,Kristian Sjolund,2019,2019,Georgia Tech,ACC,21,200,20,56,5,11,15,45,8,10,2,20,22,4,4,2,14,25,63
16385,David Smith,2010,2012,Drake,MVC,63,478,20,41,20,41,0,0,23,41,12,44,56,33,12,4,38,51,63
16386,Rokas Ulvydas,2016,2018,Total,Total,35,300,22,48,22,48,0,0,19,34,18,44,62,1,2,28,19,51,63
16387,Reid Wallace,2010,2010,Northern Arizona,Big Sky,25,255,26,54,17,29,9,25,2,3,10,26,36,6,4,5,13,27,63
16388,Jordan Wells,2013,2015,McNeese State,Southland,51,302,27,74,25,66,2,8,7,16,21,23,44,7,4,10,18,61,63
16389,Aundra Williams,2011,2011,Marshall,CUSA,31,297,22,37,22,37,0,0,19,35,26,37,63,1,6,10,4,38,63
16390,Dominic Woodson,2014,2015,Total,Total,24,184,28,64,28,64,0,0,7,19,19,27,46,9,9,7,14,46,63
16391,Aquil Younger,2012,2013,Drexel,CAA,63,483,22,68,20,56,2,12,17,24,2,45,47,39,24,3,56,53,63
16392,Franklin Agunanne,2019,2019,Loyola (IL),MVC,33,224,25,48,25,48,0,0,12,19,8,52,60,2,6,15,26,54,62
16393,Devon Archie,2011,2012,Iowa,Big Ten,41,319,27,50,27,50,0,0,8,28,38,62,100,11,12,13,22,32,62
16394,Connor Arnold,2019,2019,Virginia Military Institute,Southern,27,200,21,59,4,15,17,44,3,3,9,20,29,5,6,1,12,13,62
16395,Christian Bentley,2018,2018,Siena,MAAC,29,328,20,43,13,29,7,14,15,23,17,25,42,16,10,1,16,29,62
16396,Chris Braley,2014,2015,Stony Brook,AEC,48,355,23,64,13,26,10,38,6,11,21,53,74,14,9,2,20,44,62
16397,Myles Carter,2018,2019,Delaware State,MEAC,40,264,21,70,15,49,6,21,14,17,14,21,35,10,7,0,25,36,62
16398,Michael Chambers,2017,2017,Maryland-Eastern Shore,MEAC,24,245,21,56,15,25,6,31,14,21,5,30,35,14,5,1,18,31,62
16399,Brooks Cluxton,2018,2019,Campbell,Big South,29,251,24,41,24,41,0,0,14,31,25,44,69,14,4,15,14,27,62
16400,Jarius Cook,2019,2019,North Dakota State,Summit,18,186,23,67,11,25,12,42,4,6,4,15,19,7,8,2,9,15,62
16401,Jordan Dembley,2015,2015,Liberty,Big South,25,364,19,42,12,24,7,18,17,25,8,21,29,42,6,2,25,22,62
16402,Victor Enoh,2018,2019,Memphis,AAC,45,368,18,40,18,40,0,0,26,49,29,38,67,7,2,3,20,46,62
16403,Darnell Ferguson,2008,2008,Sacramento State,Big Sky,27,343,23,73,18,48,5,25,11,15,30,40,70,11,9,12,15,47,62
16404,Ndene Gueve,2019,2019,Texas-Rio Grande Valley,WAC,21,238,28,64,28,64,0,0,6,13,19,38,57,6,6,11,17,47,62
16405,Anders Haas,2014,2014,Albany (NY),AEC,21,134,18,53,3,9,15,44,11,13,2,10,12,5,1,0,8,11,62
16406,Kevin Holmes Jr.,2016,2017,Coastal Carolina,Total,40,370,23,90,10,23,13,67,3,8,15,52,67,2,5,11,23,31,62
16407,Teslim Idris,2016,2016,Savannah State,MEAC,29,333,25,52,20,40,5,12,7,16,17,24,41,10,10,7,14,40,62
16408,Otas Iyekekpolor,2017,2018,Central Arkansas,Southland,47,299,22,50,22,50,0,0,18,28,23,33,56,5,5,8,14,57,62
16409,Keigen Kerby,2019,2019,Chattanooga,Southern,27,322,22,58,9,17,13,41,5,10,13,46,59,12,7,13,18,54,62
16410,Jafar Kinsey,2015,2018,Total,Total,37,418,22,82,15,36,7,46,11,25,9,30,39,21,9,1,26,42,62
16411,Damarkeo Lyshe,2012,2015,Bowling Green State,MAC,48,241,19,59,8,23,11,36,13,20,9,7,16,14,8,0,11,41,62
16412,John Manley,2008,2009,Cal Poly,Big West,40,443,26,47,26,47,0,0,10,32,34,61,95,19,6,4,20,43,62
16413,Keith Manley,2010,2011,Gardner-Webb,Big South,33,272,23,66,23,58,0,8,16,26,23,37,60,5,6,2,15,50,62
16414,Jacob Manning,2008,2008,New Orleans,Sun Belt,32,503,22,54,17,41,5,13,13,19,19,55,74,8,7,2,17,62,62
16415,Michael Martin,2010,2011,Alcorn State,SWAC,53,565,23,49,23,49,0,0,16,38,52,46,98,9,16,29,25,97,62
16416,Devin McBride,2008,2010,Total,Total,14,134,22,53,16,37,6,16,12,20,11,10,21,3,1,0,6,17,62
16417,Sayveon McEwen,2019,2019,Robert Morris,NEC,25,196,23,62,17,33,6,29,10,14,0,7,7,4,9,0,8,28,62
16418,Daquein McNeil,2014,2015,Minnesota,Big Ten,34,367,23,67,17,43,6,24,10,21,10,35,45,22,14,1,16,44,62
16419,Jalen Palm,2013,2014,Monmouth,Total,47,285,19,68,11,31,8,37,16,23,3,19,22,20,15,0,21,47,62
16420,Monquel Pegues,2008,2008,New Mexico,MWC,33,381,18,75,18,75,0,0,26,46,24,58,82,3,5,6,28,54,62
16421,Tim Perry Jr.,2019,2019,Drexel,CAA,27,308,30,43,30,43,0,0,2,9,25,60,85,4,2,12,11,53,62
16422,Ahyaro Phillips,2009,2009,Nevada,WAC,29,262,24,42,24,41,0,1,14,21,29,50,79,16,6,10,20,51,62
16423,Shang Ping,2008,2008,Nebraska,Big 12,21,207,24,44,22,37,2,7,12,31,14,16,30,7,5,7,17,28,62
16424,Matt Ratto,2013,2014,Cal State Bakersfield,Total,40,179,18,48,2,5,16,43,10,11,5,16,21,8,6,1,9,22,62
16425,Ross Ryan,2019,2019,South Carolina Upstate,Big South,27,277,26,56,25,54,1,2,9,13,15,28,43,17,12,8,21,26,62
16426,Nemanja Stankovic,2008,2009,Chicago State,Ind,50,376,21,58,21,57,0,1,20,32,29,33,62,9,5,11,35,72,62
16427,Armani Taylor,2018,2018,South Carolina State,MEAC,28,205,24,44,24,44,0,0,14,38,27,32,59,2,2,15,19,45,62
16428,Sean Tingle,2014,2015,Arkansas-Pine Bluff,SWAC,30,183,18,49,18,48,0,1,26,45,19,14,33,2,4,5,31,38,62
16429,Brady Twombly,2016,2016,Northern Arizona,Big Sky,21,232,21,52,7,12,14,40,6,8,8,25,33,3,4,4,9,18,62
16430,Matt Van Dyk,2016,2017,Michigan State,Big Ten,51,280,21,40,21,40,0,0,20,36,29,36,65,16,12,14,15,42,62
16431,Dawson Verhines,2014,2015,Southern Illinois,MVC,63,566,17,51,9,25,8,26,20,29,17,41,58,24,14,2,22,34,62
16432,Stephen Verwers,2008,2008,Hawaii,WAC,10,206,24,46,24,46,0,0,14,29,14,27,41,11,4,11,18,31,62
16433,Brendan Walker,2008,2010,Mercer,A-Sun,80,300,19,61,13,32,6,29,18,27,8,12,28,27,10,0,23,18,62
16434,Alex Allbery,2016,2018,Omaha,Summit,43,291,23,54,14,33,9,21,6,9,11,20,31,10,11,1,20,26,61
16435,Dayton Boddie ,2013,2013,UC-Riverside,Big West,15,210,22,54,20,38,2,16,15,23,1,26,27,16,14,2,20,10,61
16436,Alex Brown,2017,2017,Norfolk State,MEAC,26,248,24,70,14,35,10,35,3,6,5,24,29,10,1,2,21,19,61
16437,LeSean Brown,2017,2019,Air Force,MWC,40,212,16,46,12,28,4,18,25,39,5,25,30,16,4,0,7,16,61
16438,Ray Chen,2017,2017,Liberty,Big South,35,248,15,35,7,14,8,21,23,26,3,27,30,19,7,0,15,25,61
16439,Adam Chmielewski,2011,2011,St. Francis (NY),NEC,28,356,14,59,6,31,8,28,25,30,11,20,31,32,11,0,24,26,61
16440,Chase Connor,2014,2015,West Virginia,Big 12,35,174,21,58,2,3,19,55,0,0,1,7,8,6,12,0,4,20,61
16441,Isaiah Dahlman,2008,2010,Michigan State,Big Ten,57,177,23,45,16,26,7,19,8,14,7,21,28,5,2,0,8,13,61
16442,Jacoby Davis,2014,2014,Mississippi State,SEC,28,316,20,74,3,21,17,53,4,5,8,26,34,19,9,0,17,30,61
16443,Patrick Davis,2011,2011,Alabama State,SWAC,16,193,26,61,25,59,1,2,8,12,11,27,38,1,8,19,20,25,61
16444,Daniel Dillon,2008,2008,Arizona,Pac-10,30,432,17,52,6,21,11,31,16,18,8,24,32,38,12,1,14,43,61
16445,Miles Dixon,2011,2011,Houston Baptist,GWC,5,151,24,57,21,46,3,11,10,11,6,12,18,8,9,3,17,14,61
16446,Myles Douglas,2018,2018,Central Florida,AAC,31,276,20,68,15,39,5,29,16,34,4,29,33,9,1,1,25,29,61
16447,Oscar Garcia,2013,2013,Lipscomb,A-Sun,30,341,21,55,21,55,0,0,19,40,19,34,53,5,9,1,31,63,61
16448,Romaro Gill,2019,2019,Seton Hall,Big East,27,293,28,48,28,48,0,0,5,14,22,50,72,1,7,34,19,54,61
16449,John Gourlay,2008,2009,Lehigh,Patriot,48,431,25,60,25,60,0,0,11,13,19,53,72,12,2,10,20,67,61
16450,Kierell Green,2017,2019,Niagara,MAAC,39,217,25,58,20,32,5,26,6,10,16,39,55,8,7,12,14,45,61
16451,Trey Harris,2008,2008,UC-Irvine,Big West,19,232,20,47,10,25,10,22,11,15,2,11,13,24,2,0,14,11,61
16452,Mark Howell,2014,2015,Wright State,Horizon,46,393,19,62,14,37,5,25,18,23,3,25,28,33,22,2,21,30,61
16453,Cody Johnson,2014,2014,Loyola (IL),MVC,23,193,25,52,18,33,7,19,4,6,9,29,38,5,0,10,10,25,61
16454,Kensha Johnson,2009,2009,South Carolina State,MEAC,29,454,20,54,15,35,5,19,16,23,6,48,54,44,23,7,46,52,61
16455,Jeremy Jones,2012,2012,Kansas State,Big 12,20,163,23,51,14,26,9,25,6,10,1,14,15,15,3,1,12,11,61
16456,Jabari Joyner,2010,2013,Delaware State,MEAC,58,365,19,67,9,27,10,40,13,16,11,20,31,31,13,0,32,22,61
16457,Brylle Kamen,2011,2011,San Jose State,WAC,10,203,17,60,17,56,0,4,27,38,18,41,59,2,4,1,20,19,61
16458,Morgan Kelly,2008,2009,Brown,Ivy,39,322,21,92,9,26,12,66,7,16,7,27,34,15,4,4,25,47,61
16459,Zeno Lake,2018,2018,Cal State Northridge,Big West,16,323,23,44,23,44,0,0,15,30,28,44,72,4,6,6,9,35,61
16460,Bruce Marshall,2013,2014,Missouri State,MVC,41,286,19,53,9,22,10,31,13,20,8,26,34,2,1,5,12,46,61
16461,Chris McFarland,2008,2010,Saint Francis (PA),NEC,55,459,17,48,13,35,4,13,23,34,13,33,46,37,20,2,39,52,61
16462,Charles Moore,2008,2008,Tennessee Tech,OVC,29,304,21,51,18,42,3,9,16,23,36,45,81,16,18,5,27,40,61
16463,Nicos Norris,2011,2011,Texas Southern,SWAC,24,251,18,56,6,14,12,42,13,16,1,8,9,15,12,0,20,23,61
16464,Sylvester Ogbonda,2017,2019,Georgia Tech,ACC,42,206,22,50,22,50,0,0,17,29,17,31,48,8,5,12,19,46,61
16465,Quinten Payne,2014,2016,Total,Total,43,408,23,73,14,25,9,48,6,9,2,21,23,24,10,3,24,41,61
16466,Kodye Pugh,2018,2019,Stanford,Pac-12,38,238,23,52,19,34,4,18,11,20,13,15,28,15,5,1,25,18,61
16467,James Reese,2018,2018,Buffalo,MAC,25,195,19,60,11,19,8,41,15,16,6,16,22,17,8,4,11,33,61
16468,Aaron Richie,2009,2010,Purdue-Fort Wayne,Summit,28,269,22,42,16,26,6,16,11,21,19,22,41,5,5,1,6,21,61
16469,Dalvin Roberts,2015,2015,Florida A&M,MEAC,19,288,13,51,6,19,7,32,28,45,3,14,17,16,5,3,17,35,61
16470,Brian Rodriguez-Flores,2019,2019,San Jose State,MWC,24,202,23,65,15,29,8,36,7,11,10,16,26,13,4,1,14,16,61
16471,Aziz Seck,2017,2019,Northern Arizona,Big Sky,41,288,25,56,25,55,0,1,11,34,21,39,60,8,8,7,21,64,61
16472,Johnathan Spicer,2015,2016,Florida A&M,MEAC,48,400,21,62,20,51,1,11,18,28,21,41,62,12,5,2,35,21,61
16473,Alexander Strating,2018,2019,Colorado,Pac-12,34,238,25,37,25,37,0,0,11,24,19,18,37,9,2,2,15,31,61
16474,Matej Svoboda,2018,2018,Dayton,A-10,28,318,25,76,16,31,9,45,2,2,9,24,33,17,4,2,25,44,61
16475,Jamal Thompson,2008,2008,Alcorn State,SWAC,21,257,21,83,13,35,8,48,11,16,9,23,32,16,11,2,15,30,61
16476,Max Tinsley,2016,2018,Pacific,WCC,39,296,25,50,18,32,7,18,4,7,13,22,35,16,9,1,9,26,61
16477,Mike Turner,2013,2013,Northwestern,Big Ten,32,504,24,71,18,56,6,15,7,12,21,43,64,56,18,20,28,85,61
16478,Stanley Turner,2008,2008,Jackson State,SWAC,30,216,27,59,27,59,0,0,7,16,21,35,56,6,3,9,33,52,61
16479,Scotty Tyler,2014,2016,Total,Total,37,303,26,52,24,47,2,5,7,10,17,34,51,10,16,6,14,45,61
16480,B.J. Visman,2008,2008,UC-Riverside,Big West,29,263,26,64,26,60,0,4,9,13,27,34,61,3,3,7,22,35,61
16481,Ronald Whitaker,2017,2018,Florida International,CUSA,32,233,24,61,22,43,2,18,11,18,17,22,39,5,6,3,14,41,61
16482,Larry Williams,2008,2010,Auburn,SEC,50,197,21,55,7,11,14,44,5,12,3,9,12,4,9,0,9,13,61
16483,Crew Ainge,2018,2019,Utah State,MWC,34,343,23,67,21,38,2,29,12,20,6,43,49,34,13,1,26,41,60
16484,J.R. Angle,2008,2009,Iowa,Big Ten,23,229,20,58,5,13,15,45,5,10,8,25,33,13,5,1,13,21,60
16485,Calistus Anyichie,2019,2019,Binghamton,AEC,32,292,22,39,22,39,0,0,16,25,21,47,68,7,11,21,17,50,60
16486,Andrew Atman,2008,2008,Buffalo,MAC,18,214,20,57,14,37,6,20,14,22,12,35,47,9,3,6,14,27,60
16487,Yunio Barrueta,2013,2013,East Tennessee State,A-Sun,25,294,19,56,13,37,6,19,16,25,21,36,57,10,3,3,16,24,60
16488,Nikola Bodic,2008,2008,Western Illinois,Summit,10,189,20,61,14,39,6,22,14,14,10,20,30,8,6,1,20,17,60
16489,Kevin Broussard,2012,2012,Stephen F. Austin,Southland,13,161,21,53,8,19,13,34,5,7,0,7,7,7,3,0,3,9,60
16490,Ken Brown,2011,2011,Western Kentucky,Sun Belt,9,206,18,45,10,24,8,21,16,19,2,18,20,26,15,3,31,20,60
16491,Kolbe Caldwell,2018,2018,Utah,Pac-12,27,306,22,65,11,26,11,39,5,7,5,20,25,15,5,1,23,28,60
16492,Kale Catchings,2019,2019,Harvard,Ivy,16,202,20,46,14,31,6,15,14,20,12,24,36,7,10,1,9,33,60
16493,Telly Davenport,2016,2017,Utah Valley,WAC,23,203,23,49,21,34,2,15,12,24,2,36,38,28,6,2,29,24,60
16494,D.J. Davis,2015,2015,South Dakota,Summit,32,299,22,62,18,47,4,15,12,22,25,30,55,14,13,1,15,31,60
16495,Ibrahim Djambo,2014,2014,Clemson,ACC,32,294,21,66,11,24,10,42,8,12,14,30,44,4,5,6,14,42,60
16496,Davor Galic,2008,2008,North Carolina-Greensboro,Southern,28,197,19,56,11,20,8,36,14,26,7,14,21,7,5,0,23,36,60
16497,Khalil Gracey,2018,2018,Morgan State,MEAC,22,175,22,57,15,36,7,21,9,16,8,15,23,13,7,1,13,17,60
16498,Justynn Hammond,2008,2008,Portland State,Big Sky,16,229,21,54,10,28,11,26,7,12,7,22,29,12,8,4,28,33,60
16499,Tryl Hartfield,2008,2009,Detroit Mercy,Horizon,35,267,14,56,6,23,8,33,24,32,6,14,20,16,4,0,16,16,60
16500,Gavin Hoffmann,2012,2015,San Francisco,WCC,71,407,18,47,8,20,10,27,14,23,6,30,36,21,8,0,13,61,60
16501,Alex Jacobson,2009,2012,Arizona,Total,68,391,26,51,25,50,1,1,7,13,27,33,60,6,2,8,24,55,60
16502,Max Johns,2019,2019,Princeton,Ivy,24,250,22,48,14,25,8,23,8,13,10,16,26,3,9,1,15,27,60
16503,Amari Kelly,2019,2019,Duquesne,A-10,29,308,28,63,27,55,1,8,3,10,29,31,60,9,7,20,32,65,60
16504,Ben Knox,2010,2011,North Texas,Sun Belt,48,352,27,57,27,57,0,0,6,19,27,47,74,7,6,17,21,58,60
16505,Dishon Lowery,2017,2018,Wofford,Southern,38,268,21,40,21,40,0,0,18,26,28,40,68,10,4,10,21,38,60
16506,Torrey Mayo,2018,2019,Southern,SWAC,32,474,19,58,14,39,5,19,17,32,6,31,37,45,15,2,35,60,60
16507,Robyn Missa,2015,2015,Nevada,MWC,24,318,23,54,20,44,3,10,11,19,21,43,64,2,2,4,18,29,60
16508,Daniel Mortensen,2016,2016,Wright State,Horizon,22,139,21,52,3,8,18,44,0,0,2,15,17,5,1,3,5,17,60
16509,Gaby Ngoundjo,2008,2009,Charlotte,A-10,60,409,22,60,22,59,0,1,16,25,39,37,76,6,11,19,29,76,60
16510,Ozren Pavlovic,2013,2013,Hawaii,Big West,22,195,17,63,8,27,9,36,17,19,9,21,30,8,4,2,21,17,60
16511,Sami Pekkola,2008,2008,St. Francis (NY),NEC,23,198,24,56,22,45,2,11,10,20,16,19,35,5,8,3,13,28,60
16512,Jimmy Ratliff,2019,2019,Siena,MAAC,20,331,21,60,5,8,16,52,2,3,13,18,31,8,7,4,10,21,60
16513,Carlton Reed,2008,2008,Northern Iowa,MVC,17,194,18,56,9,29,9,27,15,18,2,14,16,12,6,0,17,18,60
16514,Matt Rennie,2013,2016,Dartmouth,Ivy,55,395,19,53,19,52,0,1,22,41,40,52,92,15,7,4,18,48,60
16515,Thai Segwai,2019,2019,Central Connecticut State,NEC,24,324,18,47,15,38,3,9,21,31,7,26,33,30,6,0,36,35,60
16516,Stephon Sharp,2016,2017,Minnesota,Big Ten,24,202,19,50,14,33,5,17,17,22,8,6,14,11,2,3,17,18,60
16517,Sam Smithson,2010,2012,Western Carolina,Southern,42,228,26,60,26,59,0,1,8,23,35,24,59,5,8,10,21,39,60
16518,Patrick Strzala,2018,2018,Manhattan,MAAC,27,215,18,55,1,11,17,44,7,7,3,12,15,9,7,0,12,25,60
16519,Howard Thomas,2017,2017,McNeese State,Southland,20,188,24,51,24,51,0,0,12,28,18,23,41,3,7,6,12,20,60
16520,Dorian Tyler,2011,2012,Illinois-Chicago,Horizon,39,283,26,68,23,50,3,18,5,15,23,44,67,10,6,4,18,21,60
16521,Vaidotas Volkus,2008,2008,Missouri,Big 12,28,223,23,52,23,52,0,0,14,18,16,30,46,5,3,6,12,45,60
16522,Travell Washington,2019,2019,Illinois-Chicago,Horizon,28,309,19,54,5,16,14,38,8,18,10,24,34,4,3,4,16,51,60
16523,Dwain Whitfield,2015,2019,Total,SWAC,81,605,25,75,24,71,1,4,9,17,48,43,91,19,6,2,23,79,60
16524,Ice Asortse,2013,2013,Stephen F. Austin,Southland,25,166,23,37,23,37,0,0,13,23,13,15,28,3,8,3,20,31,59
16525,Tyron Bain,2014,2014,Grambling,SWAC,26,225,17,52,16,41,1,11,24,34,11,17,28,13,10,0,25,24,59
16526,Bray Barnes,2016,2019,Cal State Bakersfield,WAC,63,218,17,48,12,21,5,27,20,26,14,22,36,4,2,2,9,48,59
16527,Corban Bates,2008,2008,Army,Patriot,29,443,27,47,24,38,3,9,2,11,30,49,79,25,16,4,23,41,59
16528,Andre Clark,2009,2009,Arkansas,SEC,24,222,22,49,22,47,0,2,15,25,17,25,42,6,5,9,16,25,59
16529,Jake Connor,2016,2018,Utah,Pac-12,36,186,21,51,6,8,15,43,2,6,2,9,11,13,4,2,5,18,59
16530,Josh Davis,2008,2010,Yale,Ivy,35,333,26,50,26,47,0,3,7,18,24,59,83,25,6,10,24,47,59
16531,Paul Djoko,2019,2019,Northern Kentucky,Horizon,35,549,21,49,21,39,0,10,17,32,6,33,39,45,14,22,29,37,59
16532,Denzel Douglas,2013,2013,Idaho,WAC,30,358,20,50,13,27,7,23,12,15,5,42,47,47,15,0,34,16,59
16533,Todd Eaglin,2015,2016,North Texas,CUSA,49,453,19,56,10,20,9,36,12,18,5,36,41,35,16,3,35,51,59
16534,Alden Gibbs,2010,2010,Eastern Washington,Big Sky,23,378,19,66,17,57,2,9,19,36,30,47,77,13,29,3,14,18,59
16535,Luke Hamilton,2019,2019,Mercer,Southern,25,228,21,70,10,26,11,44,6,13,14,24,38,5,4,3,4,19,59
16536,Myles Hanson,2018,2018,Columbia,Ivy,19,200,21,64,9,21,12,43,5,5,8,35,43,8,5,4,8,18,59
16537,Jay Harvey,2018,2019,Total,Total,36,526,22,47,22,47,0,0,15,46,62,45,107,3,6,10,24,68,59
16538,Chandler Hash,2011,2011,South Carolina Upstate,A-Sun,21,177,18,59,2,6,16,53,7,11,2,11,13,10,3,0,25,22,59
16539,Clayton Heuer,2011,2012,Green Bay,Horizon,39,197,23,73,17,32,6,41,7,9,8,17,25,5,9,5,11,26,59
16540,Mitchell Hill,2012,2014,Tennessee Tech,OVC,43,350,18,57,6,19,12,38,11,15,4,13,17,17,11,0,16,23,59
16541,Adam Hood,2008,2008,Air Force,MWC,28,283,10,23,5,14,5,9,34,42,4,25,29,24,9,0,26,37,59
16542,Gregory Horne,2009,2009,Southern,SWAC,26,234,19,66,19,66,0,0,21,38,35,32,67,2,9,9,24,30,59
16543,Cory Jacobsen,2013,2016,South Dakota State,Summit,48,276,19,53,4,7,15,46,6,13,2,17,19,12,3,0,11,15,59
16544,Brice Jenkins,2011,2011,Jacksonville State,OVC,29,357,20,60,11,35,9,25,10,18,14,26,40,18,14,2,16,33,59
16545,Charles Joy,2012,2013,Southern Illinois-Edwardsville,OVC,42,362,24,70,22,51,2,19,9,19,9,44,53,30,3,2,34,44,59
16546,Dylan Karell,2013,2015,Central Florida,Total,66,487,24,43,24,43,0,0,11,35,31,50,81,16,13,18,25,57,59
16547,Dan Kingma,2015,2018,Washington,Pac-12,47,252,18,49,5,15,13,34,10,19,5,17,22,18,5,0,15,28,59
16548,Buay Koka,2018,2019,Tulane,AAC,22,236,26,38,26,38,0,0,7,12,15,36,51,1,7,19,13,46,59
16549,Souleymane Koureissi,2019,2019,Richmond,A-10,26,170,20,39,16,23,4,16,15,26,6,20,26,5,4,0,6,26,59
16550,Josh Linder,2018,2019,Georgia State,Sun Belt,46,198,25,46,25,45,0,1,9,27,22,23,45,6,6,5,19,48,59
16551,Max Livingston,2015,2016,Portland,WCC,35,244,20,57,6,12,14,45,5,7,5,16,21,21,8,1,5,21,59
16552,Ater Majok,2010,2010,Connecticut,Big East,26,383,25,59,25,59,0,0,9,22,32,47,79,4,4,42,21,51,59
16553,Nahjee Matlock,2016,2016,Montana State,Big Sky,30,311,19,73,11,45,8,28,13,20,15,29,44,30,4,2,33,31,59
16554,Patrick McCloskey,2008,2008,Oakland,Summit,31,446,21,40,21,40,0,0,17,29,54,63,117,7,19,4,26,55,59
16555,John Morris,2010,2012,Central Michigan,MAC,52,529,23,66,13,40,10,26,3,6,3,22,25,37,17,0,17,42,59
16556,Mufaro Murinda,2016,2017,Coppin State,MEAC,30,192,19,59,11,22,8,37,13,20,5,18,23,7,2,2,4,14,59
16557,Qon Murphy,2019,2019,Houston Baptist,Southland,21,204,18,68,12,42,6,26,17,28,13,28,41,15,9,5,22,20,59
16558,Rico Myles,2009,2009,Morgan State,MEAC,30,337,23,45,23,44,0,1,13,28,50,56,106,10,6,8,17,47,59
16559,Tre Owens,2013,2014,UC-Riverside,Big West,31,239,19,71,2,11,17,60,4,6,2,20,22,8,5,2,6,9,59
16560,Oliver Prince,2008,2008,Florida A&M,MEAC,6,,24,56,24,56,0,0,11,19,16,23,39,7,4,0,13,21,59
16561,Tyler Riemersma,2018,2018,Navy,Patriot,28,288,20,51,20,46,0,5,19,25,34,43,77,22,11,6,18,20,59
16562,Michael Schlotman,2014,2017,William & Mary,CAA,56,434,15,42,12,35,3,7,26,43,11,33,44,45,15,5,25,43,59
16563,Kam Shephard,2012,2012,North Carolina A&T,MEAC,14,185,22,39,22,39,0,0,15,25,15,20,35,10,4,12,17,30,59
16564,Matt Staubi,2015,2018,Loyola (MD),Patriot,64,404,19,61,8,26,11,35,10,13,1,24,25,63,16,0,44,34,59
16565,Raphell Thomas-Edwards,2012,2013,Buffalo,MAC,38,388,19,56,9,23,10,33,11,18,12,63,75,14,8,3,32,42,59
16566,Brett Thompson,2009,2009,Saint Louis,A-10,30,341,22,55,20,45,2,10,13,18,22,54,76,8,6,16,32,51,59
16567,David Travers,2013,2015,Georgia State,Total,31,250,20,52,9,25,11,27,8,14,2,11,13,24,8,0,14,14,59
16568,Brett VandenBergh,2013,2013,North Dakota State,Summit,32,505,20,50,4,13,16,37,3,8,8,41,49,24,11,7,15,35,59
16569,Bill Weaver,2009,2010,Liberty,Big South,56,324,27,57,27,57,0,0,5,15,22,26,48,9,12,2,17,32,59
16570,Jason West,2010,2010,Texas Southern,SWAC,18,152,21,50,12,26,9,24,8,13,4,10,14,8,12,0,16,24,59
16571,Donovan Williams,2012,2015,Louisiana,Sun Belt,32,136,19,50,9,20,10,30,11,16,9,12,21,10,12,2,9,11,59
16572,Kobe Wilson,2019,2019,Arkansas State,Sun Belt,25,245,19,64,6,23,13,41,8,14,2,12,14,9,4,1,13,26,59
16573,Pernell Adgei,2016,2019,Total,Total,36,328,19,46,19,45,0,1,20,36,32,52,84,12,10,1,16,60,58
16574,Andrew Bargmann,2014,2017,Colgate,Patriot,38,249,19,42,10,15,9,27,11,14,3,27,30,12,11,0,12,21,58
16575,Corey Barrett,2015,2015,Central Connecticut State,NEC,27,282,25,68,25,68,0,0,8,16,26,41,67,3,3,9,12,39,58
16576,Justin Blevins,2008,2008,Central Michigan,MAC,30,355,24,58,24,58,0,0,10,23,21,18,39,4,2,5,21,46,58
16577,Dillon Boggs,2008,2009,Gardner-Webb,Total,35,218,21,64,9,30,12,34,4,6,5,12,17,18,4,0,13,25,58
16578,Joe Bright,2012,2013,Stephen F. Austin,Southland,39,382,16,52,15,43,1,9,25,36,26,30,56,16,11,4,21,38,58
16579,Jordan Brown,2014,2015,Arkansas-Pine Bluff,SWAC,41,288,25,51,25,51,0,0,8,21,22,30,52,6,7,2,5,23,58
16580,Zach Brown,2010,2011,Lipscomb,A-Sun,39,347,21,54,14,24,7,30,9,10,4,24,28,47,7,1,40,29,58
16581,Robert Burger,2013,2013,Savannah State,MEAC,34,437,21,63,12,29,9,34,7,15,11,19,30,13,29,0,28,39,58
16582,Brandon Chauca,2015,2016,University of California,Pac-12,31,248,20,56,7,17,13,39,5,8,1,14,15,20,3,0,23,25,58
16583,Joey De La Rosa,2012,2015,Total,Total,55,350,24,61,24,61,0,0,10,28,24,45,69,4,4,13,22,57,58
16584,Abdul Dial,2016,2019,Total,Total,24,174,22,49,19,34,3,15,11,16,15,20,35,7,2,2,7,20,58
16585,Baba Diallo,2011,2011,Centenary (LA),Summit,29,317,21,52,20,42,1,10,15,27,15,17,32,8,8,2,22,36,58
16586,Alex Dubovitskiy,2017,2018,Chicago State,WAC,46,381,20,59,8,17,12,42,6,11,13,23,36,7,10,1,20,63,58
16587,Larry Dumas,2008,2008,Western Illinois,Summit,25,235,17,37,17,37,0,0,24,39,12,21,33,21,12,0,15,31,58
16588,Destin Dunton,2019,2019,Southern,SWAC,19,320,17,47,17,39,0,8,24,34,8,20,28,25,16,1,21,34,58
16589,Marquis Duvall,2008,2008,Charleston Southern,Big South,19,234,21,42,21,41,0,1,16,24,22,46,68,5,7,4,17,35,58
16590,Jamal Evans,2016,2016,Northern Colorado,Big Sky,16,128,21,45,11,27,10,18,6,11,8,20,28,1,0,5,10,29,58
16591,A'Torey Everett,2017,2017,Tennessee State,OVC,24,233,17,44,13,37,4,7,20,25,3,18,21,17,2,1,19,33,58
16592,Brice Gallow,2008,2008,Long Beach State,Big West,26,299,21,46,16,28,5,18,11,14,6,24,30,21,11,2,24,24,58
16593,K.C. Goodwin,2014,2015,Southern Illinois,MVC,24,418,16,63,4,26,12,37,14,21,5,33,38,21,14,0,33,46,58
16594,Jacobi Gordon,2019,2019,University of California,Pac-12,25,241,15,49,8,21,7,28,21,28,18,24,42,5,2,1,17,26,58
16595,Vlatko Granic,2017,2017,Loyola (IL),MVC,24,222,23,49,17,29,6,20,6,15,12,19,31,6,5,4,8,24,58
16596,Clayfell Harris,2008,2011,Wagner,NEC,55,304,25,50,25,50,0,0,8,13,12,31,43,7,2,19,29,74,58
16597,Christopher Ikuenobe,2016,2016,Texas-Rio Grande Valley,WAC,27,209,23,44,23,44,0,0,12,22,12,19,31,7,4,7,10,32,58
16598,Iziah James,2018,2018,Cal Poly,Big West,26,247,18,54,10,32,8,22,14,16,3,17,20,17,9,1,21,31,58
16599,Kur Jockuch,2019,2019,Northern Colorado,Big Sky,28,237,20,40,20,40,0,0,18,37,27,33,60,10,5,3,17,47,58
16600,Matt Johnson,2009,2012,Columbia,Ivy,69,482,19,73,10,22,9,51,11,15,12,53,65,16,11,4,29,90,58
16601,Kevin Jones,2008,2008,Chicago State,Ind,20,277,20,73,6,22,14,51,4,7,2,21,23,23,7,0,13,11,58
16602,James King,2012,2014,Texas A&M-Corpus Christi,Southland,54,344,19,75,6,26,13,49,7,11,7,16,23,14,6,2,15,45,58
16603,Brett Kingma,2012,2012,Oregon,Pac-12,19,186,21,68,6,20,15,48,1,3,8,8,16,7,7,0,5,12,58
16604,Adam Kunkel,2019,2019,Belmont,OVC,25,232,17,53,6,13,11,40,13,15,2,14,16,17,11,2,9,22,58
16605,Nesho Milosevic,2010,2010,Western Kentucky,Sun Belt,27,208,25,52,25,51,0,1,8,18,17,27,44,1,1,3,23,35,58
16606,Jarvis Moore,2012,2012,Alcorn State,SWAC,20,280,23,58,18,48,5,10,7,8,7,15,22,30,18,1,35,23,58
16607,Jonathan Moore,2009,2009,Stony Brook,AEC,14,245,17,72,2,17,15,55,9,14,3,18,21,7,10,0,10,20,58
16608,Mike Nwabuzor,2017,2017,Texas-Rio Grande Valley,WAC,30,271,18,62,13,42,5,20,17,24,6,34,40,19,12,2,22,31,58
16609,Tyree Pickron,2019,2019,Quinnipiac,MAAC,28,280,20,82,6,21,14,61,4,10,6,20,26,10,8,1,10,19,58
16610,Khyan Rayner,2014,2017,Princeton,Ivy,57,236,16,51,6,20,10,31,16,28,3,16,19,10,8,1,11,28,58
16611,DeMarc Richardson,2013,2014,Tennessee-Martin,OVC,49,566,21,57,20,49,1,8,15,27,14,22,36,57,13,2,42,47,58
16612,Archie Rose,2008,2009,Brigham Young,MWC,37,194,14,41,11,27,3,14,27,39,15,32,47,10,5,1,22,32,58
16613,Christien Sager,2012,2015,Oklahoma State,Big 12,79,384,16,45,6,12,10,33,16,35,22,36,58,16,12,2,11,44,58
16614,Teddy Schickel,2010,2012,NJIT,GWC,36,409,20,76,17,59,3,17,15,19,14,30,44,33,31,1,25,46,58
16615,Eddie Scott,2018,2019,Pennsylvania,Ivy,28,181,22,50,16,31,6,19,8,20,15,27,42,7,6,1,15,24,58
16616,Miles Seward,2016,2016,Northern Colorado,Big Sky,18,136,18,41,9,18,9,23,13,14,4,11,15,5,3,0,12,12,58
16617,Cameron Spencer,2008,2010,Total,Total,52,418,21,45,21,45,0,0,16,23,34,80,114,15,12,13,17,49,58
16618,Terron Sutton,2008,2008,Loyola Marymount,WCC,26,297,25,55,25,55,0,0,8,21,22,43,65,3,8,10,25,28,58
16619,Azariah Sykes,2017,2018,Morgan State,MEAC,48,657,16,29,16,27,0,2,26,51,56,115,171,9,13,12,16,118,58
16620,Flo Thamba,2019,2019,Baylor,Big 12,33,331,21,39,21,39,0,0,16,30,31,41,72,11,6,21,24,57,58
16621,Thorir Thorbjarnarson,2018,2019,Nebraska,Big Ten,34,323,22,63,16,35,6,28,8,12,11,46,57,32,15,5,14,29,58
16622,Nicholas Timberlake,2019,2019,Towson,CAA,9,181,23,58,18,37,5,21,7,13,8,17,25,12,8,0,9,17,58
16623,Chidi Udengwu,2019,2019,Idaho State,Big Sky,17,158,20,40,20,40,0,0,18,29,14,44,58,11,5,1,19,20,58
16624,Parker Van Dyke,2014,2014,Utah,Pac-12,23,226,21,47,12,20,9,27,7,7,3,13,16,23,4,2,10,11,58
16625,Riley Voss,2018,2019,Cornell,Ivy,31,241,22,66,13,29,9,37,5,10,13,30,43,26,1,0,11,27,58
16626,Austin Williams,2017,2019,Yale,Ivy,33,199,27,48,25,43,2,5,2,6,11,17,28,7,2,3,4,30,58
16627,Patrick Ackerman,2012,2015,Total,Total,56,406,26,58,26,58,0,0,5,8,8,39,47,2,7,18,14,70,57
16628,James Albright,2011,2011,Cal State Bakersfield,Ind,21,198,23,56,14,28,9,28,2,11,13,10,23,6,3,3,11,46,57
16629,Ky're Allison,2017,2017,Marshall,CUSA,23,194,21,56,11,25,10,31,5,7,3,14,17,17,6,1,21,44,57
16630,Richard Anderson,2017,2019,Total,Total,20,215,20,58,10,23,10,35,7,9,4,10,14,13,12,0,10,22,57
16631,Chris Avenant,2011,2014,Northeastern,CAA,61,386,21,62,12,27,9,35,6,8,13,21,34,13,11,5,21,68,57
16632,Ishmael Awange,2009,2010,Texas-Arlington,Southland,48,401,21,40,21,40,0,0,15,33,33,54,87,5,5,25,36,87,57
16633,Rechon Black,2019,2019,North Carolina,ACC,23,237,23,49,18,37,5,12,6,7,10,39,49,27,14,4,15,27,57
16634,Bret Brielmaier,2008,2008,Arizona,Pac-10,21,306,25,35,25,35,0,0,7,13,20,40,60,11,4,2,4,31,57
16635,Manuel Cass,2008,2008,Texas-El Paso,CUSA,13,160,17,55,9,23,8,32,15,19,9,16,25,6,4,1,12,21,57
16636,Danny Cohen,2016,2017,New Orleans,Southland,37,233,18,54,7,23,11,31,10,11,11,21,32,6,2,1,16,19,57
16637,Jacques Coleman,2013,2013,Omaha,Summit,25,171,20,47,17,35,3,12,14,23,3,19,22,14,11,0,23,21,57
16638,Nate Cooper,2008,2010,Howard,MEAC,77,608,18,42,18,42,0,0,21,46,21,54,75,13,6,13,26,111,57
16639,Zach Farquhar,2017,2019,Liberty,Total,56,169,17,30,2,3,15,27,8,11,0,17,17,7,3,1,3,10,57
16640,Georges Fotso,2008,2010,Murray State,OVC,71,457,21,45,21,45,0,0,15,29,42,35,77,7,11,8,22,91,57
16641,Jerami Grace,2017,2017,Murray State,OVC,26,219,18,66,6,19,12,47,9,13,8,21,29,9,8,1,11,33,57
16642,Jonathan Guevara,2018,2018,Cal State Northridge,Big West,25,391,19,61,13,41,6,20,13,25,1,27,28,28,7,1,21,34,57
16643,Dean Hadley,2008,2008,San Francisco,WCC,30,385,22,71,22,53,0,18,13,18,16,28,44,21,8,0,32,39,57
16644,Raphael Hall,2008,2009,Norfolk State,MEAC,30,159,21,59,8,23,13,36,2,5,8,14,22,3,6,0,3,14,57
16645,Dwayne Harvey,2011,2011,Alabama State,SWAC,23,312,14,45,8,30,6,15,23,41,12,20,32,47,8,5,34,33,57
16646,Elijah Hazekamp,2019,2019,North Dakota,Summit,16,106,19,36,8,13,11,23,8,11,7,23,30,4,5,2,6,8,57
16647,Crandall Head,2011,2014,Total,Total,55,348,22,73,18,47,4,26,9,14,7,26,33,33,12,1,34,40,57
16648,Johnny Higgins,2011,2011,Marshall,CUSA,26,264,10,37,8,26,2,11,35,44,2,22,24,36,14,2,24,26,57
16649,Jonathan Hood,2015,2016,Eastern Kentucky,OVC,20,160,19,52,5,13,14,39,5,6,3,11,14,6,7,0,4,9,57
16650,Anand Hundal,2019,2019,Seattle,WAC,25,207,22,47,12,16,10,31,3,6,15,30,45,6,4,15,7,29,57
16651,Andre Jackson,2012,2012,Cal State Bakersfield,Ind,14,116,26,53,26,53,0,0,5,11,4,20,24,0,3,5,8,24,57
16652,Tristan Jarrett,2018,2018,Kennesaw State,A-Sun,12,149,21,69,14,39,7,30,8,13,8,19,27,8,4,3,22,10,57
16653,Dytanya Johnson,2011,2011,NJIT,GWC,25,252,21,48,21,47,0,1,15,26,25,45,70,4,8,10,28,54,57
16654,Jonathan Joseph,2015,2015,Stetson,A-Sun,15,218,20,42,16,28,4,14,13,23,12,27,39,5,3,7,21,32,57
16655,Taavi Jurkatamm,2018,2019,San Francisco,WCC,57,539,26,65,23,52,3,13,2,11,32,63,95,27,14,21,22,86,57
16656,Ausar Madison,2014,2017,Howard,MEAC,45,485,17,54,14,39,3,15,20,37,12,35,47,56,28,0,49,56,57
16657,Aleksa Matic,2019,2019,North Alabama,A-Sun,22,198,18,55,5,17,13,38,8,8,1,11,12,8,5,1,17,17,57
16658,Jacob McCord,2018,2018,Idaho State,Big Sky,18,139,21,57,19,47,2,10,13,20,20,28,48,4,4,1,18,19,57
16659,Edwind McGhee,2011,2014,DePaul,Big East,69,350,15,52,8,25,7,27,20,29,14,31,45,21,16,4,16,27,57
16660,Darius Morales,2011,2012,East Carolina,CUSA,48,262,25,49,25,49,0,0,7,16,17,38,55,1,4,25,17,57,57
16661,Chidozie Ndu,2018,2019,Sam Houston State,Southland,40,195,22,33,22,33,0,0,13,24,12,24,36,3,3,12,7,34,57
16662,Rozelle Nix,2017,2018,Total,Total,33,246,24,55,24,55,0,0,9,15,29,48,77,5,1,6,25,54,57
16663,Demarco Owens,2018,2018,McNeese State,Southland,19,135,20,49,20,47,0,2,17,32,14,23,37,7,4,1,18,18,57
16664,Erick Peguero,2010,2010,Tennessee State,OVC,20,192,21,61,21,47,0,14,15,30,10,23,33,9,9,4,22,25,57
16665,Patrick Souter,2010,2011,Milwaukee,Horizon,39,274,20,56,17,46,3,10,14,24,13,17,30,24,8,3,18,22,57
16666,Ronnie Steward,2009,2010,Akron,MAC,36,300,24,60,18,40,6,20,3,10,2,14,16,31,5,0,24,24,57
16667,Michael Strittmatter,2008,2009,Princeton,Ivy,21,196,25,50,22,39,3,11,4,9,1,12,27,13,7,1,7,1,57
16668,Derrek Tartt,2010,2011,Albany (NY),AEC,46,347,19,51,13,32,6,19,13,22,7,25,32,27,11,2,36,33,57
16669,Brandon Thomas,2018,2019,Hawaii,Big West,36,270,19,66,10,23,9,43,10,19,6,17,23,12,4,1,8,24,57
16670,Justin Tucker,2017,2017,Wofford,Southern,27,249,20,49,20,48,0,1,17,28,20,20,40,6,4,2,10,24,57
16671,Nick Turner,2011,2012,Kennesaw State,A-Sun,36,315,20,82,6,31,14,51,3,8,9,16,25,18,4,1,26,21,57
16672,Aron Walker,2011,2011,Prairie View,SWAC,24,161,21,46,21,46,0,0,15,25,11,21,32,0,2,5,9,21,57
16673,Adam Webb,2018,2019,Stetson,A-Sun,37,234,21,44,21,44,0,0,15,21,24,31,55,2,2,28,25,45,57
16674,Jared White,2013,2013,Southeast Missouri State,OVC,25,207,17,35,13,30,4,5,19,22,3,18,21,22,4,0,25,30,57
16675,Dima Zdor,2019,2019,Weber State,Big Sky,28,156,22,36,21,33,1,3,12,25,18,37,55,1,0,11,6,32,57
16676,Patrick Agho,2011,2014,Total,Total,40,224,22,47,22,47,0,0,12,32,14,32,46,3,3,7,19,40,56
16677,Austin Allen,2012,2012,Arkansas-Pine Bluff,SWAC,25,211,19,50,19,49,0,1,18,33,29,23,52,2,13,4,11,39,56
16678,Agustin Ambrosino,2013,2013,Brigham Young,WCC,31,191,20,52,9,18,11,34,5,10,10,33,43,8,3,2,13,23,56
16679,Travis Avery,2013,2016,New Orleans,Total,63,196,21,48,21,48,0,0,14,29,10,26,36,13,7,6,12,36,56
16680,Nenad Banjanin,2008,2008,Eastern Michigan,MAC,26,293,22,47,21,44,1,3,11,24,16,16,32,7,4,1,17,28,56
16681,Shikei Blake,2016,2016,Montana State,Big Sky,24,219,19,45,19,45,0,0,18,24,22,26,48,1,5,2,13,53,56
16682,J'Raan Brooks,2019,2019,Southern California,Pac-12,28,229,23,52,17,35,6,17,4,9,5,30,35,7,1,1,11,33,56
16683,Terdarin Bryson,2010,2010,Grambling,SWAC,28,319,18,53,13,36,5,17,15,19,12,37,49,17,20,9,24,40,56
16684,Nigel Carter,2009,2011,University of California,Pac-10,40,237,19,50,11,26,8,24,10,22,10,21,31,4,2,1,11,25,56
16685,Parker Chitty,2017,2017,Eastern Kentucky,OVC,30,348,17,63,9,16,8,47,14,22,2,38,40,35,10,2,27,54,56
16686,Elijah Clarance,2018,2018,Illinois State,MVC,21,233,16,66,14,43,2,23,22,31,3,19,22,27,10,1,32,29,56
16687,James Cotton,2010,2010,Maryland-Eastern Shore,MEAC,19,265,15,34,15,32,0,2,26,41,13,38,51,8,11,5,17,45,56
16688,Chandler Davis,2019,2019,Texas State,Sun Belt,27,184,24,51,24,50,0,1,8,18,26,17,43,14,3,2,15,39,56
16689,Julian Demalleville,2012,2013,Sacramento State,Big Sky,57,554,17,51,7,15,10,36,12,19,3,50,53,52,20,2,32,58,56
16690,Joe Duffy,2008,2011,Vanderbilt,SEC,52,219,20,46,17,40,3,6,13,17,13,26,39,11,5,1,12,29,56
16691,Ross Erickson,2010,2011,Hartford,AEC,45,343,19,66,11,31,8,35,10,14,10,17,27,12,7,2,16,23,56
16692,Zieyik Estime,2013,2014,Norfolk State,MEAC,29,148,19,59,3,9,16,50,2,2,6,6,12,1,1,0,6,13,56
16693,Nicolas Fennell,2019,2019,North Carolina Central,MEAC,23,186,20,31,15,19,5,12,11,20,12,20,32,14,15,3,10,30,56
16694,Jordan Goldwire,2018,2019,Duke,ACC,61,470,21,72,13,28,8,44,6,10,9,30,39,47,29,0,19,49,56
16695,Malik Gray,2015,2015,Norfolk State,MEAC,20,172,18,47,4,12,14,35,6,16,3,20,23,4,5,3,11,32,56
16696,Brent Hank,2019,2019,Albany (NY),AEC,31,438,21,41,21,41,0,0,14,29,42,60,102,13,14,7,29,69,56
16697,Robby Hanzlik,2008,2008,Maine,AEC,21,288,20,76,12,31,8,45,8,12,4,21,25,26,27,1,45,37,56
16698,Malek Harris,2015,2015,Kansas State,Big 12,27,336,21,53,21,50,0,3,14,23,17,33,50,14,2,0,18,38,56
16699,Jason Hight,2008,2008,Maine,AEC,16,324,20,49,10,22,10,27,6,7,4,35,39,39,18,0,44,29,56
16700,Daniel Huggins,2008,2009,Jackson State,SWAC,38,202,19,83,9,24,10,59,8,12,12,14,26,7,13,0,23,31,56
16701,Corey Jackson,2011,2012,Long Beach State,Big West,39,161,17,51,11,33,6,18,16,25,2,11,13,6,3,1,14,8,56
16702,Kyle Jones,2009,2013,Arkansas-Pine Bluff,SWAC,56,383,18,66,1,4,17,62,3,8,6,11,17,20,8,0,21,22,56
16703,Tanner Kerry,2010,2011,Pepperdine,WCC,40,352,17,53,17,53,0,0,22,31,24,27,51,6,2,5,16,67,56
16704,Joe Kirby,2015,2018,Richmond,A-10,58,306,23,66,13,24,10,42,0,1,22,33,55,16,9,2,12,32,56
16705,Derrek Lewis,2008,2011,Texas A&M,Big 12,47,209,19,44,7,15,12,29,6,8,14,14,28,14,4,1,11,22,56
16706,Foster Loyer,2019,2019,Michigan State,Big Ten,35,207,18,44,10,17,8,27,12,13,1,13,14,32,4,0,20,25,56
16707,Joshua Mack,2008,2010,Total,Total,23,188,20,62,10,26,10,36,6,7,3,22,25,32,12,1,29,21,56
16708,Thomas Manzano,2010,2010,Wyoming,MWC,8,141,20,48,18,27,2,21,14,24,6,12,18,11,4,0,6,9,56
16709,Brandon McGhee,2019,2019,Pacific,WCC,28,390,23,52,22,46,1,6,9,16,25,32,57,33,21,4,16,23,56
16710,L.J. McIntosh,2014,2014,Texas-Rio Grande Valley,WAC,25,246,19,73,8,21,11,52,7,11,1,15,16,16,12,2,12,24,56
16711,Dwight Miller,2012,2012,Tennessee,SEC,23,161,25,49,21,41,4,8,2,8,18,17,35,1,6,14,4,20,56
16712,Andy Nagel,2010,2011,North Dakota State,Summit,43,318,22,47,22,45,0,2,12,23,31,23,54,8,2,1,14,61,56
16713,Anthony Phillip,2010,2011,Western Carolina,Southern,21,141,20,49,14,33,6,16,10,18,13,12,25,14,6,3,10,22,56
16714,Shane Porchea,2011,2012,South Carolina Upstate,A-Sun,36,277,20,67,15,45,5,22,11,21,17,23,40,11,6,2,16,34,56
16715,Jelani Poston,2009,2009,Illinois-Chicago,Horizon,15,137,19,30,19,30,0,0,18,28,21,18,39,2,3,2,10,20,56
16716,Lance Richard,2015,2018,Louisiana-Monroe,Sun Belt,49,158,19,58,1,3,18,55,0,0,1,9,10,6,6,1,9,7,56
16717,Isaiah Rollins,2019,2019,Southern,SWAC,26,249,20,66,13,35,7,31,9,13,5,21,26,10,8,1,12,23,56
16718,Eric Schiele,2008,2009,Cleveland State,Horizon,18,147,18,49,8,21,10,28,10,15,3,18,21,7,9,1,13,8,56
16719,Braiden Shaw,2016,2018,Brigham Young,WCC,51,260,21,37,21,37,0,0,14,32,29,46,75,8,14,2,14,41,56
16720,Jordan Shea,2015,2017,Massachusetts-Lowell,AEC,32,292,21,51,15,30,6,21,8,11,5,25,30,20,7,3,16,41,56
16721,Greg Williams Jr.,2019,2019,St. John's (NY),Big East,28,236,20,40,17,25,3,15,13,18,9,18,27,11,8,5,15,34,56
16722,Ja'Cori Wilson,2019,2019,Morehead State,OVC,28,221,20,50,10,19,10,31,6,9,21,35,56,4,7,7,13,35,56
16723,Matthew Wilson,2009,2010,American,Patriot,44,324,14,30,14,29,0,1,28,41,13,32,45,28,4,1,23,55,56
16724,Brian Addison,2008,2009,Buffalo,MAC,34,224,23,54,22,50,1,4,8,22,29,39,68,6,5,13,14,46,55
16725,Allen Aragbaye,2008,2009,Northeastern,CAA,31,141,14,40,9,25,5,15,22,23,5,14,19,6,6,2,14,21,55
16726,Ted Bancroft,2011,2015,Providence,Big East,93,563,19,69,11,24,8,45,9,22,29,55,84,17,27,4,25,71,55
16727,Ryan Bennett,2008,2008,Sam Houston State,Southland,15,252,15,50,11,25,4,25,21,31,4,22,26,48,15,2,33,22,55
16728,Klay Brown,2019,2019,Saint Peter's,MAAC,25,349,18,59,9,22,9,37,10,18,11,40,51,15,19,10,24,43,55
16729,Vernon Carr,2008,2009,Towson,CAA,31,405,22,82,15,42,7,40,4,9,3,24,27,41,15,1,26,25,55
16730,D'Marnier Cunningham,2015,2015,Memphis,AAC,20,217,22,59,19,49,3,10,8,11,3,12,15,33,15,4,22,22,55
16731,Joe Ebondo,2014,2015,Old Dominion,CUSA,51,641,22,53,22,53,0,0,11,26,57,76,133,10,16,5,23,96,55
16732,Oladapo Fagbenle,2008,2008,Campbell,A-Sun,29,309,24,47,24,46,0,1,7,16,29,43,72,16,8,24,21,53,55
16733,Bahrom Firozgary,2013,2014,Rice,CUSA,45,319,16,31,16,31,0,0,23,36,19,28,47,5,3,4,19,73,55
16734,Terron Gilmore,2013,2016,Murray State,OVC,51,338,18,38,18,38,0,0,19,31,19,37,56,4,11,8,25,74,55
16735,Marcus Goode,2009,2009,Marshall,CUSA,13,106,24,40,24,37,0,3,7,14,17,20,37,1,3,8,9,18,55
16736,Spencer Goodman,2011,2012,North Dakota,GWC,14,224,16,46,9,22,7,24,16,19,6,34,40,5,4,1,18,23,55
16737,Gabe Hadley,2018,2018,New Mexico State,WAC,22,138,19,49,3,8,16,41,1,2,1,10,11,4,2,1,4,2,55
16738,Brady Heiman,2019,2019,Nebraska,Big Ten,30,257,25,42,25,41,0,1,5,17,23,29,52,4,3,15,7,32,55
16739,Cody Henegar,2011,2012,North Carolina-Greensboro,Southern,33,196,21,64,15,43,6,21,7,12,13,25,38,1,2,6,8,13,55
16740,Brandon Herman,2012,2012,Robert Morris,NEC,30,293,21,63,16,42,5,21,8,18,7,23,30,20,8,0,19,23,55
16741,Alex Holcombe,2017,2019,Total,Total,44,242,24,46,24,46,0,0,7,17,23,30,53,4,3,23,10,42,55
16742,Zachary Jackson,2015,2016,Alabama A&M,SWAC,27,205,21,56,16,35,5,21,8,17,11,14,25,8,7,4,10,24,55
16743,Jalen Johnson,2018,2019,Tennessee,SEC,39,217,20,40,8,14,12,26,3,5,10,19,29,13,4,3,8,17,55
16744,Tyler Jones,2018,2019,Fairleigh Dickinson,NEC,45,263,17,50,5,17,12,33,9,12,5,15,20,22,18,0,23,38,55
16745,Ivan Jurkovic,2013,2014,Florida International,Total,48,326,21,55,21,51,0,4,13,18,20,26,46,3,5,3,23,63,55
16746,Konstantin Kulikov,2018,2018,Incarnate Word,Southland,14,190,24,52,24,50,0,2,7,11,16,31,47,6,2,18,19,22,55
16747,Joel Lindberg,2012,2012,North Dakota State,Summit,28,443,18,39,14,28,4,11,15,15,4,25,29,38,7,2,18,59,55
16748,Ricky Lindo,2019,2019,Maryland,Big Ten,34,416,20,52,18,40,2,12,13,25,30,89,119,12,15,15,18,57,55
16749,K.J. Malveau,2016,2016,Texas State,Sun Belt,31,250,16,52,5,18,11,34,12,15,1,21,22,17,8,0,23,18,55
16750,Mack McKearney,2012,2013,Dartmouth,Ivy,46,371,14,61,7,26,7,35,20,28,4,30,34,35,18,3,25,29,55
16751,Kevin McNeal,2019,2019,Cal State Bakersfield,WAC,30,240,24,66,22,55,2,11,5,17,15,22,37,6,6,1,16,27,55
16752,Grayson Moore,2016,2016,Utah State,MWC,18,252,17,48,10,23,7,25,14,21,23,40,63,21,8,8,13,18,55
16753,Jermaine Morgan,2015,2015,Bradley,MVC,22,267,21,62,21,61,0,1,13,28,24,35,59,4,9,4,20,54,55
16754,Tevah Morris,2008,2008,Green Bay,Horizon,30,256,19,37,19,37,0,0,17,22,15,36,51,3,3,3,18,31,55
16755,Marquis Nelson,2015,2016,Nicholls State,Southland,38,294,21,65,10,32,11,33,2,8,7,21,28,12,7,2,25,29,55
16756,Ben Olayinka,2012,2013,Northern Arizona,Big Sky,30,265,21,44,21,44,0,0,13,25,21,31,52,7,3,17,21,46,55
16757,D.J. Peavy,2019,2019,Mercer,Southern,18,133,18,33,8,16,10,17,9,11,1,11,12,11,3,0,13,21,55
16758,Christian Peterson,2010,2012,UC-Santa Barbara,Big West,50,476,16,45,15,44,1,1,22,34,45,48,93,17,16,1,26,67,55
16759,Joe Posey,2008,2008,James Madison,CAA,16,238,20,67,9,19,11,48,4,7,7,17,24,13,2,3,9,21,55
16760,Reggie Price,2013,2014,Hampton,MEAC,33,198,21,69,9,25,12,44,1,4,12,21,33,3,5,0,11,10,55
16761,De'Vaughn Reid,2013,2015,Holy Cross,Patriot,39,293,17,54,13,41,4,13,17,24,3,21,24,26,9,1,23,22,55
16762,Da'Shawn Robinson,2016,2018,Total,Total,29,227,19,61,12,30,7,31,10,19,4,22,26,30,12,2,11,24,55
16763,Raivis Scerbinskis,2018,2019,Winthrop,Big South,22,115,17,50,0,3,17,47,4,6,7,15,22,5,1,1,4,12,55
16764,Edgar Segura,2008,2008,Green Bay,Horizon,25,334,21,68,13,35,8,33,5,7,7,17,24,40,8,0,29,30,55
16765,Austin Smellie,2019,2019,Idaho State,Big Sky,29,342,16,38,7,14,9,24,14,17,8,23,31,21,8,0,13,23,55
16766,Khalea Turner-Morris,2018,2019,Massachusetts,A-10,36,225,22,35,22,35,0,0,11,22,22,35,57,5,1,8,15,43,55
16767,Alton Williams,2011,2012,Austin Peay,OVC,19,133,18,39,3,6,15,33,4,5,1,11,12,5,2,0,1,4,55
16768,LaRond Williams,2017,2018,Long Beach State,Big West,36,281,20,55,20,55,0,0,15,26,22,37,59,4,10,22,25,72,55
16769,Tiremone Williams,2015,2016,Louisiana,Sun Belt,56,395,18,52,15,33,3,19,16,29,4,32,36,32,18,1,21,42,55
16770,Jihad Wright,2012,2012,Campbell,Big South,18,158,14,30,14,29,0,1,27,36,21,12,33,6,4,1,6,16,55
16771,Arthur Zulu,2009,2010,Sam Houston State,Southland,45,264,25,50,25,50,0,0,5,10,18,31,49,7,9,12,15,53,55
16772,Drew Absher,2011,2014,Virginia Military Institute,Big South,42,176,16,47,7,15,9,32,13,17,2,15,17,18,2,0,15,13,54
16773,Kellen Blake,2015,2018,Winthrop,Big South,45,91,21,40,14,22,7,18,5,10,8,5,13,5,4,0,4,3,54
16774,Devorious Brown,2017,2018,Florida Atlantic,CUSA,34,326,19,61,19,52,0,9,16,24,14,28,42,26,18,1,31,33,54
16775,Crisshawn Clark,2019,2019,Portland,WCC,16,264,17,69,7,30,10,39,10,13,11,31,42,12,6,0,14,21,54
16776,Matt Conway,2018,2018,Albany (NY),AEC,23,200,22,49,19,35,3,14,7,13,12,14,26,6,1,5,8,19,54
16777,Mitchell Deter,2011,2014,Charleston Southern,Big South,47,188,18,48,3,6,15,42,3,4,6,25,31,12,3,0,7,13,54
16778,Uche Dibiamaka,2019,2019,Texas-Rio Grande Valley,WAC,30,298,21,64,18,40,3,24,9,14,7,24,31,15,6,5,15,35,54
16779,Gaston Diedhiou,2015,2018,Minnesota,Big Ten,57,361,23,57,23,52,0,5,8,16,19,30,49,5,7,8,12,51,54
16780,Brent Eaton,2009,2009,Green Bay,Horizon,27,183,19,50,7,20,12,30,4,4,5,8,13,8,5,1,10,20,54
16781,Brad Farrell,2009,2009,Loyola (MD),MAAC,28,401,22,65,21,60,1,5,9,12,23,38,61,12,13,5,24,49,54
16782,Joel Fiegler,2015,2015,Central Arkansas,Southland,28,304,22,50,22,47,0,3,10,13,11,50,61,13,8,27,35,57,54
16783,Taylor Gagnon,2008,2008,East Carolina,CUSA,25,318,17,47,15,42,2,5,18,24,28,29,57,5,8,2,14,55,54
16784,Brian Gibson,2011,2011,Wyoming,MWC,23,192,22,35,22,35,0,0,10,23,31,45,76,1,7,4,6,28,54
16785,Tae Hardy,2019,2019,East Carolina,AAC,23,271,18,54,12,33,6,21,12,27,3,27,30,15,12,3,13,26,54
16786,Hank Harris,2008,2008,Southeast Missouri State,OVC,25,350,15,40,11,26,4,14,20,29,6,21,27,42,27,1,23,25,54
16787,Toles Hartman,2011,2011,North Carolina-Asheville,Big South,25,215,22,38,22,37,0,1,10,20,17,24,41,12,4,5,16,39,54
16788,James Herrick,2015,2018,Sacramento State,Big Sky,51,197,19,42,19,42,0,0,16,29,16,37,53,2,2,3,14,36,54
16789,Justin Hollins,2016,2016,Cal State Bakersfield,WAC,32,383,23,44,23,44,0,0,8,20,24,59,83,3,7,60,24,65,54
16790,Brian Holmes,2011,2011,North Florida,A-Sun,16,190,17,40,14,31,3,9,17,27,5,19,24,15,6,0,30,18,54
16791,Nick Jackson,2011,2012,Dartmouth,Ivy,27,235,21,64,11,37,10,27,2,2,2,14,16,4,6,4,19,14,54
16792,Mahir Johnson,2016,2017,Delaware State,MEAC,16,126,23,47,19,39,4,8,4,6,7,7,14,4,3,0,10,13,54
16793,Tremaine Johnson,2008,2009,Delaware State,MEAC,36,217,20,51,18,37,2,14,12,16,10,17,27,4,5,0,21,25,54
16794,Austin Karazsia,2014,2015,South Alabama,Sun Belt,43,282,19,49,12,25,7,24,9,17,14,32,46,3,4,3,11,38,54
16795,Harrison Kay,2017,2019,Central Connecticut State,NEC,44,277,20,58,16,46,4,12,10,18,13,28,41,8,5,3,23,54,54
16796,Jarrel Lane,2012,2013,Maryland-Baltimore County,AEC,31,519,23,79,22,62,1,17,7,16,10,23,33,51,22,0,46,38,54
16797,Zach Monaghan,2012,2012,South Dakota State,Summit,25,192,16,56,8,23,8,33,14,21,4,10,14,14,4,0,20,6,54
16798,Abdou Niang,2010,2011,Western Illinois,Summit,41,449,20,81,14,43,6,38,8,13,13,48,61,9,3,9,25,71,54
16799,Greg Noack,2014,2014,Monmouth,MAAC,27,209,24,40,24,40,0,0,6,8,14,27,41,6,10,0,8,37,54
16800,Augustine Okosun,2008,2008,Seton Hall,Big East,30,292,23,42,23,42,0,0,8,27,31,30,61,5,8,31,13,63,54
16801,Julian Powell,2018,2018,Saint Peter's,MAAC,30,254,23,43,22,34,1,9,7,10,16,30,46,9,8,14,15,44,54
16802,Domas Rinksalis,2010,2012,Wofford,Southern,38,269,15,36,15,36,0,0,24,42,15,37,52,3,5,7,12,54,54
16803,Chris Rozier,2010,2011,Jacksonville,A-Sun,40,209,23,69,21,60,2,9,6,9,14,17,31,7,4,11,16,17,54
16804,Chris Seeley,2018,2018,Utah,Pac-12,20,150,20,46,20,43,0,3,14,30,12,38,50,8,1,8,11,27,54
16805,Isaac Smith,2011,2011,Eastern Illinois,OVC,26,334,15,42,14,37,1,5,23,27,6,20,26,22,6,0,24,21,54
16806,Tyvoris Soloman,2015,2015,South Carolina State,MEAC,29,538,16,52,10,34,6,18,16,27,18,47,65,80,25,1,37,52,54
16807,Dazmond Starke,2012,2012,Idaho,WAC,12,149,22,53,22,53,0,0,10,16,19,23,42,5,5,2,16,21,54
16808,Payton Tivis,2009,2011,South Dakota State,Summit,56,363,22,52,21,45,1,7,9,14,7,35,42,20,10,0,17,31,54
16809,Toby Van Ry,2016,2019,Total,Total,44,252,20,52,16,33,4,19,10,17,14,51,65,16,3,10,24,46,54
16810,Eso Akunne,2010,2013,Michigan,Big Ten,53,177,20,44,11,24,9,20,4,6,2,29,31,11,1,1,8,17,53
16811,Dan Bohall,2008,2008,Iowa,Big Ten,19,225,14,45,9,15,5,30,20,26,4,15,19,27,3,0,19,26,53
16812,DeAndre Bynum,2011,2011,Jacksonville State,OVC,20,236,19,48,14,32,5,16,10,28,13,16,29,12,4,1,11,22,53
16813,D'Von Campbell,2012,2012,Texas-El Paso,CUSA,23,265,17,50,10,30,7,20,12,19,3,23,26,21,8,0,22,15,53
16814,Billy Cotton,2009,2009,McNeese State,Southland,21,177,19,41,19,41,0,0,15,27,15,25,40,8,8,6,26,35,53
16815,Brian Curtis,2008,2008,Portland State,Big Sky,25,159,14,32,2,4,12,28,13,21,7,4,11,6,4,1,8,11,53
16816,Matt Dahlen,2015,2017,Oregon State,Pac-12,52,381,20,40,20,39,0,1,13,30,22,45,67,21,10,4,23,80,53
16817,Chris Davenport,2011,2011,Alcorn State,SWAC,10,147,18,46,17,45,1,1,16,28,10,17,27,0,7,2,14,27,53
16818,Mamadou Diakhate,2008,2008,Fairfield,MAAC,13,145,13,24,6,14,7,10,20,32,10,11,21,2,8,0,6,28,53
16819,John Fenton,2014,2015,Colgate,Patriot,42,335,22,54,22,54,0,0,9,25,24,47,71,1,6,9,14,72,53
16820,Taylor Filipek,2011,2012,Eastern Kentucky,OVC,56,598,19,72,18,59,1,13,14,36,31,57,88,37,11,3,25,60,53
16821,BJ Fitzgerald,2019,2019,Norfolk State,MEAC,25,128,17,42,10,19,7,23,12,14,9,24,33,1,4,0,7,23,53
16822,Ty Graves,2017,2017,Boston College,ACC,11,207,19,50,7,17,12,33,3,5,0,10,10,18,0,2,18,15,53
16823,Justice Green,2018,2018,Eastern Illinois,OVC,21,137,20,48,11,18,9,30,4,8,1,17,18,5,9,2,3,9,53
16824,Breki Gylfason,2019,2019,Appalachian State,Sun Belt,24,158,17,41,4,7,13,34,6,13,6,13,19,5,1,2,10,31,53
16825,Ali Langford,2012,2012,Niagara,MAAC,29,309,21,37,16,26,5,11,6,9,29,28,57,8,17,11,14,53,53
16826,Steve Martin,2008,2011,Chicago State,Total,82,806,18,73,11,48,7,25,10,20,4,46,50,93,22,5,89,103,53
16827,Erik Nissen,2014,2015,Maine,AEC,29,182,21,49,20,47,1,2,10,14,9,35,44,4,4,8,13,36,53
16828,Mezie Offurum,2019,2019,George Washington,A-10,26,212,19,40,18,35,1,5,14,21,5,21,26,10,3,4,24,22,53
16829,Samson Oyediran,2016,2018,Tennessee State,OVC,56,364,20,44,15,25,5,19,8,19,23,36,59,5,4,0,20,72,53
16830,Brandon Price,2014,2015,Western Kentucky,Total,36,208,14,40,9,24,5,16,20,30,9,6,15,22,7,0,22,17,53
16831,Christian Thieneman,2017,2019,Marshall,CUSA,41,281,15,46,6,14,9,32,14,24,13,43,56,5,2,1,9,36,53
16832,Morris Udeze,2019,2019,Wichita State,AAC,16,201,24,43,24,43,0,0,5,13,18,33,51,6,3,7,10,29,53
16833,Antoine Vernon,2019,2019,Oregon State,Pac-12,30,326,13,35,4,14,9,21,18,18,4,18,22,25,7,0,15,32,53
16834,Cameron Walker,2016,2017,Stanford,Pac-12,39,374,11,35,10,28,1,7,30,55,17,40,57,26,8,3,26,54,53
16835,James Watson,2010,2012,Total,Total,30,208,23,48,23,48,0,0,7,24,30,23,53,6,3,9,11,42,53
16836,Trinson White,2015,2015,Milwaukee,Horizon,19,254,13,43,11,38,2,5,25,36,16,20,36,13,5,3,16,16,53
16837,Dave Wiegmann,2013,2014,Albany (NY),AEC,46,351,20,56,18,43,2,13,11,20,18,57,75,12,7,10,18,36,53
16838,Curtis Wilkinson,2011,2011,East Tennessee State,A-Sun,21,225,20,27,20,27,0,0,13,28,26,25,51,4,5,13,11,35,53
16839,Adam Williams,2008,2009,Marshall,CUSA,51,442,20,48,18,32,2,16,11,34,14,43,57,18,16,1,16,61,53
16840,Leon Williams,2017,2017,Florida A&M,MEAC,10,160,21,48,21,47,0,1,11,19,12,18,30,4,5,2,9,24,53
16841,Brandon Wright,2019,2019,Alabama A&M,SWAC,23,307,20,50,16,36,4,14,9,19,13,26,39,28,12,1,20,29,53
16842,Troy Alexander,2009,2010,Santa Clara,WCC,44,438,14,45,10,31,4,14,20,34,5,26,31,42,22,2,50,45,52
16843,Marco Anthony,2018,2019,Virginia,ACC,35,222,18,55,11,35,7,20,9,15,1,24,25,20,2,3,14,15,52
16844,Jack Ballantyne,2018,2018,Detroit Mercy,Horizon,24,284,16,57,7,20,9,37,11,12,7,35,42,19,2,1,18,26,52
16845,Ali Barnes,2016,2016,Miami (OH),MAC,14,195,17,48,6,15,11,33,7,8,1,11,12,5,4,0,10,23,52
16846,Davonte Beard,2012,2012,Siena,MAAC,10,227,15,42,11,25,4,17,18,25,5,13,18,16,7,0,18,14,52
16847,Cameron Blakley,2014,2016,Charlotte,CUSA,46,232,16,59,5,16,11,43,9,13,6,25,31,5,4,7,14,45,52
16848,Jacobby Bledsoe,2014,2014,Missouri-Kansas City,WAC,23,390,17,66,9,20,8,46,10,16,3,28,31,30,24,0,18,40,52
16849,Rory Burt,2010,2010,Louisiana-Monroe,Sun Belt,28,245,18,41,18,40,0,1,16,26,22,24,46,0,4,22,13,37,52
16850,Chasen Campbell,2013,2014,South Carolina State,MEAC,28,181,18,64,9,36,9,28,7,11,9,17,26,4,1,8,14,21,52
16851,Antoine Childs,2009,2010,Western Carolina,Southern,18,88,19,26,15,21,4,5,10,17,4,4,8,3,4,2,6,11,52
16852,Javon Coney,2008,2011,Colorado,Big 12,70,370,19,57,13,28,6,29,8,14,15,37,52,12,7,3,11,39,52
16853,Marques Cox,2008,2009,Stony Brook,AEC,51,782,17,44,15,33,2,11,16,28,28,53,81,48,59,0,26,100,52
16854,Russell Daniels,2019,2019,Montana State,Big Sky,29,438,18,53,15,42,3,11,13,21,7,25,32,42,12,1,33,42,52
16855,Kjell de Graaf,2019,2019,NJIT,A-Sun,26,243,16,49,4,12,12,37,8,11,13,27,40,14,3,6,10,27,52
16856,Tyler Deihl,2011,2012,Presbyterian,Big South,40,228,18,50,3,4,15,46,1,3,1,12,13,18,1,0,20,14,52
16857,Martin Dixon-Green,2017,2017,Canisius,MAAC,22,172,17,49,11,31,6,18,12,18,16,27,43,5,4,2,14,25,52
16858,Chris Fleming,2008,2009,George Mason,CAA,44,291,23,53,23,53,0,0,6,10,16,32,48,7,2,2,19,50,52
16859,Kyle Ford,2009,2009,Nicholls State,Southland,11,156,17,43,5,10,12,33,6,8,3,8,11,6,1,1,10,13,52
16860,Gabe Grant,2018,2018,Houston,AAC,24,127,14,44,4,15,10,29,14,22,8,18,26,4,4,3,3,7,52
16861,Taylor Hoffer,2011,2013,North Carolina-Greensboro,Southern,50,464,17,51,14,40,3,11,15,25,48,49,97,9,9,10,22,98,52
16862,Curtis Jackson,2009,2009,Little Rock,Sun Belt,25,179,17,47,5,13,12,34,6,9,4,11,15,6,1,0,9,23,52
16863,Kevin Johnson,2013,2013,Seton Hall,Big East,21,165,19,38,19,38,0,0,14,31,23,20,43,0,4,8,7,22,52
16864,Antonio Jones,2009,2009,Alcorn State,SWAC,22,180,16,41,7,21,9,20,11,15,6,17,23,9,11,0,18,24,52
16865,Steve Jones,2008,2010,Total,Total,41,374,20,53,18,38,2,15,10,13,18,22,40,12,4,1,15,31,52
16866,Matiss Kulackovskis,2019,2019,Bowling Green State,MAC,17,131,21,52,12,28,9,24,1,4,15,21,36,1,0,2,7,16,52
16867,Colby Lewis,2010,2013,Charlotte,A-10,36,157,18,49,2,6,16,43,0,0,4,8,12,6,2,0,6,20,52
16868,Mo Lewis,2017,2018,Navy,Patriot,26,204,19,34,19,34,0,0,14,15,26,19,45,7,5,1,7,29,52
16869,Jakolby Long,2017,2018,Iowa State,Big 12,30,249,18,57,6,30,12,27,4,9,8,31,39,14,5,0,9,27,52
16870,Stargell Love,2011,2011,Baylor,Big 12,24,287,22,61,18,42,4,19,4,6,4,30,34,34,9,0,34,33,52
16871,Brian Lytle,2008,2008,Fairleigh Dickinson,NEC,27,363,17,47,17,46,0,1,18,28,27,21,48,12,7,5,20,62,52
16872,Dylon Maggio,2015,2015,Southeastern Louisiana,Southland,26,249,19,45,7,22,12,23,2,5,4,19,23,7,8,4,24,31,52
16873,Elijah McNamara,2019,2019,Miami (OH),MAC,29,275,20,69,13,31,7,38,5,10,8,24,32,10,3,8,11,15,52
16874,Alexsander Milosavljevic,2014,2015,Abilene Christian,Southland,40,215,24,53,24,52,0,1,4,8,25,27,52,4,1,3,16,27,52
16875,Dan Nelms,2008,2010,Davidson,Southern,73,397,21,44,19,41,2,3,8,27,27,36,63,28,5,6,16,63,52
16876,Isaac Nixon,2010,2010,Norfolk State,MEAC,27,233,19,48,10,27,9,21,5,11,4,19,23,8,7,1,28,37,52
16877,Aaron O'Neill,2012,2015,Furman,Southern,59,396,17,46,3,7,14,39,4,6,1,27,28,17,5,0,9,43,52
16878,Antonio Ootesey,2008,2011,Arkansas-Pine Bluff,SWAC,64,321,15,69,5,27,10,42,12,29,5,22,27,14,12,1,24,39,52
16879,Brad Piehl,2010,2010,Robert Morris,NEC,29,259,23,56,23,53,0,3,6,8,13,22,35,6,6,3,23,31,52
16880,Ryker Pierce,2018,2019,UC-Riverside,Big West,27,196,15,57,4,18,11,39,11,17,6,6,12,5,8,1,5,24,52
16881,Tyler Plummer,2018,2019,Wagner,NEC,40,475,19,51,15,36,4,15,10,31,27,28,55,28,17,7,36,50,52
16882,Antoine Proctor,2011,2011,Sacramento State,Big Sky,8,186,15,43,11,29,4,14,18,25,5,27,32,28,11,0,25,20,52
16883,Chris Reaves,2010,2010,Austin Peay,OVC,26,165,21,42,19,32,2,10,8,16,7,8,15,3,2,0,6,8,52
16884,Patrick Rucker,2019,2019,Mississippi Valley State,SWAC,26,338,20,40,10,21,10,19,2,7,7,31,38,18,8,0,25,25,52
16885,Kam Shepherd,2008,2009,North Carolina A&T,MEAC,36,431,22,67,21,62,1,5,7,25,26,48,74,12,11,15,42,78,52
16886,Mark Shepherd,2008,2008,Baylor,Big 12,32,397,15,39,15,39,0,0,22,35,35,41,76,8,14,16,20,69,52
16887,Omar Silverio,2019,2019,Rhode Island,A-10,28,219,18,56,8,26,10,30,6,11,5,23,28,18,9,1,14,21,52
16888,Mike Simpson,2011,2013,Coppin State,MEAC,44,249,19,63,8,26,11,37,3,9,8,17,25,10,5,0,26,32,52
16889,Raymond Sims,2010,2011,South Alabama,Sun Belt,20,285,17,39,9,22,8,17,10,14,0,24,24,41,17,1,42,36,52
16890,Giovanni Smith,2013,2014,Jacksonville State,OVC,30,255,15,47,1,8,14,39,8,10,0,14,14,9,4,1,5,20,52
16891,Josh Sowards,2008,2009,West Virginia,Big East,32,73,18,47,11,24,7,23,9,17,5,5,10,4,1,0,1,8,52
16892,Solly Stansbury,2018,2018,Richmond,A-10,17,214,20,56,16,34,4,22,8,13,11,17,28,12,12,2,12,30,52
16893,Austin Trice,2019,2019,Kansas State,Big 12,27,215,19,32,19,32,0,0,14,42,26,45,71,3,2,5,8,23,52
16894,James Walker,2011,2011,Utah State,WAC,25,239,16,47,9,21,7,26,13,20,2,22,24,31,11,4,18,31,52
16895,Aaron Washington,2013,2014,Missouri-Kansas City,Total,24,363,24,58,24,52,0,6,4,7,8,23,31,30,14,1,21,37,52
16896,Diego Willis,2019,2019,NJIT,A-Sun,28,271,19,59,6,17,13,42,1,3,4,37,41,18,6,0,10,15,52
16897,Eric Wormely,2009,2009,Ball State,MAC,27,340,21,41,21,41,0,0,10,16,15,21,36,5,4,5,20,42,52
16898,Michael Wynn,2019,2019,Wake Forest,ACC,27,177,16,65,7,25,9,40,11,13,13,11,24,4,3,3,7,17,52
16899,Mike Annese,2009,2010,Colorado State,MWC,26,116,12,33,5,17,7,16,20,27,1,9,10,7,7,1,14,15,51
16900,Will Bailey,2012,2012,Morehead State,OVC,23,138,17,37,16,32,1,5,16,26,15,13,28,3,6,0,10,15,51
16901,Miles Banks,2017,2017,Incarnate Word,Southland,13,254,22,47,22,47,0,0,7,21,26,54,80,10,3,2,14,39,51
16902,Bob Bevilacqua,2010,2010,Canisius,MAAC,28,246,15,51,2,10,13,41,8,9,7,6,13,12,6,0,10,15,51
16903,Romain Boxus,2019,2019,Hartford,AEC,23,256,18,44,9,13,9,31,6,6,9,20,29,6,5,3,10,43,51
16904,Sean Brennan,2014,2014,North Florida,A-Sun,18,125,13,30,3,12,10,18,15,25,1,9,10,16,6,2,15,13,51
16905,Verice Cloyd,2008,2008,Chattanooga,Southern,13,120,19,36,12,20,7,16,6,13,4,10,14,7,4,0,10,9,51
16906,George Conditt IV,2019,2019,Iowa State,Big 12,26,209,19,30,19,30,0,0,13,18,18,25,43,2,8,26,13,31,51
16907,Rob Elam,2012,2013,South Carolina Upstate,A-Sun,58,513,19,61,19,60,0,1,13,23,24,32,56,25,13,7,19,48,51
16908,Lionel Ellison III,2016,2016,Fresno State,MWC,31,433,10,45,7,27,3,18,28,42,9,40,49,34,17,2,18,49,51
16909,Ashton Farmer,2008,2008,Arkansas State,Sun Belt,30,346,17,47,17,45,0,2,17,32,24,44,68,8,10,3,27,61,51
16910,KeyShawn Feazell,2018,2019,Mississippi State,SEC,50,272,23,48,21,37,2,11,3,8,16,41,57,1,3,4,21,47,51
16911,Jeremy Felton,2010,2010,Western Illinois,Summit,8,97,22,54,22,54,0,0,7,9,5,20,25,6,6,5,7,6,51
16912,Roman Gentry,2008,2008,Milwaukee,Horizon,10,160,20,56,19,36,1,20,10,13,5,8,13,6,4,1,9,18,51
16913,Andrew Goba,2008,2010,Stony Brook,AEC,59,526,20,47,20,47,0,0,11,17,33,42,75,3,12,6,18,86,51
16914,Kamaka Hepa,2019,2019,Texas,Big 12,26,274,16,54,3,13,13,41,6,7,10,32,42,9,1,8,6,17,51
16915,Jarod Jahns,2011,2013,Texas A&M,Total,44,476,18,44,17,36,1,8,14,20,28,35,63,12,9,8,15,59,51
16916,Ryan Janer,2009,2009,Detroit Mercy,Horizon,18,140,18,41,7,14,11,27,4,4,2,3,5,6,3,0,13,9,51
16917,T.J. Johnson,2014,2014,South Alabama,Sun Belt,20,190,19,47,11,25,8,22,5,7,3,21,24,9,4,2,9,15,51
16918,Stanley Jones,2008,2008,Furman,Southern,8,163,21,38,21,38,0,0,9,11,8,19,27,3,4,3,10,21,51
16919,Willie Kirkland,2011,2012,Coastal Carolina,Big South,11,119,18,37,13,20,5,17,10,13,4,20,24,2,6,1,6,5,51
16920,Justin Leemo,2009,2009,South Florida,Big East,31,486,16,76,2,18,14,58,5,11,6,33,39,37,18,1,21,48,51
16921,Chris Leggett,2009,2009,Troy,Sun Belt,14,130,20,39,20,39,0,0,11,14,15,14,29,5,5,10,6,13,51
16922,Gustavo Lino,2009,2010,Southern Mississippi,CUSA,31,265,18,41,18,41,0,0,15,21,19,41,60,1,1,5,5,46,51
16923,Daniel Love,2019,2019,Mercer,Southern,25,216,21,69,19,52,2,17,7,15,9,31,40,34,15,1,23,23,51
16924,Brett Marfurt,2009,2010,Colgate,Patriot,42,232,16,61,6,17,10,44,9,15,7,12,19,8,4,3,16,22,51
16925,Isaiah Maston,2014,2014,South Alabama,Sun Belt,28,257,18,44,4,9,14,35,1,2,6,19,25,9,1,3,8,30,51
16926,Christian Matthews,2017,2017,Georgia Tech,ACC,15,107,15,39,9,25,6,14,15,20,2,7,9,4,3,3,6,10,51
16927,Christopher Miller,2014,2017,Total,Total,27,222,18,56,11,35,7,21,8,14,6,15,21,5,4,5,12,20,51
16928,Jahleem Montague,2018,2018,Longwood,Big South,17,222,20,49,20,47,0,2,11,17,14,30,44,11,8,10,22,35,51
16929,Constantin Motnii,2008,2008,American,Patriot,12,164,15,29,15,29,0,0,21,27,11,20,31,5,1,2,17,21,51
16930,Charles Newton,2010,2011,Tennessee Tech,OVC,38,146,16,29,6,8,10,21,9,14,3,16,19,10,13,0,14,27,51
16931,Tanner Plemmons,2013,2014,Stetson,A-Sun,28,94,18,39,3,5,15,34,0,0,1,2,3,4,2,1,6,6,51
16932,Deshean Porchea,2008,2008,Alabama State,SWAC,24,207,15,44,4,13,11,31,10,16,9,22,31,32,4,0,13,22,51
16933,Brandon Roberts,2008,2009,Louisiana-Monroe,Sun Belt,18,381,16,52,11,33,5,19,14,18,6,27,33,37,14,1,39,33,51
16934,Tarod Sanders,2008,2008,Murray State,OVC,26,212,19,38,19,38,0,0,13,26,16,28,44,4,9,1,12,37,51
16935,TyQuayion Smith,2016,2019,Alcorn State,SWAC,66,312,17,50,14,39,3,11,14,26,12,26,38,5,12,14,17,39,51
16936,Jakob Stenhede,2015,2016,Maryland-Baltimore County,AEC,41,284,19,40,19,40,0,0,13,26,17,40,57,1,2,9,9,40,51
16937,Dave Telander,2008,2008,Loyola (IL),Horizon,25,248,19,54,10,15,9,39,4,4,7,16,23,14,12,1,10,24,51
16938,Robin Thompson,2015,2017,Missouri State,MVC,36,231,19,42,19,42,0,0,13,24,18,22,40,8,14,10,10,54,51
16939,David Tillman,2014,2018,Arkansas-Pine Bluff,SWAC,89,499,22,43,22,43,0,0,7,25,26,34,60,10,7,36,36,110,51
16940,Dustin Triano,2015,2017,Gonzaga,WCC,54,161,17,31,3,3,14,28,3,5,7,17,24,7,4,0,4,19,51
16941,Jihar Williams,2018,2019,William & Mary,CAA,31,222,17,67,6,20,11,47,6,11,0,16,16,11,8,7,5,17,51
16942,Donovon Wright,2017,2017,Cornell,Ivy,10,179,16,50,8,31,8,19,11,25,12,14,26,4,2,4,5,23,51
16943,Horace Wyatt Jr.,2019,2019,Little Rock,Sun Belt,24,263,18,37,16,31,2,6,13,19,3,19,22,10,5,4,15,29,51
16944,Will Adams,2012,2012,Towson,CAA,27,337,19,64,12,30,7,34,5,10,12,20,32,12,8,3,21,34,50
16945,Dewayne Bowden,2012,2013,Houston Baptist,GWC,25,167,16,47,14,38,2,9,16,24,5,11,16,9,5,0,20,25,50
16946,Scott Brooks,2008,2010,Navy,Patriot,57,311,18,52,17,48,1,4,13,33,17,42,59,7,11,3,21,60,50
16947,Justin Brown,2017,2018,North Carolina-Asheville,Big South,23,103,17,34,14,18,3,16,13,14,4,11,15,3,5,3,9,21,50
16948,Chris Cole,2008,2008,New Mexico State,WAC,25,427,15,45,13,27,2,18,18,22,7,34,41,72,22,2,37,35,50
16949,Richard Connor,2011,2012,Savannah State,Total,42,408,16,52,14,35,2,17,16,30,20,33,53,31,12,0,32,53,50
16950,Clinton Cuffee,2011,2012,Howard,MEAC,43,437,20,51,19,48,1,3,9,23,12,29,41,41,29,8,42,44,50
16951,Daniel Dzierzawski,2017,2017,Toledo,MAC,7,109,18,42,17,36,1,6,13,15,1,13,14,11,2,0,17,9,50
16952,Austin Falke,2008,2010,Stephen F. Austin,Southland,36,194,21,57,14,34,7,23,1,2,2,14,16,16,7,1,11,16,50
16953,Rory Fannon,2010,2012,Utah Valley,GWC,78,550,19,53,19,53,0,0,12,28,32,52,84,15,4,10,36,93,50
16954,Joe Foley,2019,2019,Lehigh,Patriot,22,170,18,27,18,27,0,0,14,20,4,19,23,20,7,2,20,16,50
16955,Mason Forbes,2019,2019,Harvard,Ivy,21,180,22,32,22,32,0,0,6,12,8,13,21,2,3,4,10,18,50
16956,Keith Fuetsch,2010,2013,Nevada,Total,47,238,16,44,9,23,7,21,11,20,3,14,17,21,9,2,20,17,50
16957,Jared Grady,2009,2009,Delaware State,MEAC,18,242,22,55,21,52,1,3,5,15,12,22,34,15,9,1,16,23,50
16958,Marshall Graves,2017,2019,Louisiana State,SEC,40,206,17,54,5,12,12,42,4,5,4,13,17,14,3,1,6,16,50
16959,Owen Hamilton,2018,2018,Northern Illinois,MAC,27,184,22,34,22,33,0,1,6,12,11,24,35,3,7,3,10,30,50
16960,Matt Hancock,2013,2015,Lamar,Southland,49,425,20,63,12,27,8,36,2,4,9,27,36,17,2,1,21,29,50
16961,Amir Harris,2019,2019,Nebraska,Big Ten,23,268,23,40,23,40,0,0,4,14,8,49,57,17,10,10,14,22,50
16962,Usman Haruna,2018,2019,Total,Total,41,300,21,35,21,35,0,0,8,22,17,63,80,3,4,11,14,54,50
16963,Chris Hawkins,2015,2015,Memphis,AAC,18,205,20,41,18,37,2,4,8,14,21,27,48,10,7,2,10,21,50
16964,K.J. James,2015,2016,High Point,Big South,34,228,19,37,19,35,0,2,12,29,17,35,52,13,8,5,15,20,50
16965,Matthew Jiles,2015,2018,New Orleans,Southland,71,314,16,57,9,27,7,30,11,19,12,16,28,21,15,1,21,28,50
16966,D'Andre Johnson,2018,2019,North Carolina A&T,MEAC,30,160,20,48,13,26,7,22,3,7,7,24,31,5,2,15,10,28,50
16967,Sean Kane,2008,2009,Brown,Ivy,31,170,16,43,0,4,16,39,2,2,1,14,15,4,0,1,9,9,50
16968,Youssoupha Kane,2015,2015,Detroit Mercy,Horizon,24,311,21,51,21,51,0,0,8,19,25,35,60,7,9,11,19,53,50
16969,Logan Koch,2017,2019,Eastern Illinois,OVC,36,360,17,59,3,12,14,47,2,2,0,21,21,30,13,0,17,37,50
16970,Matt Korcheck,2014,2015,Arizona,Pac-12,43,178,18,26,18,26,0,0,14,18,17,30,47,5,3,12,7,26,50
16971,Montie Leunen,2015,2017,Portland State,Big Sky,41,279,14,40,11,21,3,19,19,24,9,22,31,17,8,5,8,43,50
16972,Gavin MacGregor,2009,2009,Brigham Young,MWC,19,187,17,26,17,26,0,0,16,28,17,27,44,2,2,4,7,39,50
16973,Thomas Marshall,2012,2013,Southern,SWAC,33,402,15,38,15,36,0,2,20,27,4,31,35,28,14,0,30,50,50
16974,Jordan Martin,2015,2016,Eastern Michigan,MAC,29,176,16,40,15,36,1,4,17,33,21,35,56,4,9,4,8,28,50
16975,James Matthews,2008,2008,Eastern Michigan,MAC,10,145,18,36,18,36,0,0,14,17,16,22,38,2,2,1,15,17,50
16976,Duol Mayot,2015,2016,South Dakota,Summit,43,240,19,44,19,44,0,0,12,25,20,31,51,8,4,1,14,28,50
16977,Dashawn McDowell,2017,2019,Total,Total,32,265,18,42,16,38,2,4,12,31,16,20,36,16,7,2,18,29,50
16978,Cory Norman,2008,2009,Arkansas-Pine Bluff,SWAC,32,286,16,52,3,8,13,44,5,6,6,13,19,17,8,1,18,19,50
16979,Manny Ochenje,2012,2013,Pepperdine,WCC,30,216,19,44,19,44,0,0,12,17,19,26,45,0,1,5,11,31,50
16980,Blair Orr,2017,2019,Cal State Northridge,Big West,29,183,21,44,21,44,0,0,8,11,7,19,26,4,2,3,10,32,50
16981,Bernard Rimmer,2009,2009,Georgia State,CAA,20,265,19,44,19,41,0,3,12,22,27,26,53,7,7,6,13,24,50
16982,David Safstrom,2008,2011,Lehigh,Patriot,63,374,18,36,18,36,0,0,14,25,24,51,75,6,7,17,27,86,50
16983,Richard Semrau,2008,2010,Illinois,Big Ten,44,276,22,42,22,42,0,0,6,12,19,40,59,9,5,5,20,33,50
16984,Aaron Smith,2009,2010,Stephen F. Austin,Southland,32,229,17,49,8,20,9,29,7,11,12,42,54,8,4,1,9,21,50
16985,Dontrell Taylor,2008,2008,Tennessee State,OVC,16,158,17,31,17,31,0,0,16,23,9,15,24,0,0,8,14,23,50
16986,Andre Walker,2015,2017,Hofstra,CAA,47,309,21,48,21,48,0,0,8,16,19,70,89,8,6,41,20,68,50
16987,Mason Wedel,2013,2015,Missouri-Kansas City,Total,35,384,18,62,9,21,9,41,5,7,8,28,36,27,19,1,16,28,50
16988,Jonathan Whipple,2010,2010,Kennesaw State,A-Sun,30,369,20,66,17,54,3,12,7,15,31,30,61,16,16,8,20,45,50
16989,Mike White,2008,2008,Indiana,Big Ten,22,288,17,43,17,43,0,0,16,24,28,27,55,9,12,2,18,40,50
16990,Blake Wilkinson,2012,2017,Total,Total,34,287,19,51,19,51,0,0,12,22,21,28,49,6,11,4,16,42,50
16991,Antoine Allen,2010,2010,Miami (FL),ACC,17,137,13,36,3,12,10,24,13,19,0,13,13,12,10,1,14,11,49
16992,Aarias Austin,2016,2016,Northern Iowa,MVC,9,120,17,43,7,17,10,26,5,5,0,16,16,7,2,0,8,7,49
16993,Vangelis Bebis,2015,2015,Iona,MAAC,27,233,17,52,4,8,13,44,2,2,2,18,20,8,8,3,7,24,49
16994,Cecil Brown,2008,2009,Morehead State,OVC,41,363,17,56,11,28,6,28,9,20,4,18,22,26,10,0,38,28,49
16995,Trent Buttrick,2018,2019,Penn State,Big Ten,35,229,16,49,7,16,9,33,8,12,14,27,41,4,4,8,11,36,49
16996,Flynn Cameron,2019,2019,DePaul,Big East,27,240,18,42,12,24,6,18,7,11,9,18,27,18,9,0,16,31,49
16997,Kyle Carey,2017,2017,Northern Colorado,Big Sky,21,181,16,54,12,33,4,21,13,21,5,23,28,5,4,1,12,22,49
16998,Cameron Carmical,2018,2019,Eastern Kentucky,OVC,35,345,16,45,5,15,11,30,6,11,3,31,34,46,17,0,17,46,49
16999,Raphael Carter,2013,2013,Oakland,Summit,26,236,21,36,21,36,0,0,7,18,22,26,48,4,5,6,9,33,49
17000,Eric Coggins,2009,2010,Quinnipiac,NEC,32,251,19,33,19,33,0,0,11,25,25,35,60,3,2,12,8,51,49
17001,Konimba Diarra,2008,2008,College of Charleston,Southern,21,143,21,40,21,40,0,0,7,8,4,17,21,5,1,6,9,22,49
17002,Kyle Dodd,2008,2009,Eastern Michigan,MAC,49,320,21,57,21,56,0,1,7,12,18,36,54,11,6,23,20,23,49
17003,Joshua Doss,2017,2018,South Dakota,Summit,33,192,16,26,14,20,2,6,15,19,12,34,46,7,8,2,9,10,49
17004,Xavier Dupree,2016,2017,Houston,AAC,38,261,18,50,6,20,12,30,1,2,14,43,57,16,10,8,18,39,49
17005,Josh Egner,2011,2012,Akron,MAC,29,193,19,50,19,47,0,3,11,20,14,26,40,3,2,10,14,38,49
17006,Dyrbe Enos ,2014,2016,Hawaii,Big West,53,190,16,59,1,8,15,51,2,6,2,11,13,7,6,1,11,25,49
17007,Marc Andre Fortin,2016,2016,Sam Houston State,Southland,28,185,20,47,20,47,0,0,9,18,26,16,42,11,4,6,14,39,49
17008,Devante Foster,2019,2019,Troy,Sun Belt,18,150,18,39,15,24,3,15,10,13,12,29,41,3,5,6,12,24,49
17009,Shaquillo Fritz,2018,2019,Arkansas State,Sun Belt,31,308,19,43,19,43,0,0,11,18,27,44,71,7,4,25,16,52,49
17010,Kevin Gullikson,2008,2009,Wisconsin,Big Ten,40,281,21,48,21,46,0,2,7,21,22,23,45,21,2,1,13,33,49
17011,Jurmelle Hall,2015,2015,Mississippi Valley State,SWAC,18,173,17,57,6,17,11,40,4,6,9,19,28,7,7,2,10,23,49
17012,Shyheim Hicks,2018,2019,Long Island University,NEC,30,190,15,46,6,15,9,31,10,15,5,12,17,6,1,0,12,28,49
17013,Matt Hill,2008,2012,Massachusetts,A-10,65,485,15,57,9,32,6,25,13,19,26,50,76,10,19,13,18,68,49
17014,Montrell Horsey,2019,2019,Delaware State,MEAC,13,209,14,65,9,48,5,17,16,22,6,16,22,14,8,1,22,32,49
17015,Tyson Hunter,2019,2019,Clemson,ACC,31,257,16,63,5,16,11,47,6,9,6,26,32,12,2,8,6,18,49
17016,Adida Ikongshul,2017,2019,Western Michigan,MAC,65,409,16,53,13,45,3,8,14,26,36,64,100,14,4,2,30,76,49
17017,Vuk Ivanovic,2008,2008,Brigham Young,MWC,15,115,16,28,16,28,0,0,17,26,16,20,36,6,3,5,15,20,49
17018,J.T. Jones,2015,2016,Southeast Missouri State,OVC,18,169,18,48,11,26,7,22,6,10,10,21,31,13,4,0,11,26,49
17019,Vieux Kande,2014,2015,Louisiana,Sun Belt,45,185,19,28,19,28,0,0,11,24,14,20,34,2,3,5,11,39,49
17020,Thomas Kithier,2019,2019,Michigan State,Big Ten,30,183,23,29,23,29,0,0,3,6,14,26,40,5,3,3,7,25,49
17021,Drew LaMont,2018,2018,American,Patriot,14,245,16,45,3,9,13,36,4,8,5,18,23,13,7,6,10,18,49
17022,John Marciano,2008,2008,Dartmouth,Ivy,17,143,21,41,21,41,0,0,7,12,7,20,27,3,1,9,11,25,49
17023,Frane Markusovic,2008,2009,American,Patriot,27,172,20,25,20,25,0,0,9,15,6,20,26,4,2,2,8,30,49
17024,Stephen McClellan,2008,2008,Chattanooga,Southern,15,98,15,43,3,5,12,38,7,9,0,4,4,4,2,0,3,5,49
17025,Jimmy McDonnell,2012,2015,Temple,Total,54,363,15,45,8,27,7,18,12,18,15,35,50,15,9,4,22,62,49
17026,Eric Mosley,2010,2010,Austin Peay,OVC,20,112,16,43,13,25,3,18,14,18,3,10,13,5,5,1,8,11,49
17027,Troy Pierce,2011,2011,Charleston Southern,Big South,31,275,17,36,17,36,0,0,15,22,31,24,55,7,10,6,11,31,49
17028,Glen Pierre,2014,2017,Total,Total,51,360,15,45,15,45,0,0,19,25,23,44,67,3,7,23,19,72,49
17029,Chad Powlovich,2008,2008,Vermont,AEC,31,463,18,52,18,52,0,0,13,17,30,44,74,20,10,1,24,54,49
17030,Will Reigel,2009,2012,Davidson,Southern,81,442,14,31,14,26,0,5,21,28,43,39,82,30,9,1,14,69,49
17031,De'Aundray Robinson,2011,2011,Cal State Bakersfield,Ind,21,259,21,65,19,54,2,11,5,11,23,44,67,7,14,8,17,38,49
17032,Mike Robinson,2008,2008,Eastern Illinois,OVC,9,231,17,48,13,26,4,22,11,20,5,13,18,38,12,1,21,20,49
17033,Kenny Russell,2009,2009,Jackson State,SWAC,23,175,18,58,15,38,3,20,10,23,10,17,27,10,5,3,16,26,49
17034,Ryan Singer,2015,2018,San Jose State,MWC,47,512,14,58,10,34,4,24,17,30,28,48,76,11,5,8,23,82,49
17035,Jared Smoot,2012,2013,Navy,Patriot,41,353,19,36,19,36,0,0,11,23,27,51,78,0,2,9,23,46,49
17036,Taylor Stafford,2015,2015,Evansville,MVC,29,192,16,43,6,13,10,30,7,10,4,14,18,13,4,0,3,12,49
17037,Tyler Stevenson,2019,2019,Southern Mississippi,CUSA,15,115,20,41,20,41,0,0,9,19,11,23,34,3,3,1,7,11,49
17038,Mading Thok,2014,2015,Ball State,MAC,17,120,20,29,20,29,0,0,9,19,15,23,38,4,1,3,7,19,49
17039,Trell Thompson,2018,2018,Morehead State,OVC,14,164,19,53,11,23,8,30,3,5,10,17,27,6,6,1,11,13,49
17040,Oddyst Walker,2019,2019,Stephen F. Austin,Southland,30,318,17,62,8,30,9,32,6,13,8,20,28,17,8,0,21,31,49
17041,Von Washington,2014,2015,Western Michigan,MAC,32,135,17,50,6,11,11,39,4,9,2,11,13,2,5,0,5,10,49
17042,Raquan Wilkins,2017,2017,East Carolina,AAC,27,211,16,55,11,31,5,24,12,16,13,27,40,4,7,1,14,17,49
17043,Herve Aholode,2015,2016,Gardner-Webb,Big South,35,255,18,44,18,43,0,1,12,19,25,30,55,6,9,6,9,41,48
17044,Carlton Allen,2014,2016,Manhattan,MAAC,55,357,17,35,17,35,0,0,14,22,18,30,48,2,7,8,17,94,48
17045,Akeem Anderson,2012,2012,Maryland-Eastern Shore,MEAC,24,224,20,46,20,46,0,0,8,15,17,26,43,2,7,5,17,39,48
17046,Jason Bennett,2009,2009,Detroit Mercy,Horizon,29,324,20,47,20,47,0,0,8,26,21,29,50,0,3,25,22,61,48
17047,Ta'Vonne Bond,2018,2019,Virginia Military Institute,Southern,36,298,16,40,14,27,2,13,14,19,7,21,28,24,16,1,24,50,48
17048,Xavier Bryant,2019,2019,Sam Houston State,Southland,23,187,15,35,11,23,4,12,14,18,2,19,21,53,17,0,22,25,48
17049,Jose Cami,2008,2008,Campbell,A-Sun,21,251,13,68,4,15,9,53,13,21,4,17,21,10,6,1,18,35,48
17050,Patrick Coleman,2011,2012,Southern,SWAC,33,277,15,52,7,22,8,30,10,13,11,22,33,16,4,2,15,23,48
17051,Branden Conrad,2008,2009,South Carolina,SEC,22,317,12,41,3,12,9,29,15,18,5,27,32,37,21,1,17,32,48
17052,Bryce Davis,2019,2019,Incarnate Word,Southland,15,149,14,41,13,39,1,2,19,31,3,18,21,3,5,2,13,29,48
17053,Christian Davis,2016,2017,Arkansas State,Sun Belt,36,256,13,53,13,49,0,4,22,36,10,36,46,1,4,7,22,49,48
17054,Preston Davis,2008,2009,Stephen F. Austin,Southland,35,170,15,45,10,28,5,17,13,20,4,10,14,18,4,1,13,14,48
17055,Raul Delgado,2013,2013,Brigham Young,WCC,26,171,18,52,10,21,8,31,4,5,6,18,24,12,9,3,8,28,48
17056,Greg Dillon,2010,2010,Grambling,SWAC,8,103,18,51,13,35,5,16,7,11,4,9,13,8,4,0,15,18,48
17057,Morris Dunnigan,2017,2017,Houston,AAC,20,125,18,51,14,33,4,18,8,13,3,14,17,2,4,0,4,12,48
17058,Joan Duran,2018,2018,Tennessee Tech,OVC,20,157,19,42,13,28,6,14,4,9,10,21,31,8,8,2,9,24,48
17059,Reggie Fondren,2012,2012,Little Rock,Sun Belt,26,219,17,53,13,35,4,18,10,11,7,10,17,12,8,2,8,17,48
17060,Brandon Ford,2008,2010,Central Michigan,MAC,59,391,20,43,20,43,0,0,8,18,21,40,61,5,9,13,16,62,48
17061,Zadrian Gibson,2010,2010,Kennesaw State,A-Sun,20,212,19,34,19,34,0,0,10,16,22,19,41,4,7,8,14,32,48
17062,Ricky Gouety,2019,2019,Stetson,A-Sun,29,178,19,39,19,39,0,0,10,16,16,22,38,2,5,5,16,39,48
17063,Nick Grieves,2012,2013,San Jose State,WAC,18,94,16,46,1,2,15,44,1,2,1,10,11,4,2,0,4,4,48
17064,Jamar Harris,2012,2012,Arkansas-Pine Bluff,SWAC,30,350,22,46,22,45,0,1,4,21,24,31,55,5,2,13,20,34,48
17065,Cristian Henry,2011,2011,North Carolina A&T,MEAC,26,147,21,38,21,38,0,0,6,15,12,20,32,4,3,4,14,39,48
17066,Jon Hogga,2008,2008,Saint Peter's,MAAC,16,200,17,47,11,18,6,29,8,9,18,22,40,12,4,0,11,11,48
17067,Marcus Johnson,2013,2014,Mississippi Valley State,SWAC,19,245,13,47,3,8,10,39,12,13,6,16,22,8,8,0,10,27,48
17068,Shea Jones,2015,2016,Jacksonville,A-Sun,25,242,15,46,3,18,12,28,6,15,8,26,34,19,6,4,19,28,48
17069,Trey Kalina,2018,2019,North Carolina-Wilmington,CAA,34,163,20,47,20,47,0,0,8,15,16,19,35,1,2,13,12,26,48
17070,Brian Kelley,2016,2016,Norfolk State,MEAC,29,318,18,52,17,39,1,13,11,13,6,18,24,31,12,3,29,42,48
17071,Bisi Latunde-Addey,2012,2013,Coastal Carolina,Big South,23,151,21,36,21,36,0,0,6,11,21,19,40,3,5,5,11,17,48
17072,Corry Long,2018,2019,Stony Brook,AEC,33,193,19,36,13,19,6,17,4,9,15,13,28,9,13,3,11,17,48
17073,Mike Louder,2013,2014,Jacksonville State,OVC,20,137,19,39,16,34,3,5,7,8,10,11,21,0,1,2,4,25,48
17074,Danny Mahoney,2015,2016,San Jose State,MWC,28,346,18,77,12,30,6,47,6,6,5,22,27,32,8,0,30,23,48
17075,Adrian Martin,2019,2019,Western Michigan,MAC,26,315,16,86,7,40,9,46,7,9,6,25,31,10,14,1,16,32,48
17076,Jakub Mijakowski,2017,2019,Pennsylvania,Ivy,35,141,16,48,2,6,14,42,2,2,8,17,25,6,2,0,7,10,48
17077,Zach Miller,2012,2012,Northern Illinois,MAC,19,342,14,46,5,16,9,30,11,12,2,22,24,37,11,0,29,33,48
17078,Eric Moeller,2015,2015,Florida Gulf Coast,A-Sun,27,253,17,41,16,37,1,4,13,27,13,25,38,6,4,9,25,43,48
17079,John Odo,2014,2015,Louisiana State,SEC,44,259,19,32,19,32,0,0,10,17,20,36,56,2,4,13,12,39,48
17080,Martynas Pocius,2008,2009,Duke,ACC,26,167,16,52,10,18,6,34,10,11,9,13,22,11,8,0,13,15,48
17081,C.J. Reese,2014,2014,Southeast Missouri State,OVC,21,238,19,41,18,40,1,1,9,16,4,10,14,39,5,1,30,21,48
17082,Kris Rolle,2014,2015,Saint Peter's,MAAC,45,321,17,33,17,33,0,0,14,33,31,48,79,6,5,11,10,55,48
17083,Travis Rollo,2013,2016,Army,Patriot,72,572,21,48,21,47,0,1,6,17,24,44,68,21,9,10,21,76,48
17084,Matt Rosenwinkel,2014,2017,Northern Kentucky,Total,54,382,15,46,5,8,10,38,8,11,11,30,41,7,9,0,7,48,48
17085,Donovon Ross,2012,2012,Southeastern Louisiana,Southland,19,211,23,44,23,44,0,0,2,11,13,17,30,6,3,5,7,22,48
17086,Zisis Sarikopoulos,2008,2010,Total,Total,34,219,18,34,18,34,0,0,12,24,22,19,41,5,3,13,17,38,48
17087,Jordan Scurry,2017,2019,Creighton,Big East,42,122,18,47,7,9,11,38,1,2,3,16,19,8,3,0,6,9,48
17088,Marc Seylan,2016,2017,Maryland-Eastern Shore,MEAC,45,455,19,70,19,55,0,15,10,21,25,47,72,24,12,0,22,37,48
17089,Erick Smith,2011,2013,Bryant,NEC,39,279,20,61,18,47,2,14,6,16,11,16,27,10,6,1,18,29,48
17090,Marek Soucek,2012,2015,Oklahoma State,Big 12,55,277,19,45,14,24,5,21,5,10,7,21,28,13,3,4,16,67,48
17091,Gavin Stephenson,2013,2013,Virginia Military Institute,Big South,22,194,17,51,14,32,3,19,11,16,8,21,29,24,16,0,19,22,48
17092,Luke Tauscher,2008,2008,Texas Christian,MWC,26,210,16,47,14,41,2,6,14,22,26,52,78,7,4,11,8,29,48
17093,Jameson Tipping,2010,2010,Western Kentucky,Sun Belt,28,218,16,54,6,20,10,34,6,11,4,9,13,11,5,0,9,25,48
17094,Dequan Twilley,2008,2008,East Tennessee State,A-Sun,12,243,16,44,10,28,6,16,10,15,0,8,8,24,11,0,26,28,48
17095,Quincy Ukaigwe,2011,2013,Chicago State,GWC,59,401,22,46,22,45,0,1,4,19,34,53,87,6,15,8,28,115,48
17096,Stephen Weigh,2008,2008,Utah,MWC,11,164,17,46,9,20,8,26,6,11,5,10,15,6,4,1,11,5,48
17097,Darius Williams,2019,2019,Cal State Bakersfield,WAC,30,236,19,48,19,48,0,0,10,27,17,32,49,7,4,8,29,40,48
17098,Will Wise,2012,2013,Maryland-Baltimore County,AEC,34,274,20,46,20,46,0,0,8,21,14,27,41,3,3,7,18,58,48
17099,Christian Wolf,2011,2013,Milwaukee,Horizon,52,298,11,41,11,40,0,1,26,41,22,28,50,10,3,1,14,52,48
17100,Wyatt Yess,2018,2019,Yale,Ivy,35,211,15,41,14,33,1,8,17,33,18,39,57,11,5,8,11,36,48
17101,Derek Young,2008,2008,Navy,Patriot,15,140,16,32,10,22,6,10,10,18,3,11,14,16,5,0,17,16,48
17102,Orlando Allen,2011,2011,Marshall,CUSA,32,319,20,48,20,48,0,0,7,17,33,44,77,3,3,24,24,72,47
17103,John Anderson,2008,2008,Bethune-Cookman,MEAC,22,334,20,51,20,51,0,0,7,9,25,39,64,10,4,9,21,34,47
17104,Zavier Anderson,2008,2011,Clemson,ACC,56,350,17,40,14,34,3,6,10,25,12,37,49,44,26,9,46,48,47
17105,Joey Asbury,2011,2014,Oakland,Total,64,278,15,42,12,27,3,15,14,16,13,19,32,1,7,0,8,35,47
17106,Shaq Athie,2019,2019,Grambling,SWAC,22,162,12,33,12,32,0,1,23,41,10,29,39,22,5,0,17,14,47
17107,Yannick Braimbridge,2009,2010,Howard,MEAC,47,443,17,60,11,32,6,28,7,13,4,23,27,36,10,0,43,36,47
17108,Tim Brown,2009,2009,Southern,SWAC,10,177,18,51,18,51,0,0,11,34,20,19,39,3,1,5,19,18,47
17109,Brett Burrier,2009,2009,Maryland-Baltimore County,AEC,22,218,16,49,12,32,4,17,11,18,14,22,36,6,4,2,10,30,47
17110,JJ Caldwell,2018,2018,Texas A&M,SEC,16,256,16,42,14,35,2,7,13,18,8,23,31,41,12,2,21,20,47
17111,Jeremy Case,2008,2008,Kansas,Big 12,30,147,17,45,6,16,11,29,2,2,2,8,10,28,7,0,6,12,47
17112,Devin Cooper,2016,2018,Radford,Big South,26,149,15,44,10,27,5,17,12,14,2,16,18,10,1,0,15,18,47
17113,Rickie Crews,2008,2008,Monmouth,NEC,15,154,19,55,17,43,2,12,7,17,11,22,33,3,8,11,16,17,47
17114,Walter Ellis,2019,2019,Bucknell,Patriot,27,221,17,56,4,10,13,46,0,0,4,29,33,9,6,4,5,22,47
17115,Andre Ferguson,2017,2017,Portland,WCC,19,262,13,46,7,29,6,17,15,25,3,22,25,23,5,0,23,32,47
17116,Bobby Foley,2008,2011,Princeton,Ivy,42,127,17,41,4,6,13,35,0,1,5,8,13,6,2,0,7,5,47
17117,Royce Hamm Jr.,2018,2019,Texas,Big 12,37,233,15,41,15,37,0,4,17,32,30,40,70,2,4,9,19,37,47
17118,Charles Harris,2013,2015,Western Michigan,MAC,24,106,20,40,17,29,3,11,4,10,8,15,23,7,3,1,6,7,47
17119,Joe Harris,2012,2012,Central Arkansas,Southland,15,151,19,42,10,18,9,24,0,4,9,15,24,5,3,0,6,10,47
17120,Matt Hasse,2011,2013,Austin Peay,OVC,47,266,14,30,12,28,2,2,17,26,21,44,65,29,8,8,17,56,47
17121,Cordell James,2013,2013,Morehead State,OVC,21,142,17,39,9,21,8,18,5,8,1,5,6,12,7,0,23,24,47
17122,Matt Johns,2019,2019,South Dakota,Summit,19,298,17,36,10,19,7,17,6,13,8,16,24,17,10,3,12,35,47
17123,David Kachelries,2018,2018,NJIT,A-Sun,14,100,21,36,18,26,3,10,2,4,6,3,9,8,7,2,7,13,47
17124,Martavis Key,2010,2010,Florida International,Sun Belt,16,189,19,53,14,32,5,21,4,8,5,13,18,9,3,0,7,27,47
17125,Ian Langendoerfer,2017,2018,Loyola (MD),Patriot,39,280,14,55,9,29,5,26,14,23,12,20,32,9,2,1,23,27,47
17126,Daijon Macklien,2015,2015,Arkansas State,Sun Belt,23,281,18,41,13,28,5,13,6,9,3,18,21,18,6,0,24,21,47
17127,Jan Maehlen,2011,2013,Pepperdine,WCC,42,386,21,37,21,37,0,0,5,17,24,41,65,4,4,10,18,61,47
17128,Cory Magee,2008,2008,Siena,MAAC,33,372,14,40,10,31,4,9,15,25,36,49,85,13,2,1,18,58,47
17129,Desjuan Newton,2014,2014,Robert Morris,NEC,12,165,17,41,9,22,8,19,5,9,11,18,29,15,6,2,7,22,47
17130,Innocent Nwoko,2018,2019,Central Michigan,MAC,47,188,20,34,20,33,0,1,7,17,17,28,45,1,7,10,10,29,47
17131,Adam Powers,2008,2008,Dartmouth,Ivy,10,130,23,35,23,35,0,0,1,3,11,5,16,6,5,2,5,24,47
17132,Ryan Shields,2008,2009,Vermont,AEC,51,351,19,47,19,47,0,0,9,12,14,56,70,12,6,8,18,52,47
17133,Ty Solomon,2017,2018,South Carolina State,MEAC,23,455,13,47,9,26,4,21,17,24,8,35,43,57,20,0,31,43,47
17134,Andre Thornton,2008,2008,Central Florida,CUSA,20,144,18,46,18,46,0,0,11,28,11,24,35,3,7,0,6,9,47
17135,Daryl Traynham,2011,2011,Massachusetts,A-10,10,166,12,45,9,29,3,16,20,28,4,10,14,31,16,0,21,24,47
17136,Jamal Turner,2009,2010,Fairfield,MAAC,57,743,17,70,15,65,2,5,11,29,38,51,89,48,17,4,43,86,47
17137,Parker U'u,2013,2016,Total,Total,40,241,15,57,5,15,10,42,7,9,9,32,41,11,10,0,24,25,47
17138,Coletrane Washington,2019,2019,Drexel,CAA,24,272,16,55,4,10,12,45,3,4,4,6,10,3,3,1,7,18,47
17139,Justin Wertner,2018,2018,UC-Irvine,Big West,20,139,14,38,4,14,10,24,9,9,10,9,19,6,4,1,3,12,47
17140,Decensae White,2008,2009,Total,Total,12,211,15,52,12,40,3,12,14,27,11,18,29,8,10,1,15,19,47
17141,Dalin Williams,2019,2019,Northwestern State,Southland,30,265,17,39,17,39,0,0,13,20,19,34,53,6,8,14,23,36,47
17142,Eugene Witherspoon,2019,2019,Chicago State,WAC,26,252,18,42,17,36,1,6,10,22,12,37,49,3,5,5,21,34,47
17143,Keion Alexander,2017,2018,Total,Total,39,230,18,35,18,35,0,0,10,22,25,25,50,4,7,22,15,44,46
17144,Mael Amenvedzi,2011,2011,Western Illinois,Summit,25,271,13,38,6,15,7,23,13,19,5,25,30,11,2,1,22,54,46
17145,McKay Anderson,2014,2014,Southern Utah,Big Sky,23,220,18,42,9,23,9,19,1,2,11,16,27,11,5,1,10,18,46
17146,Princewill Anosike,2019,2019,Howard,MEAC,28,235,16,33,16,33,0,0,14,16,21,59,80,5,2,14,16,49,46
17147,Jeremy Basnight,2010,2010,North Carolina-Wilmington,CAA,18,114,15,42,4,7,11,35,5,7,2,9,11,5,2,1,7,15,46
17148,David Bell,2016,2017,Ohio State,Big Ten,38,226,14,31,14,31,0,0,18,31,28,35,63,3,3,12,7,41,46
17149,Colton Blevins,2017,2017,Tennessee Tech,OVC,15,88,15,31,15,27,0,4,16,22,13,16,29,3,1,3,5,14,46
17150,Jonathan Bryant II,2018,2018,Chattanooga,Southern,24,215,18,47,17,37,1,10,9,16,12,20,32,5,4,0,12,16,46
17151,Jeff Christensen,2009,2009,Eastern Washington,Big Sky,28,291,14,38,11,29,3,9,15,20,13,20,33,24,4,2,20,23,46
17152,Demetrice Clopton,2017,2019,Jackson State,SWAC,33,212,19,46,19,46,0,0,8,14,22,26,48,6,2,0,14,34,46
17153,Nick Colletta,2014,2015,Marist,MAAC,21,210,17,59,6,13,11,46,1,1,1,15,16,3,5,2,6,10,46
17154,Christian Cornelius,2008,2009,Southern Illinois,MVC,28,208,20,38,20,38,0,0,6,16,17,21,38,1,5,4,16,32,46
17155,Isaiah Fontaine,2017,2019,Total,Total,43,250,17,45,17,45,0,0,12,33,25,30,55,3,5,17,14,54,46
17156,Jackson Forbes,2015,2017,Princeton,Ivy,31,148,16,46,6,8,10,38,4,5,7,16,23,12,3,0,9,15,46
17157,Charles Foster,2016,2016,East Carolina,AAC,21,116,17,39,8,12,9,27,3,6,1,7,8,6,1,0,13,12,46
17158,Mike Fox,2010,2012,Nebraska,Total,38,266,18,41,14,31,4,10,6,12,15,18,33,7,4,0,9,21,46
17159,Garrett Frick,2012,2012,NJIT,GWC,23,232,21,36,21,34,0,2,4,13,19,24,43,5,6,2,11,36,46
17160,Kenny Grant,2015,2016,Rider,MAAC,34,207,20,39,20,39,0,0,6,13,14,35,49,2,4,8,17,43,46
17161,Christian Gray,2019,2019,Fresno State,MWC,27,247,15,42,15,42,0,0,16,29,27,48,75,5,7,5,9,46,46
17162,Oliver Jefferson,2009,2011,Jackson State,SWAC,40,253,22,40,22,40,0,0,2,6,10,30,40,7,1,11,23,49,46
17163,Jason Jensen,2009,2009,Texas-Rio Grande Valley,Ind,26,343,17,60,10,23,7,37,5,10,8,40,48,26,8,0,15,14,46
17164,Robert Johnson,2011,2012,Kent State,MAC,29,214,15,50,13,38,2,12,14,32,12,34,46,11,7,3,16,34,46
17165,Ethan Kennedy,2008,2008,Coppin State,MEAC,9,133,17,53,8,23,9,30,3,4,6,6,12,5,3,2,5,7,46
17166,Shaun Kirk,2016,2018,North Carolina State,ACC,33,176,18,44,14,25,4,19,6,9,7,28,35,5,5,3,13,27,46
17167,Simon Krajcovic,2015,2015,Loyola Marymount,WCC,17,256,18,41,14,29,4,12,6,12,8,20,28,36,13,0,30,27,46
17168,Joseph Lanzi,2019,2019,Denver,Summit,20,242,17,54,11,23,6,31,6,6,6,16,22,14,6,5,22,12,46
17169,Robert Martina,2011,2011,Manhattan,MAAC,17,173,17,46,16,39,1,7,11,14,14,13,27,7,2,5,8,25,46
17170,John Matt Merritt,2018,2019,Lipscomb,A-Sun,30,151,18,31,11,16,7,15,3,5,2,9,11,11,3,0,7,12,46
17171,Joseph Morgan,2009,2009,Morgan State,MEAC,10,102,17,38,13,18,4,20,8,9,7,5,12,2,1,0,3,12,46
17172,Dannie Powell,2008,2008,Central Connecticut State,NEC,30,312,17,44,17,43,0,1,12,27,7,21,28,27,11,1,17,28,46
17173,Ridas Pulkauninkas,2010,2010,Mercer,A-Sun,27,200,15,45,7,11,8,34,8,12,9,15,24,7,5,0,8,13,46
17174,Zachary Reynolds,2014,2015,Northern Arizona,Big Sky,32,266,18,34,17,33,1,1,9,15,36,48,84,2,3,9,10,27,46
17175,Jared Rice,2019,2019,Cal Poly,Big West,17,176,17,56,13,34,4,22,8,16,8,5,13,8,2,0,11,22,46
17176,Nikkei Rutty,2019,2019,Monmouth,MAAC,24,276,13,32,13,32,0,0,20,47,20,25,45,4,3,5,15,36,46
17177,C.J. Seaforth,2018,2018,Iona,MAAC,20,143,16,35,5,9,11,26,3,5,2,11,13,12,2,0,13,21,46
17178,Temjae Singleton,2015,2015,Cal State Fullerton,Big West,21,174,14,47,6,15,8,32,10,19,12,20,32,5,0,0,10,24,46
17179,Fred Slater,2019,2019,South Carolina State,MEAC,18,151,16,44,8,14,8,30,6,7,2,12,14,6,4,0,4,12,46
17180,Matt Steelman,2009,2012,Wofford,Southern,39,79,14,31,1,4,13,27,5,6,1,7,8,3,1,0,3,9,46
17181,Jaylin Stewart,2016,2016,Southeast Missouri State,OVC,26,210,18,52,11,25,7,27,3,8,7,38,45,2,5,2,7,33,46
17182,Dominique Street,2015,2015,Jackson State,SWAC,10,152,14,64,2,13,12,51,6,7,5,13,18,4,3,1,5,11,46
17183,Jarrett Sutton,2009,2012,Missouri,Big 12,50,150,15,53,0,3,15,50,1,2,4,12,16,1,5,0,1,7,46
17184,P.J. Torres,2012,2013,Duquesne,A-10,21,124,16,49,9,23,7,26,7,12,4,15,19,20,4,0,14,12,46
17185,Johnny Trueblood,2016,2019,Nebraska,Big Ten,34,241,17,41,14,32,3,9,9,23,12,33,45,26,11,0,12,15,46
17186,Casey Trujeque,2011,2011,Montana State,Big Sky,29,264,13,47,3,13,10,34,10,10,8,16,24,37,9,1,21,25,46
17187,Trent VanHorn,2014,2017,Wake Forest,ACC,49,319,13,40,12,27,1,13,19,25,4,20,24,13,9,0,15,36,46
17188,Daniel Wallace,2015,2018,Saint Francis (PA),NEC,49,253,20,44,20,43,0,1,6,15,8,43,51,14,5,5,21,48,46
17189,Anthony Williams,2009,2011,IUPUI,Summit,41,201,19,35,19,35,0,0,8,13,13,28,41,1,4,4,6,48,46
17190,Orlando Allen,2009,2010,Oklahoma,Big 12,28,150,19,34,19,34,0,0,7,14,15,18,33,0,1,14,9,31,45
17191,Antwi Atuahene,2008,2008,Arizona State,Pac-10,28,193,14,29,11,25,3,4,14,20,6,27,33,12,15,0,12,28,45
17192,Terrance Beasley,2010,2010,Tulane,CUSA,25,190,17,56,16,47,1,9,10,19,12,18,30,6,4,2,15,42,45
17193,Marcus Blake,2012,2015,Florida Gulf Coast,A-Sun,62,284,14,43,14,42,0,1,17,28,21,48,69,10,6,5,18,25,45
17194,James Bridges,2019,2019,Sacramento State,Big Sky,27,326,15,42,5,8,10,34,5,7,6,22,28,6,6,2,4,11,45
17195,Ryan Burnett,2014,2015,Stony Brook,AEC,29,174,17,47,11,22,6,25,5,8,11,4,15,10,0,0,8,16,45
17196,Jamie Chapman,2013,2015,Southern Mississippi,CUSA,48,318,14,39,8,22,6,17,11,24,16,21,37,22,15,3,20,50,45
17197,Kasey Cunningham,2008,2010,Southern California,Pac-10,15,215,18,35,18,35,0,0,9,19,15,27,42,4,8,3,17,27,45
17198,Mike Dabney,2011,2011,Bowling Green State,MAC,16,151,15,28,15,28,0,0,15,26,18,14,32,0,4,13,10,31,45
17199,Ryan Darling,2009,2010,Cal Poly,Big West,33,369,20,38,20,38,0,0,5,8,34,61,95,8,7,13,14,61,45
17200,Paul Debnam,2008,2011,Virginia Tech,ACC,34,85,17,33,14,26,3,7,8,18,10,13,23,4,5,3,7,4,45
17201,Zac Downing,2011,2011,Stephen F. Austin,Southland,22,169,15,56,5,20,10,36,5,7,8,14,22,4,4,2,8,15,45
17202,Dre Evans,2011,2011,Providence,Big East,32,201,13,34,2,4,11,30,8,10,2,21,23,7,3,0,9,20,45
17203,Kadavion Evans,2017,2017,Louisiana,Sun Belt,15,162,15,46,6,12,9,34,6,7,2,10,12,27,7,1,9,22,45
17204,Marvin Fitzgerald,2011,2011,North Carolina Central,Ind,20,212,19,49,18,38,1,11,6,10,22,27,49,10,8,3,15,37,45
17205,Stojan Gjuroski,2012,2014,Louisiana Tech,Total,48,193,16,61,6,17,10,44,3,8,15,21,36,8,3,1,12,11,45
17206,Brendon Gooch,2018,2019,Southern Illinois,MVC,40,253,13,46,1,5,12,41,7,16,13,41,54,10,5,6,9,9,45
17207,Trendon Hankerson,2019,2019,Northern Illinois,MAC,21,394,17,54,9,22,8,32,3,4,5,42,47,19,12,9,22,55,45
17208,Nino Hernandez,2019,2019,Bryant,NEC,19,128,13,21,13,19,0,2,19,25,7,10,17,8,2,1,14,26,45
17209,Deveyon Hunter,2009,2009,Eastern Kentucky,OVC,25,183,17,47,15,31,2,16,9,18,9,9,18,10,2,0,12,11,45
17210,Beno Jaekel,2008,2008,Longwood,Ind,24,256,17,40,17,40,0,0,11,15,27,26,53,12,4,5,27,39,45
17211,Alex Jones,2019,2019,Lipscomb,A-Sun,34,266,16,49,13,29,3,20,10,17,3,31,34,34,23,0,18,27,45
17212,Bristan Kelley,2008,2008,Northern Illinois,MAC,26,224,17,32,17,32,0,0,11,17,14,21,35,7,5,2,12,41,45
17213,Ryan Kelley,2009,2009,Colorado,Big 12,17,94,14,29,9,18,5,11,12,20,3,5,8,3,3,0,8,11,45
17214,Lukas Kisunas,2019,2019,Stanford,Pac-12,28,173,17,33,17,33,0,0,11,18,16,33,49,4,1,6,10,30,45
17215,Ryan Krueger,2019,2019,South Dakota State,Summit,22,167,15,32,4,7,11,25,4,4,5,16,21,8,6,0,0,20,45
17216,Marquiez Lawrence,2014,2015,Kent State,MAC,47,340,18,37,18,37,0,0,9,20,31,49,80,6,8,12,24,86,45
17217,Marten Linssen,2018,2018,Valparaiso,MVC,22,163,13,30,13,30,0,0,19,33,15,29,44,6,12,7,15,39,45
17218,Marcus Littles,2019,2019,George Washington,A-10,24,161,18,33,18,33,0,0,9,14,4,25,29,4,1,4,20,28,45
17219,Marius McAllister,2015,2018,North Carolina Central,MEAC,44,252,18,36,18,34,0,2,9,15,18,35,53,22,11,3,15,23,45
17220,Alquan Mendenhall,2009,2009,High Point,Big South,11,116,17,49,7,13,10,36,1,2,5,8,13,8,6,0,3,12,45
17221,Bryant Mocaby,2019,2019,Northern Kentucky,Horizon,17,158,12,47,2,6,10,41,11,13,2,8,10,7,1,0,7,16,45
17222,Brenden Morris,2017,2019,Weber State,Big Sky,20,79,17,33,12,20,5,13,6,8,7,19,26,2,6,4,3,11,45
17223,Austin Mueller,2018,2019,Wyoming,MWC,21,321,15,38,11,25,4,13,11,14,6,29,35,6,9,6,21,42,45
17224,Chris Paige,2008,2009,Nicholls State,Southland,43,420,16,50,16,50,0,0,13,46,23,55,78,12,9,10,41,63,45
17225,Rob Peterson III,2019,2019,High Point,Big South,25,225,12,36,7,23,5,13,16,28,16,27,43,6,5,1,17,28,45
17226,Ben Rand,2008,2008,Northern Illinois,MAC,19,278,15,32,15,31,0,1,15,22,19,36,55,22,6,1,26,25,45
17227,Terrence Roderick,2009,2009,Alabama-Birmingham,CUSA,8,174,19,50,14,28,5,22,2,6,16,28,44,15,8,0,10,22,45
17228,Ryan Sims,2008,2009,Bowling Green State,MAC,29,215,15,48,8,16,7,32,8,14,10,13,23,17,4,0,18,22,45
17229,Anthony Smith,2018,2018,Nevada-Las Vegas,MWC,13,144,20,40,16,27,4,13,1,2,14,14,28,8,6,1,8,24,45
17230,Matty Smith,2017,2019,Central Michigan,MAC,62,350,20,53,19,41,1,12,4,12,6,25,31,51,12,2,30,47,45
17231,Tim Spitler,2008,2008,Saint Peter's,MAAC,25,297,17,41,16,35,1,6,10,18,22,30,52,14,18,2,16,30,45
17232,Aireus Stephenson,2011,2011,South Dakota State,Summit,18,129,16,53,11,38,5,15,8,12,1,5,6,20,4,0,10,5,45
17233,Mason Stuteville,2015,2016,Sacramento State,Big Sky,24,113,18,51,12,27,6,24,3,7,9,24,33,3,1,4,7,19,45
17234,Eric Vila,2017,2017,Texas A&M,SEC,20,237,15,51,9,28,6,23,9,16,4,36,40,18,10,0,13,16,45
17235,Kevin Wagner,2012,2012,Texas Tech,Big 12,18,266,15,49,10,39,5,10,10,15,3,12,15,27,7,2,19,28,45
17236,Matt Washington,2010,2010,Weber State,Big Sky,21,116,17,32,17,31,0,1,11,19,13,24,37,1,5,4,7,16,45
17237,Connor Wheeler,2016,2016,Southern Illinois-Edwardsville,OVC,22,251,14,63,6,24,8,39,9,13,3,21,24,22,9,1,12,33,45
17238,Longi Yiljep,2012,2015,Brown,Ivy,33,306,15,41,11,25,4,16,11,20,10,19,29,10,5,12,20,39,45
17239,Trevor Banks,2019,2019,Arkansas-Pine Bluff,SWAC,9,156,17,36,17,36,0,0,10,19,13,17,30,1,3,2,8,23,44
17240,Andrea Bernardi,2018,2018,Marist,MAAC,20,127,10,30,6,14,4,16,20,26,7,11,18,6,8,2,20,17,44
17241,Chris Brew,2010,2010,UC-Santa Barbara,Big West,15,130,17,37,17,36,0,1,10,21,8,8,16,12,9,0,8,9,44
17242,Charlie Burch,2008,2008,Providence,Big East,28,327,16,45,9,25,7,20,5,8,14,21,35,15,5,0,16,31,44
17243,T.J. Burke,2012,2013,UC-Riverside,Big West,25,200,18,40,16,35,2,5,6,13,18,35,53,2,2,7,13,31,44
17244,Michael Corchiani,2017,2017,Southeastern Louisiana,Southland,30,267,12,33,2,8,10,25,10,17,3,26,29,25,16,0,21,46,44
17245,Isaiah Cotton,2015,2015,Alabama A&M,SWAC,24,213,16,35,16,35,0,0,12,34,19,29,48,5,5,12,20,53,44
17246,Maurice County,2013,2013,New Orleans,Ind,25,225,18,45,15,29,3,16,5,6,9,13,22,20,11,5,12,22,44
17247,Khalil Cuffee,2019,2019,Southeast Missouri State,OVC,13,52,15,27,5,7,10,20,4,8,1,2,3,2,2,0,6,11,44
17248,Austin Davis,2018,2019,Michigan,Big Ten,41,143,21,33,21,33,0,0,2,6,14,27,41,3,2,7,8,32,44
17249,Kennon Dvorak,2012,2013,Texas A&M-Corpus Christi,Southland,27,238,13,38,4,10,9,28,9,18,9,17,26,11,6,0,11,21,44
17250,Niko Filipovich,2015,2016,Hawaii,Big West,42,206,11,40,7,11,4,29,18,19,3,15,18,14,9,0,19,31,44
17251,Spencer Freedman,2019,2019,Harvard,Ivy,16,194,13,42,1,6,12,36,6,6,0,8,8,19,2,0,19,18,44
17252,Jamison Glover,2015,2018,William & Mary,CAA,29,66,14,25,12,20,2,5,14,21,4,7,11,3,2,0,4,9,44
17253,Roger Guardia,2011,2011,Cal State Fullerton,Big West,20,211,16,42,6,11,10,31,2,2,9,29,38,7,7,0,12,20,44
17254,Brian Hoff,2008,2010,Florida State,ACC,32,117,15,33,6,11,9,22,5,10,11,8,19,6,2,1,4,10,44
17255,Ameer Jackson,2016,2016,Sam Houston State,Southland,4,99,12,37,6,20,6,17,14,25,3,5,8,6,0,1,6,9,44
17256,Sidiki Johnson,2012,2013,Total,Total,14,172,17,50,17,50,0,0,10,31,29,29,58,2,6,10,13,21,44
17257,Steve Jurich,2011,2011,Cal State Fullerton,Big West,17,219,15,42,8,17,7,25,7,18,10,20,30,6,3,0,12,25,44
17258,Keonte Kennedy,2019,2019,Xavier,Big East,21,269,17,51,8,16,9,35,1,5,3,28,31,13,6,0,11,22,44
17259,Donatas Kupsas,2019,2019,Weber State,Big Sky,24,238,14,45,11,26,3,19,13,16,3,46,49,15,4,1,14,31,44
17260,Sam Lindgren,2016,2019,Colgate,Patriot,33,177,20,37,20,36,0,1,4,7,11,23,34,11,7,4,8,26,44
17261,Calum Macleod,2008,2008,Valparaiso,Horizon,21,104,14,35,10,22,4,13,12,18,7,18,25,5,1,5,7,18,44
17262,Nick Martineau,2008,2012,Brigham Young,Total,64,289,15,49,8,27,7,22,7,10,3,23,26,34,10,0,16,22,44
17263,Tyler Maye,2018,2018,Virginia Commonwealth,A-10,32,238,17,46,15,39,2,7,8,15,3,13,16,16,11,1,16,26,44
17264,Raymoan McAfee,2011,2012,Bethune-Cookman,MEAC,49,284,19,47,19,46,0,1,6,17,16,25,41,2,2,11,16,54,44
17265,Arthur McMillan,2011,2011,Morehead State,OVC,26,143,17,32,17,32,0,0,10,13,10,21,31,2,2,1,12,27,44
17266,John Miller,2016,2019,Army,Patriot,50,231,19,35,19,35,0,0,6,19,20,28,48,5,6,10,12,32,44
17267,Nyandigsi Moikubo,2012,2013,Iona,MAAC,34,198,19,34,16,30,3,4,3,15,21,18,39,10,0,2,12,25,44
17268,Sean Montgomery,2011,2011,Chicago State,GWC,10,119,18,43,17,35,1,8,7,13,13,12,25,4,1,6,16,22,44
17269,Tim Morton,2011,2011,Oral Roberts,Summit,27,219,17,37,17,35,0,2,10,16,15,30,45,5,2,3,10,42,44
17270,T.J. Moss,2019,2019,South Carolina,SEC,7,144,16,41,8,17,8,24,4,6,0,13,13,13,4,0,14,8,44
17271,Scott Muirhead,2017,2019,Texas-Arlington,Sun Belt,40,87,15,51,1,4,14,47,0,0,2,7,9,3,0,1,5,8,44
17272,Shawn Oliverson,2009,2010,Louisiana Tech,WAC,52,360,20,37,20,37,0,0,4,14,32,30,62,4,3,10,16,66,44
17273,Davon Potts,2012,2012,Cal State Northridge,Big West,22,165,17,42,15,27,2,15,8,8,5,9,14,8,2,0,6,4,44
17274,Justin Robinson,2017,2019,Duke,ACC,40,150,16,32,6,6,10,26,2,7,2,19,21,3,2,13,8,14,44
17275,Steve Robinson,2008,2010,Quinnipiac,NEC,57,324,11,46,8,33,3,13,19,37,13,23,36,32,17,0,21,39,44
17276,Andrew Sorenson,2008,2009,Gonzaga,WCC,35,119,14,36,3,4,11,32,5,6,4,6,10,0,6,0,3,3,44
17277,Kenny Stewart,2011,2011,Eastern Michigan,MAC,25,183,19,45,18,38,1,7,5,8,7,18,25,2,7,1,12,34,44
17278,Alton Tanner,2013,2013,Missouri-Kansas City,Summit,16,208,12,40,7,21,5,19,15,20,11,16,27,6,6,0,12,26,44
17279,Victor Uyaelunmo,2018,2019,Southern California,Pac-12,43,236,14,26,14,26,0,0,16,42,20,38,58,3,5,10,14,39,44
17280,C.J. White,2019,2019,Southern Methodist,AAC,23,251,14,48,4,15,10,33,6,10,9,31,40,18,3,2,15,12,44
17281,Zach Williams,2009,2009,Stephen F. Austin,Southland,26,215,13,53,10,35,3,18,15,22,11,32,43,10,10,5,11,26,44
17282,Corey Wright,2010,2010,Long Island University,NEC,30,233,14,35,12,27,2,8,14,22,3,21,24,23,9,2,29,29,44
17283,Davids Atelbauers,2019,2019,North Dakota,Summit,17,176,15,46,8,25,7,21,6,9,1,13,14,15,4,1,12,19,43
17284,Reid Aube,2014,2017,Charlotte,CUSA,56,349,14,27,14,27,0,0,15,16,34,40,74,3,5,11,14,76,43
17285,Brock Bertram,2018,2019,Buffalo,MAC,37,148,18,31,18,31,0,0,7,12,19,13,32,3,3,7,12,33,43
17286,Lawrence Blackledge,2008,2008,Marquette,Big East,27,180,19,31,19,31,0,0,5,15,17,23,40,4,4,18,9,28,43
17287,Percy Blade,2013,2013,Western Kentucky,Sun Belt,23,221,12,31,10,19,2,12,17,23,7,30,37,7,7,0,23,15,43
17288,JC Butler,2019,2019,UC-Irvine,Big West,29,261,16,42,12,23,4,19,7,10,17,22,39,6,9,0,4,26,43
17289,Michael Chavers,2018,2018,Eastern Illinois,OVC,14,136,17,37,11,28,6,9,3,5,10,22,32,8,4,3,4,7,43
17290,Danny Cheek,2012,2012,Northern Arizona,Big Sky,18,139,15,61,7,29,8,32,5,8,3,9,12,5,7,1,12,21,43
17291,David Cohen,2008,2008,Colorado State,MWC,22,207,15,35,7,19,8,16,5,6,5,7,12,10,6,0,8,19,43
17292,Andreas Coleman,2008,2009,Morehead State,OVC,48,245,16,47,15,42,1,5,10,23,17,22,39,2,3,4,16,49,43
17293,Mike Copeland,2008,2009,North Carolina,ACC,42,144,16,34,16,32,0,2,11,14,12,22,34,4,0,8,16,24,43
17294,Zach Cottrell,2017,2018,Appalachian State,Sun Belt,34,245,15,46,7,12,8,34,5,10,10,27,37,13,7,0,8,25,43
17295,Gilles Dekoninck,2018,2019,Total,Total,27,159,14,31,11,19,3,12,12,28,9,14,23,3,5,1,13,27,43
17296,Jason Douglas-Stanley,2019,2019,George Mason,A-10,22,200,14,59,2,12,12,47,3,4,2,8,10,5,3,1,8,19,43
17297,Ludovic Dufeal,2019,2019,Gardner-Webb,Big South,18,163,18,33,16,25,2,8,5,6,17,25,42,3,5,14,2,14,43
17298,Kenton Eskridge,2019,2019,Southern Utah,Big Sky,23,208,14,48,9,22,5,26,10,16,9,13,22,19,10,1,15,31,43
17299,Mitch Farrell,2013,2013,NJIT,GWC,8,99,14,32,6,11,8,21,7,10,4,13,17,2,6,1,7,8,43
17300,Royce Hamilton,2009,2010,Alabama A&M,SWAC,34,263,16,56,14,40,2,16,9,19,11,19,30,7,11,6,14,26,43
17301,Eddie Hardy,2012,2012,Alabama A&M,SWAC,22,180,15,44,4,5,11,39,2,3,3,5,8,10,1,1,10,19,43
17302,Christian Harrison,2015,2019,Total,Total,48,290,15,27,14,24,1,3,12,21,19,34,53,13,18,6,14,40,43
17303,Eric Hester,2017,2017,Florida,SEC,18,111,15,23,4,4,11,19,2,4,1,9,10,6,6,0,3,13,43
17304,Elijah Jackson,2019,2019,Eastern Washington,Big Sky,25,202,18,40,16,30,2,10,5,9,15,27,42,4,7,2,11,25,43
17305,Lance James,2010,2010,Cleveland State,Horizon,11,106,12,29,10,22,2,7,17,21,12,6,18,7,4,0,9,15,43
17306,Luke Johnson,2018,2019,Loyola (MD),Patriot,39,268,18,38,13,27,5,11,2,2,6,18,24,9,4,0,4,17,43
17307,Trey Johnson,2019,2019,McNeese State,Southland,20,260,14,39,8,15,6,24,9,15,3,15,18,13,8,1,10,22,43
17308,Bud Jones,2018,2019,Eastern Michigan,MAC,35,150,19,30,19,30,0,0,5,10,17,20,37,1,1,4,11,32,43
17309,Jordan Knox,2012,2013,Cal State Fullerton,Big West,26,201,16,34,8,13,8,21,3,7,4,16,20,19,5,1,8,29,43
17310,Xairius Larry,2017,2017,Grambling,SWAC,27,123,13,36,2,7,11,29,6,12,4,8,12,6,7,1,6,18,43
17311,J.J. Marshall,2008,2008,Louisiana Tech,WAC,21,181,13,30,4,6,9,24,8,9,1,8,9,13,3,0,5,11,43
17312,Morris Marshall,2016,2017,Wyoming,MWC,23,126,15,36,10,23,5,13,8,10,6,17,23,4,2,1,6,12,43
17313,Okechukwu Mbanugo,2008,2008,Santa Clara,WCC,29,256,16,27,16,27,0,0,11,19,12,37,49,3,5,10,25,53,43
17314,Chris Mejia,2017,2017,Southeastern Louisiana,Southland,22,136,15,38,2,4,13,34,0,0,1,6,7,4,1,1,2,19,43
17315,Arsenio Mims,2008,2011,Western Illinois,Summit,63,433,20,74,20,71,0,3,3,9,35,54,89,8,14,2,12,41,43
17316,Orin O'Bryant,2012,2012,Hampton,MEAC,30,273,18,36,18,36,0,0,7,21,14,35,49,8,6,18,20,48,43
17317,Malachy Onwudiegwu,2016,2016,Alcorn State,SWAC,25,234,13,57,7,28,6,29,11,23,9,9,18,5,3,1,18,25,43
17318,Zach Padgett,2013,2013,Central Arkansas,Southland,22,159,15,52,5,16,10,36,3,5,4,16,20,3,4,1,11,19,43
17319,Steven Priestley,2008,2011,Siena,MAAC,66,265,14,35,14,34,0,1,15,31,27,38,65,0,6,4,13,47,43
17320,Johnatan Reyes,2018,2019,Northern Colorado,Big Sky,28,129,15,33,10,19,5,14,8,13,2,13,15,16,4,0,15,9,43
17321,Matt Sargeant,2008,2008,Princeton,Ivy,15,194,17,33,10,18,7,15,2,6,6,9,15,9,3,1,24,24,43
17322,C.J. Scott,2011,2011,Louisiana Tech,WAC,10,117,16,29,14,25,2,4,9,15,4,5,9,7,1,0,13,7,43
17323,Greg Sequele,2014,2015,DePaul,Big East,36,339,20,35,20,35,0,0,3,11,27,30,57,4,8,12,14,64,43
17324,Chris Stratton,2008,2008,William & Mary,CAA,25,179,13,25,12,23,1,2,16,19,10,12,22,10,3,1,12,18,43
17325,Kai Tease,2018,2018,Howard,MEAC,10,121,14,43,3,14,11,29,4,6,3,5,8,4,2,0,10,7,43
17326,Davion Thomas,2018,2019,Total,Total,26,143,15,39,13,29,2,10,11,14,11,15,26,3,1,4,13,14,43
17327,Hrvoje Vucic,2011,2012,Valparaiso,Horizon,33,215,17,44,17,43,0,1,9,13,13,32,45,8,2,10,15,31,43
17328,Deshaun Wade,2019,2019,East Carolina,AAC,22,223,13,50,3,8,10,42,7,10,4,18,22,18,3,1,17,16,43
17329,Omar Akram,2008,2008,Maryland-Eastern Shore,MEAC,20,201,17,67,16,48,1,19,7,11,18,34,52,10,9,3,13,13,42
17330,Dwayne Banks,2018,2019,South Carolina State,MEAC,40,291,12,45,5,21,7,24,11,14,10,18,28,29,9,1,41,44,42
17331,Freddy Bitondo,2018,2018,Sam Houston State,Southland,28,208,18,35,18,35,0,0,6,19,19,19,38,4,1,1,9,44,42
17332,Tyler Brimhall,2017,2017,Idaho,Big Sky,18,133,13,47,3,13,10,34,6,8,9,11,20,5,6,0,7,12,42
17333,Michael Chandler,2015,2015,Oregon,Pac-12,19,101,14,28,14,28,0,0,14,20,15,11,26,0,2,2,11,21,42
17334,Ganlandou Cisse,2016,2019,Long Island University,NEC,35,166,17,25,17,24,0,1,8,21,9,34,43,2,5,8,7,30,42
17335,Paul Cooper,2011,2011,Texas Tech,Big 12,23,234,14,32,14,32,0,0,14,29,17,20,37,5,4,3,16,38,42
17336,Mike Davis-Sabb,2008,2009,Hofstra,CAA,44,355,16,31,16,31,0,0,10,18,25,58,83,8,8,7,20,70,42
17337,Andrew Ferguson,2019,2019,San Diego,WCC,17,108,15,30,6,13,9,17,3,4,2,17,19,14,3,6,9,26,42
17338,Mike Fleming,2014,2014,Dartmouth,Ivy,18,174,9,33,7,17,2,16,22,26,4,6,10,14,5,0,12,23,42
17339,Marcus Fuggins,2015,2015,Morehead State,OVC,28,241,16,39,16,38,0,1,10,32,27,30,57,5,11,14,22,66,42
17340,Kirby Gardner,2013,2013,Oklahoma State,Big 12,33,314,16,54,14,39,2,15,8,15,10,22,32,30,14,1,19,27,42
17341,Nick Goddard,2008,2008,Akron,MAC,13,60,11,27,1,2,10,25,10,12,0,3,3,2,0,0,2,5,42
17342,Grady Green,2010,2010,Prairie View,SWAC,9,112,18,42,14,30,4,12,2,10,3,17,20,0,1,3,11,12,42
17343,Isaiah Green,2018,2019,Eastern Michigan,MAC,33,180,18,36,17,31,1,5,5,10,13,31,44,3,8,8,6,12,42
17344,Ryan Greer,2019,2019,Northwestern,Big Ten,28,250,17,55,13,38,4,17,4,8,4,23,27,24,8,1,26,32,42
17345,Trey Grundy,2016,2016,North Carolina-Wilmington,CAA,17,123,16,38,15,28,1,10,9,14,9,11,20,4,5,3,9,29,42
17346,Quentin Guliford,2019,2019,Montana State,Big Sky,21,139,16,33,12,16,4,17,6,8,7,17,24,2,4,1,3,5,42
17347,Terrance Hubby,2016,2017,Lamar,Southland,25,137,14,25,14,22,0,3,14,29,6,20,26,1,9,7,8,26,42
17348,Jock Hughes,2019,2019,Stephen F. Austin,Southland,18,157,14,36,5,14,9,22,5,6,6,14,20,7,1,5,10,14,42
17349,Ryan Hynes,2008,2008,Georgia Southern,Southern,23,171,15,37,15,34,0,3,12,19,6,19,25,3,3,7,16,29,42
17350,Bryce Jackson,2015,2018,Total,Total,51,266,15,38,13,25,2,13,10,14,18,25,43,5,2,4,19,41,42
17351,LaMarvon Jackson,2008,2009,Little Rock,Sun Belt,45,372,14,26,14,26,0,0,14,28,18,50,68,9,5,11,20,49,42
17352,Edwin Lashley,2008,2009,Saint Joseph's,A-10,32,100,13,31,2,5,11,26,5,6,2,7,9,5,2,0,6,9,42
17353,Colby Leifson,2017,2017,Brigham Young,WCC,26,110,14,43,1,4,13,39,1,2,3,5,8,6,2,0,6,16,42
17354,Tellef Lundevall,2012,2012,Brown,Ivy,21,230,15,58,7,28,8,30,4,6,8,23,31,10,9,0,7,26,42
17355,Giovanni Mack,2015,2015,Texas Southern,SWAC,24,223,13,34,6,17,7,17,9,14,3,18,21,14,6,1,8,16,42
17356,Matt Maden,2008,2010,Gardner-Webb,Total,39,208,18,40,18,40,0,0,6,11,18,28,46,5,4,6,20,26,42
17357,Shawn Montague,2017,2017,Sacred Heart,NEC,22,161,16,31,14,27,2,4,8,21,16,34,50,4,5,0,11,15,42
17358,Daine Muller,2017,2017,Oregon State,Pac-12,21,207,13,28,0,0,13,28,3,4,1,17,18,18,3,0,9,19,42
17359,Kevin Ndahiro,2016,2017,Stetson,A-Sun,29,201,14,34,14,34,0,0,14,24,20,35,55,0,2,13,18,49,42
17360,Shaun Neal-Williams,2019,2019,Kansas State,Big 12,29,212,14,58,7,27,7,31,7,12,8,25,33,19,8,2,15,22,42
17361,Alex Orchowski,2009,2010,Lafayette,Patriot,43,219,13,21,11,16,2,5,14,20,17,27,44,9,4,4,13,31,42
17362,Ross Owens,2017,2019,Missouri State,MVC,35,156,15,43,6,8,9,35,3,6,8,12,20,9,7,1,8,15,42
17363,Isiah Patterson,2014,2015,Grambling,SWAC,28,175,13,42,4,15,9,27,7,10,3,11,14,8,4,0,10,7,42
17364,Jerry Perry,2018,2018,Texas Southern,SWAC,11,202,10,28,7,20,3,8,19,26,6,9,15,19,6,0,16,15,42
17365,Mat Piotrowski,2012,2015,Total,Total,42,281,17,57,13,34,4,23,4,5,10,46,56,8,5,29,12,19,42
17366,Jordan Pope-Didier,2012,2012,Texas A&M-Corpus Christi,Southland,28,296,20,48,20,44,0,4,2,7,18,30,48,3,7,5,18,56,42
17367,Andrew Smith,2009,2009,Texas-Rio Grande Valley,Ind,14,66,13,24,13,24,0,0,16,23,14,11,25,2,0,4,3,13,42
17368,Caleb Starks,2018,2018,Northwestern State,Southland,27,256,17,56,15,42,2,14,6,11,14,15,29,9,5,0,22,26,42
17369,Sammy Sutter,2012,2012,Illinois-Chicago,Horizon,15,115,14,39,10,24,4,15,10,12,4,6,10,6,3,0,10,23,42
17370,Jabbar Washington,2015,2016,Charleston Southern,Big South,29,175,15,44,10,26,5,18,7,16,3,16,19,17,6,2,10,14,42
17371,JC Washington,2017,2017,Charlotte,CUSA,9,157,20,40,20,39,0,1,2,5,11,28,39,11,3,6,13,27,42
17372,Jalen Williams,2017,2017,High Point,Big South,31,445,14,64,9,39,5,25,9,20,9,15,24,42,7,1,29,41,42
17373,Johnny Woodard,2016,2016,Tennessee State,OVC,7,117,13,33,1,4,12,29,4,5,3,12,15,5,1,1,8,10,42
17374,Maros Zeliznak,2019,2019,Jacksonville State,OVC,24,192,17,30,17,30,0,0,8,20,19,19,38,2,1,4,13,29,42
17375,Adetunji Adedipe,2009,2011,Ohio,MAC,63,223,19,31,19,31,0,0,3,16,25,33,58,3,3,1,14,55,41
17376,Jameel Alausa,2018,2019,Yale,Ivy,24,99,14,36,13,30,1,6,12,17,12,11,23,4,3,3,9,22,41
17377,Tony Bagtas,2014,2014,Pennsylvania,Ivy,20,271,16,45,13,34,3,11,6,8,2,21,23,40,13,1,25,23,41
17378,Donald Bell,2009,2009,Prairie View,SWAC,10,134,14,48,14,41,0,7,13,18,10,4,14,4,2,1,5,11,41
17379,James Bento,2014,2016,Mercer,Total,52,292,18,45,18,44,0,1,5,15,26,50,76,9,6,4,8,31,41
17380,Josh Biber,2011,2014,Brown,Ivy,38,253,13,37,13,34,0,3,15,32,19,27,46,13,4,0,11,24,41
17381,Kinley Branch,2011,2011,Arkansas State,Sun Belt,9,63,10,27,1,3,9,24,12,15,2,6,8,4,3,1,2,7,41
17382,Matt Brown,2011,2015,Harvard,Ivy,49,271,13,37,6,14,7,23,8,12,3,23,26,8,8,1,11,22,41
17383,Rod Brown,2019,2019,Wichita State,AAC,36,257,13,41,12,33,1,8,14,26,19,29,48,4,7,1,10,25,41
17384,Matt Bush,2011,2012,Illinois-Chicago,Horizon,30,262,15,51,4,15,11,36,0,2,7,14,21,11,2,1,18,28,41
17385,Corbin Byford,2013,2014,Oral Roberts,Southland,21,136,14,28,11,17,3,11,10,17,7,27,34,6,4,6,13,26,41
17386,P.J. Byrd,2019,2019,Virginia Commonwealth,A-10,33,302,10,37,6,18,4,19,17,22,4,13,17,36,6,0,35,35,41
17387,Mitchell Carter,2008,2011,Total,Total,37,138,14,33,14,33,0,0,13,24,11,10,21,1,1,6,11,19,41
17388,Jin Soo Choi,2009,2010,Maryland,ACC,30,180,14,51,9,28,5,23,8,11,7,27,34,2,8,6,14,26,41
17389,Tre Cobbs,2017,2018,Northern Kentucky,Horizon,23,101,12,17,9,12,3,5,14,19,0,5,5,10,3,0,12,20,41
17390,Victor Dorsey,2015,2015,Longwood,Big South,24,221,17,41,17,40,0,1,7,11,14,25,39,4,4,5,13,32,41
17391,Chukuka Emili,2018,2018,Houston Baptist,Southland,23,232,16,57,12,38,4,19,5,13,16,32,48,3,5,19,13,35,41
17392,Desmond Fleming,2014,2017,Cornell,Ivy,67,279,18,29,18,25,0,4,5,8,3,26,29,21,7,1,12,39,41
17393,Michael Fleming,2016,2016,Dartmouth,Ivy,22,269,16,33,9,14,7,19,2,3,6,9,15,15,4,0,19,24,41
17394,Kourtney Goff,2012,2012,Southern Illinois,MVC,28,419,12,49,9,29,3,20,14,21,10,16,26,44,23,0,32,36,41
17395,DouDou Gueye,2015,2017,Total,Total,54,405,19,39,19,39,0,0,3,11,24,53,77,13,10,13,20,68,41
17396,Reggie Guyton,2009,2009,Oral Roberts,Summit,14,214,16,44,13,27,3,17,6,6,1,19,20,25,7,1,13,12,41
17397,Austin Henry,2015,2015,Incarnate Word,Southland,28,231,18,56,16,49,2,7,3,8,15,26,41,3,3,7,5,42,41
17398,Jaylen Hinton,2014,2014,Georgia State,Sun Belt,29,210,13,32,13,30,0,2,15,27,4,14,18,23,8,2,4,21,41
17399,DJ Houston,2019,2019,Western Michigan,MAC,24,217,14,40,12,32,2,8,11,25,7,26,33,16,18,1,11,31,41
17400,Logan Irwin,2013,2013,Stetson,A-Sun,7,152,11,15,6,8,5,7,14,16,1,11,12,20,2,0,13,16,41
17401,Cedric Jackson,2019,2019,Florida Atlantic,CUSA,28,232,15,65,8,18,7,47,4,8,12,7,19,13,8,0,3,21,41
17402,Marques Jones,2012,2012,NJIT,GWC,22,236,15,50,9,21,6,29,5,8,2,21,23,12,8,1,26,22,41
17403,Jordan Juenemann,2009,2012,Kansas,Big 12,44,103,16,34,10,21,6,13,3,8,2,17,19,3,1,1,7,11,41
17404,Ricky Krainiak,2010,2010,Campbell,A-Sun,21,156,14,40,5,9,9,31,4,5,0,10,10,3,5,2,8,12,41
17405,Johnnie Lacy,2010,2010,Providence,Big East,22,179,14,51,12,29,2,22,11,14,8,6,14,14,7,0,9,18,41
17406,Cameron Madlock,2008,2011,Total,MAC,38,289,19,44,19,44,0,0,3,11,22,44,66,7,5,12,10,51,41
17407,Aaron Moesch,2015,2018,Wisconsin,Big Ten,72,273,11,22,9,19,2,3,17,21,12,20,32,13,7,1,9,23,41
17408,Courtney Nelson,2008,2008,Rutgers,Big East,13,178,14,50,10,24,4,26,9,15,7,16,23,8,4,0,13,19,41
17409,Fred Newell,2011,2014,North Dakota State,Summit,54,154,13,39,10,26,3,13,12,21,11,17,28,13,11,0,9,15,41
17410,Alex Newsome,2010,2010,Navy,Patriot,25,155,16,27,16,27,0,0,9,15,11,16,27,1,2,6,13,15,41
17411,Jeron Rogers,2016,2016,Cleveland State,Horizon,25,228,12,47,7,24,5,23,12,18,9,29,38,7,4,3,11,26,41
17412,Minfeke Sanoe,2019,2019,Tennessee-Martin,OVC,24,139,18,39,18,39,0,0,5,7,19,28,47,5,1,5,17,26,41
17413,Jon Schmidt,2012,2015,Brown,Ivy,48,297,17,56,17,56,0,0,7,14,31,29,60,15,4,9,14,34,41
17414,Chris Snyder,2017,2018,Western Illinois,Summit,27,177,18,29,18,27,0,2,5,10,8,23,31,5,4,7,9,31,41
17415,Elijah Staley,2016,2018,Total,Total,23,214,16,35,16,35,0,0,9,17,24,24,48,12,4,2,16,25,41
17416,Hassan Thomas,2016,2017,Illinois-Chicago,Horizon,28,200,11,45,9,37,2,8,17,23,17,29,46,8,7,2,11,25,41
17417,Daniel Venzant,2018,2018,Cal State Fullerton,Big West,24,138,17,35,14,23,3,12,4,11,0,14,14,12,3,0,9,14,41
17418,Jere Vucica,2016,2016,Miami (OH),MAC,8,86,15,32,14,26,1,6,10,16,11,10,21,1,1,0,3,8,41
17419,Sam Walters,2016,2018,UC-Santa Barbara,Big West,35,210,14,40,3,5,11,35,2,2,1,13,14,16,4,1,13,11,41
17420,Aaron Wilson,2009,2009,Sacramento State,Big Sky,19,221,18,38,18,38,0,0,5,7,18,11,29,4,5,0,10,39,41
17421,Deschon Winston,2018,2018,University of California,Pac-12,25,163,15,50,11,27,4,23,7,9,5,11,16,7,4,0,18,17,41
17422,Joseph Wright,2010,2011,South Carolina State,MEAC,34,203,13,30,13,30,0,0,15,21,14,22,36,2,8,1,18,47,41
17423,Steve Zazuri,2009,2012,Sacred Heart,NEC,70,833,17,56,17,56,0,0,7,13,19,59,78,94,36,7,73,133,41
17424,Emmanuel Adeife,2008,2009,Total,Total,18,204,11,24,11,24,0,0,18,34,24,41,65,1,2,18,7,30,40
17425,Silas Adheke,2019,2019,Northern Kentucky,Horizon,19,98,17,24,14,19,3,5,3,5,10,24,34,6,2,1,8,22,40
17426,Ryan Andrus,2015,2015,Brigham Young,WCC,21,157,12,22,9,14,3,8,13,18,12,16,28,3,4,2,5,24,40
17427,Stephen Baird,2012,2012,Liberty,Big South,16,128,15,33,11,22,4,11,6,14,7,11,18,2,4,3,7,15,40
17428,Illiwa Baldwin,2011,2011,Nevada,WAC,12,146,16,29,16,29,0,0,8,13,11,16,27,4,2,3,10,27,40
17429,TeMarcus Blanton,2016,2017,South Carolina,SEC,29,155,13,34,7,18,6,16,8,12,10,17,27,4,8,0,7,14,40
17430,Justin Brickman,2014,2017,Bryant,NEC,32,221,13,39,10,29,3,10,11,15,6,17,23,30,11,0,24,25,40
17431,Isaac Brown,2010,2012,Florida A&M,MEAC,57,387,12,64,10,42,2,22,14,30,4,21,25,38,26,0,36,49,40
17432,Denny Burguillos,2013,2014,Georgia State,Total,38,339,16,33,16,33,0,0,8,17,23,32,55,2,8,12,13,71,40
17433,Isaiah Burnett,2019,2019,Navy,Patriot,25,242,14,48,8,26,6,22,6,8,8,24,32,19,10,4,21,13,40
17434,Jermonte Bush,2008,2008,Florida A&M,MEAC,10,,15,42,13,32,2,10,8,13,0,6,6,8,7,0,14,12,40
17435,Maurice Calloo,2019,2019,Oklahoma State,Big 12,16,172,16,49,14,32,2,17,6,12,10,16,26,6,1,0,11,23,40
17436,Lin Chang,2010,2011,Long Beach State,Big West,29,130,9,26,4,14,5,12,17,23,12,21,33,3,4,3,11,30,40
17437,Dejan Cvoro,2009,2009,Western Kentucky,Sun Belt,24,267,11,51,2,22,9,29,9,15,10,21,31,21,8,4,20,31,40
17438,James Davis,2013,2013,Northern Colorado,Big Sky,19,246,14,52,7,20,7,32,5,6,1,22,23,22,6,1,15,25,40
17439,Chris Dubose,2018,2019,Savannah State,MEAC,24,142,13,53,3,5,10,48,4,4,2,4,6,2,2,1,3,7,40
17440,Jake Ehlers,2013,2013,Portland,WCC,22,163,13,32,9,23,4,9,10,17,9,14,23,3,2,0,10,15,40
17441,Richard Feagin,2018,2019,Morehead State,OVC,29,191,15,39,9,22,6,17,4,5,3,28,31,19,3,0,14,10,40
17442,Chris Fitzgerald,2011,2011,George Washington,A-10,13,93,12,42,3,7,9,35,7,8,6,5,11,2,3,0,3,6,40
17443,Drew Friberg,2019,2019,Princeton,Ivy,21,150,12,40,4,6,8,34,8,11,5,6,11,5,0,3,4,18,40
17444,Fred Garmon,2014,2014,Austin Peay,OVC,23,309,15,44,11,26,4,18,6,14,3,25,28,27,18,0,24,43,40
17445,Charles Gavin,2018,2018,Western Illinois,Summit,18,181,18,38,18,38,0,0,4,11,16,17,33,2,1,1,5,21,40
17446,James Gordon IV,2018,2019,Toledo,MAC,17,78,16,32,14,28,2,4,6,9,7,10,17,3,2,1,7,9,40
17447,Derrick Green,2017,2019,Total,Total,32,205,10,36,5,19,5,17,15,29,8,23,31,13,6,1,10,19,40
17448,Orrin Greer,2008,2008,Texas-San Antonio,Southland,13,191,14,56,10,34,4,22,8,13,5,9,14,11,5,0,18,23,40
17449,Kyle Gullett,2016,2016,Southeast Missouri State,OVC,23,285,14,45,5,22,9,23,3,5,15,19,34,14,7,1,9,22,40
17450,Jacob Hazzard,2013,2016,Arizona,Pac-12,43,93,15,43,7,20,8,23,2,2,0,5,5,7,2,0,12,7,40
17451,Bear Henderson,2016,2016,Eastern Washington,Big Sky,28,150,12,23,10,19,2,4,14,21,9,9,18,6,4,1,8,29,40
17452,C.J. Henry,2010,2010,Kansas,Big 12,13,73,14,24,3,3,11,21,1,2,1,8,9,4,5,1,2,12,40
17453,Tommy Hobbs,2013,2014,New Orleans,Total,15,70,15,29,11,20,4,9,6,9,8,14,22,2,4,2,4,3,40
17454,A.J. Holland,2010,2010,Rice,CUSA,26,315,12,48,5,22,7,26,9,14,0,26,26,37,18,3,28,26,40
17455,Trey Hopkins,2019,2019,Seattle,WAC,17,136,17,40,14,24,3,16,3,5,11,10,21,4,2,0,7,14,40
17456,Brian Hornstein,2011,2015,Total,Total,46,180,19,47,19,46,0,1,2,8,19,19,38,2,6,9,11,28,40
17457,Monie Hudson,2010,2010,Evansville,MVC,25,167,14,37,7,13,7,24,5,7,3,17,20,6,1,0,4,10,40
17458,Myles Hutchinson,2018,2019,McNeese State,Southland,25,103,13,39,10,22,3,17,11,15,7,4,11,7,10,1,13,13,40
17459,Dontay Jackson,2015,2015,Jacksonville State,OVC,28,336,14,37,14,32,0,5,12,34,7,40,47,34,16,2,29,35,40
17460,Waylon Jones,2011,2012,Southeast Missouri State,OVC,36,307,14,28,14,28,0,0,12,21,16,40,56,13,5,17,26,70,40
17461,Mari Kontae,2011,2011,McNeese State,Southland,28,220,14,37,13,26,1,11,11,12,17,20,37,3,6,4,6,32,40
17462,Milos Kostic,2015,2015,Appalachian State,Sun Belt,21,146,14,44,8,17,6,27,6,8,12,17,29,7,3,1,8,11,40
17463,Amel Kuljuhovic,2019,2019,Cal State Fullerton,Big West,18,150,15,35,13,31,2,4,8,16,9,29,38,4,4,3,8,18,40
17464,Braylon Lazare,2013,2014,Louisiana,Sun Belt,36,181,16,41,16,41,0,0,8,11,21,13,34,7,5,5,9,46,40
17465,Verkeneo Mann,2011,2011,Tennessee State,OVC,20,185,11,42,1,6,10,36,8,10,7,8,15,7,4,0,7,25,40
17466,Wendell Mardis,2008,2008,Alabama State,SWAC,19,195,14,34,5,13,9,21,3,6,8,11,19,23,11,0,15,29,40
17467,Reginald Martin,2011,2012,Alabama A&M,SWAC,37,290,16,42,16,41,0,1,8,12,10,40,50,6,8,1,25,55,40
17468,Ivan Matip,2011,2012,Cal State Bakersfield,Ind,38,231,14,48,9,21,5,27,7,14,7,13,20,5,5,3,10,30,40
17469,Kyle McElvain,2013,2014,Texas-Arlington,Total,33,177,14,45,4,11,10,34,2,2,3,11,14,3,5,0,6,23,40
17470,Shelton Mickell,2012,2012,Central Connecticut State,NEC,23,175,9,47,6,31,3,16,19,23,5,5,10,12,9,1,20,22,40
17471,Milutin Mirjacic,2008,2008,Maryland-Eastern Shore,MEAC,24,376,17,54,17,43,0,11,6,8,18,33,51,5,14,2,14,49,40
17472,Anthony Oliver II,2018,2018,Clemson,ACC,19,137,11,35,2,9,9,26,9,11,5,21,26,5,6,0,5,15,40
17473,Goran Pantovic,2011,2014,Drexel,CAA,46,384,17,37,17,37,0,0,6,9,42,41,83,6,7,20,14,57,40
17474,Chauncy Parker,2015,2016,Arkansas-Pine Bluff,SWAC,57,453,16,32,16,31,0,1,8,18,14,42,56,28,16,39,37,89,40
17475,Casey Perrin,2013,2016,Campbell,Big South,21,77,12,33,2,5,10,28,6,6,3,2,5,6,3,0,5,14,40
17476,Josh Pierre,2013,2016,Arkansas State,Sun Belt,44,337,10,52,1,6,9,46,11,16,6,30,36,4,8,1,6,18,40
17477,Justin Salzwedel,2010,2011,Boise State,WAC,28,133,12,36,0,4,12,32,4,4,4,5,9,3,1,0,3,8,40
17478,Jeremiah Saunders,2019,2019,Southeastern Louisiana,Southland,27,162,14,41,5,14,9,27,3,9,6,23,29,9,8,1,14,17,40
17479,Thornton Scott,2019,2019,William & Mary,CAA,22,347,13,45,5,15,8,30,6,10,2,29,31,49,6,3,29,15,40
17480,Devon Seaford,2008,2008,Lipscomb,A-Sun,16,123,11,55,1,15,10,40,8,10,2,3,5,6,5,0,5,9,40
17481,Archie Seals,2010,2011,Chicago State,GWC,20,289,16,37,13,26,3,11,5,12,11,18,29,11,11,0,20,29,40
17482,Mikail Simmons,2018,2018,Loyola Marymount,WCC,20,144,15,36,10,17,5,19,5,9,12,16,28,6,4,3,10,36,40
17483,Ricquall Smoot,2019,2019,Hampton,Big South,31,187,19,30,19,30,0,0,2,6,15,28,43,2,1,5,6,25,40
17484,James Spencer,2008,2011,Liberty,Big South,79,491,13,34,8,17,5,17,9,23,10,51,61,32,12,2,32,46,40
17485,Larry Stone,2009,2009,IUPUI,Summit,18,145,14,29,11,23,3,6,9,20,2,6,8,21,8,0,14,23,40
17486,Dan Studer,2015,2017,Milwaukee,Horizon,45,214,16,51,16,43,0,8,8,17,19,26,45,15,9,1,14,35,40
17487,Sebastian Suarez,2015,2015,Portland State,Big Sky,14,142,14,33,7,16,7,17,5,6,5,9,14,7,6,5,6,8,40
17488,Christopher Szalay,2008,2008,Rice,CUSA,15,140,13,35,1,5,12,30,2,2,4,7,11,13,1,1,9,16,40
17489,Danny Thompson,2010,2010,Fordham,A-10,24,266,13,51,6,25,7,26,7,8,9,25,34,7,3,1,16,20,40
17490,Milos Trivic,2011,2013,St. Francis (NY),NEC,44,186,14,34,9,23,5,11,7,22,15,20,35,6,10,1,14,30,40
17491,Lonnie Watson,2012,2013,Cal State Northridge,Big West,24,217,14,42,7,18,7,24,5,7,7,14,21,11,9,3,5,15,40
17492,Daniel Watts,2009,2011,Elon,Southern,54,252,17,44,17,44,0,0,6,11,12,42,54,5,9,10,15,38,40
17493,Tyrell Williams,2017,2018,Iona,MAAC,40,194,15,31,15,31,0,0,10,13,20,37,57,2,2,13,12,48,40
17494,Zach Wing,2008,2009,Fordham,A-10,28,372,13,27,13,27,0,0,14,30,23,38,61,5,7,1,14,70,40
17495,Mark Wohlford,2008,2010,Purdue,Big Ten,42,197,13,28,5,12,8,16,6,11,8,16,24,9,4,1,7,15,40
17496,Shaun Adams,2010,2011,Loyola (IL),Horizon,31,122,10,35,6,19,4,16,15,21,12,20,32,6,5,8,8,9,39
17497,Joel Ayayi,2019,2019,Gonzaga,WCC,23,128,17,32,14,21,3,11,2,7,6,26,32,12,6,0,2,12,39
17498,Yonas Berhe,2009,2010,Louisiana Tech,WAC,47,373,18,50,17,41,1,9,2,5,6,27,33,30,5,0,27,30,39
17499,Michael Birts,2012,2013,Southern Illinois-Edwardsville,OVC,33,179,11,25,11,24,0,1,17,23,13,14,27,2,1,7,11,25,39
17500,Langston Burnett,2013,2015,Wagner,NEC,46,292,12,55,6,16,6,39,9,22,10,28,38,10,4,5,16,23,39
17501,Will Childs-Klein,2012,2014,Yale,Ivy,28,96,17,36,16,31,1,5,4,8,6,13,19,6,2,6,11,15,39
17502,Tyler Corley,2015,2015,Mississippi Valley State,SWAC,7,110,12,42,9,29,3,13,12,18,3,3,6,7,4,0,9,6,39
17503,Lewis Cramer,2013,2015,Total,Total,25,185,15,34,15,34,0,0,9,15,11,15,26,4,4,2,6,22,39
17504,Tyshaun Crawford,2019,2019,Georgia Southern,Sun Belt,11,57,17,22,17,22,0,0,5,10,7,10,17,0,0,2,4,9,39
17505,DaRon Curry,2016,2017,Fairleigh Dickinson,NEC,32,196,15,38,14,31,1,7,8,14,1,14,15,18,3,0,14,25,39
17506,Juwan Davenport,2017,2017,Coppin State,MEAC,12,172,11,26,11,22,0,4,17,28,15,22,37,5,7,0,18,20,39
17507,Angelo Davis,2011,2014,Savannah State,Total,43,122,8,26,8,25,0,1,23,32,6,5,11,5,5,0,13,15,39
17508,Justin Davis,2008,2011,Total,Total,60,388,17,48,17,48,0,0,5,20,40,53,93,2,5,18,17,84,39
17509,Devenir Duruisseau,2016,2018,Washington,Pac-12,36,205,14,34,14,30,0,4,11,22,17,31,48,2,3,5,14,43,39
17510,Terrance Farley,2008,2008,Louisville,Big East,27,175,15,30,15,30,0,0,9,30,16,16,32,2,3,12,11,35,39
17511,Will Ferris,2016,2016,Eastern Washington,Big Sky,29,174,11,33,3,9,8,24,9,9,5,10,15,17,3,1,12,34,39
17512,Jeff Georgatos,2010,2013,Harvard,Ivy,44,265,17,42,16,38,1,4,4,8,8,21,29,1,3,4,9,17,39
17513,Quinton Gustavson,2012,2014,Milwaukee,Horizon,36,133,14,31,8,15,6,16,5,11,7,22,29,4,2,3,4,14,39
17514,Lance Harris,2008,2008,Wichita State,MVC,20,235,13,43,3,10,10,33,3,3,8,6,14,7,10,6,17,16,39
17515,Joe Henson,2010,2012,San Jose State,WAC,58,501,15,41,15,41,0,0,9,15,33,60,93,3,10,16,24,95,39
17516,Malik Hluchoweckyj,2016,2017,Bowling Green State,MAC,22,168,15,33,10,18,5,15,4,7,7,15,22,9,8,3,9,12,39
17517,Ethan Igbanugo,2019,2019,North Dakota,Summit,20,138,13,29,2,5,11,24,2,4,2,8,10,7,4,2,7,8,39
17518,Michael James,2008,2008,Florida International,Sun Belt,11,266,12,35,6,18,6,17,9,12,3,14,17,32,12,2,27,27,39
17519,Matey Juric,2019,2019,Drexel,CAA,25,282,14,33,11,24,3,9,8,11,5,15,20,25,16,2,23,38,39
17520,John Lickliter,2010,2010,Iowa,Big Ten,21,175,12,40,2,5,10,35,5,6,1,6,7,15,5,0,11,16,39
17521,Nick Livi,2008,2008,Southern Utah,Summit,5,91,11,25,4,10,7,15,10,12,0,7,7,12,2,0,16,12,39
17522,Greg Manning,2008,2008,Loyola (MD),MAAC,25,139,14,32,8,14,6,18,5,5,6,4,10,3,4,0,12,12,39
17523,Rundell Mauge,2012,2012,Pacific,Big West,20,166,18,38,18,38,0,0,3,5,13,22,35,7,10,14,10,30,39
17524,David McKinley,2010,2013,Ohio,MAC,50,134,13,29,4,7,9,22,4,4,1,7,8,8,8,0,6,9,39
17525,Dalky Melendez,2008,2008,Louisiana-Monroe,Sun Belt,19,128,15,29,9,16,6,13,3,5,9,10,19,3,1,5,6,9,39
17526,Brandon Morley,2019,2019,Utah,Pac-12,16,108,13,34,7,16,6,18,7,13,14,13,27,2,2,1,8,18,39
17527,DeMarko Nash,2013,2013,Texas-Rio Grande Valley,GWC,29,312,12,57,3,27,9,30,6,9,0,14,14,42,12,1,35,24,39
17528,Niklas Ney,2015,2016,Mercer,Southern,35,145,9,22,9,22,0,0,21,25,13,12,25,1,0,1,10,24,39
17529,Bailey Patella,2018,2019,Vermont,AEC,34,191,16,31,13,18,3,13,4,7,8,28,36,11,9,4,1,9,39
17530,Ross Pentland,2009,2010,Central Connecticut State,NEC,34,254,13,39,8,24,5,15,8,11,9,21,30,16,6,1,13,13,39
17531,Daniel Pillari,2015,2018,Monmouth,MAAC,57,105,8,33,4,12,4,21,19,26,2,8,10,5,3,0,10,18,39
17532,Tyler Ptacek,2014,2014,Evansville,MVC,22,152,11,36,0,9,11,27,6,6,6,4,10,4,1,0,9,14,39
17533,Jaylon Pugh,2019,2019,Furman,Southern,15,103,12,25,2,5,10,20,5,6,5,14,19,6,3,0,5,4,39
17534,Varun Ram,2014,2016,Maryland,Total,63,291,7,39,1,10,6,29,19,25,3,24,27,19,19,0,21,52,39
17535,Matthew Reed,2016,2016,Florida Atlantic,CUSA,13,161,17,30,17,30,0,0,5,5,9,28,37,0,1,6,4,33,39
17536,Lee Richmond,2017,2019,Jacksonville,A-Sun,21,135,12,24,10,17,2,7,13,15,3,13,16,10,9,0,11,18,39
17537,Rickey Royal,2008,2009,Army,Patriot,48,497,10,35,10,32,0,3,19,27,8,41,49,42,22,1,39,63,39
17538,Thomas Ryan,2016,2019,Yale,Ivy,39,150,11,40,6,13,5,27,12,17,4,7,11,4,7,3,10,23,39
17539,Ryan Siggins,2010,2010,DePaul,Big East,10,140,13,34,3,8,10,26,3,4,5,7,12,5,1,1,2,13,39
17540,Chris Smith,2019,2019,Arkansas-Pine Bluff,SWAC,32,271,12,35,12,35,0,0,15,35,19,33,52,7,6,8,20,63,39
17541,Jarius Stevens,2018,2018,Purdue-Fort Wayne,Summit,13,86,14,35,13,26,1,9,10,10,10,11,21,2,3,0,4,3,39
17542,Devin Stowers,2008,2010,Savannah State,Ind,47,234,13,33,13,33,0,0,13,17,20,25,45,4,6,1,17,43,39
17543,Brian Talley,2009,2009,Southern,SWAC,25,284,14,50,8,21,6,29,5,10,3,17,20,25,4,0,27,19,39
17544,Eules Thompson,2009,2009,Southern Utah,Summit,8,102,14,26,12,22,2,4,9,10,4,9,13,7,1,0,8,9,39
17545,John Underwood,2010,2012,Total,Total,41,221,14,32,14,32,0,0,11,24,20,36,56,1,5,23,18,63,39
17546,Rob Watsabaugh,2010,2012,Wyoming,MWC,40,234,17,28,16,24,1,4,4,11,10,33,43,2,5,2,11,26,39
17547,Fredrick Wilson,2011,2011,Seattle,Ind,19,226,16,53,13,39,3,14,4,7,13,21,34,15,5,0,29,18,39
17548,Luka Zivkovic,2012,2013,Fordham,A-10,28,156,13,46,4,10,9,36,4,6,5,15,20,5,4,1,10,29,39
17549,Wesley Afolayan,2013,2015,Prairie View,SWAC,28,166,16,45,16,42,0,3,6,17,15,25,40,2,3,4,15,33,38
17550,Ron Artest III,2019,2019,Cal State Northridge,Big West,16,199,17,31,17,31,0,0,4,14,15,19,34,3,3,10,16,48,38
17551,Mason Aucoin,2017,2019,Louisiana,Sun Belt,32,113,12,34,5,12,7,22,7,10,4,18,22,3,5,1,8,11,38
17552,Bill Awet,2018,2019,Southern Illinois-Edwardsville,OVC,26,211,14,41,13,30,1,11,9,14,8,34,42,7,7,9,19,37,38
17553,Wanaah Bail,2014,2015,UCLA,Pac-12,24,159,15,36,15,35,0,1,8,17,14,23,37,5,5,4,5,22,38
17554,Olivier-Paul Betu,2013,2014,UC-Davis,Big West,47,376,13,32,11,18,2,14,10,19,7,25,32,30,13,1,30,38,38
17555,Brandon Bolden,2013,2017,Total,Total,28,138,15,25,15,25,0,0,8,17,10,18,28,3,3,11,14,20,38
17556,Jamar Brown,2017,2018,Wagner,NEC,13,82,13,18,13,18,0,0,12,20,11,8,19,0,3,3,11,27,38
17557,Trey Brown,2015,2015,North Carolina A&T,MEAC,11,110,15,36,10,17,5,19,3,6,3,7,10,3,3,1,7,14,38
17558,Jerome Burney,2008,2009,Maryland,ACC,26,193,19,47,19,46,0,1,0,8,17,27,44,6,2,15,4,14,38
17559,Justin Butler,2010,2010,Arkansas State,Sun Belt,19,161,10,27,9,20,1,7,17,25,9,13,22,7,2,4,6,28,38
17560,Milos Cabarkapa,2015,2016,Central Michigan,MAC,30,112,13,22,13,22,0,0,12,19,11,21,32,1,0,3,8,17,38
17561,Chris Carter,2014,2015,Long Island University,NEC,17,89,15,29,13,24,2,5,6,9,8,12,20,0,2,3,7,15,38
17562,Whitley Carter,2014,2015,Savannah State,MEAC,41,203,12,37,5,17,7,20,7,8,4,12,16,14,5,0,12,22,38
17563,Jerel Chavis,2008,2008,Delaware State,MEAC,20,130,15,34,9,17,6,17,2,6,3,5,8,3,3,0,5,11,38
17564,Kevin Crawford,2014,2016,North Carolina Central,MEAC,31,127,14,23,14,21,0,2,10,12,3,7,10,30,11,0,13,16,38
17565,Xavier Crawford,2009,2009,Cal State Northridge,Big West,25,140,15,35,15,35,0,0,8,10,16,19,35,2,5,5,12,27,38
17566,Brandon Dunson,2011,2011,Arizona State,Pac-10,18,150,11,30,6,14,5,16,11,18,4,12,16,9,4,0,12,10,38
17567,Stephen Edoka,2019,2019,North Carolina-Asheville,Big South,27,215,15,41,15,35,0,6,8,12,23,35,58,4,10,6,19,35,38
17568,Grant Evans,2015,2015,Wright State,Horizon,21,241,14,57,5,20,9,37,1,4,4,14,18,15,7,0,15,27,38
17569,Chad Ferguson,2008,2008,Coastal Carolina,Big South,17,130,13,46,5,16,8,30,4,4,3,12,15,5,0,0,8,28,38
17570,Jamel Flash,2012,2015,Towson,CAA,86,399,13,42,13,42,0,0,12,26,28,35,63,2,4,10,15,46,38
17571,Khalif Foster,2009,2010,Robert Morris,NEC,24,135,11,35,6,16,5,19,11,16,5,14,19,5,4,1,15,18,38
17572,Treyvon Francis,2015,2016,Savannah State,MEAC,30,454,14,68,11,34,3,34,7,15,9,25,34,19,29,5,34,36,38
17573,Harley Fuller,2009,2009,Florida International,Sun Belt,23,373,17,48,13,34,4,14,0,4,5,33,38,26,7,2,35,40,38
17574,Matt Grace,2019,2019,Richmond,A-10,31,235,16,34,10,17,6,17,0,3,9,23,32,16,4,6,6,29,38
17575,James Griffin,2015,2016,Marist,MAAC,20,203,12,44,9,17,3,27,11,14,4,20,24,4,5,0,29,24,38
17576,Ryan Harbour,2009,2011,San Diego,WCC,35,202,13,28,8,18,5,10,7,10,7,13,20,10,4,3,14,23,38
17577,Jean Herbert-Harris,2010,2010,Brown,Ivy,14,154,15,37,9,18,6,19,2,4,4,17,21,9,7,1,15,19,38
17578,Jerry Higgins III,2019,2019,Citadel,Southern,22,144,12,29,7,15,5,14,9,12,4,7,11,26,8,0,11,12,38
17579,Mitch Hill,2015,2018,Winthrop,Big South,56,137,13,39,4,6,9,33,3,6,9,22,31,9,5,3,7,4,38
17580,Frederik Jorg,2013,2015,Eastern Washington,Big Sky,31,110,15,24,15,24,0,0,8,15,12,14,26,4,0,7,5,30,38
17581,Spencer Llewellyn,2012,2014,Pacific,Total,34,168,14,38,5,9,9,29,1,1,2,6,8,3,1,1,9,9,38
17582,Justin Lobell,2015,2016,Southeastern Louisiana,Southland,18,162,13,28,1,3,12,25,0,0,3,13,16,4,4,0,5,7,38
17583,Gary Love,2012,2012,Tennessee-Martin,OVC,19,225,13,34,4,10,9,24,3,7,9,16,25,9,5,4,11,19,38
17584,Ramando Lyons,2008,2008,Alcorn State,SWAC,18,206,12,30,12,30,0,0,14,19,12,21,33,3,3,3,13,43,38
17585,Ali Mackay,2012,2015,Davidson,Total,63,194,15,24,13,17,2,7,6,11,9,26,35,9,4,2,5,19,38
17586,Jamar Madge,2019,2019,Milwaukee,Horizon,26,183,12,42,4,19,8,23,6,9,5,8,13,5,1,0,3,17,38
17587,Roberto Mantovani,2017,2017,Robert Morris,NEC,22,286,13,35,13,35,0,0,12,22,22,33,55,9,4,2,17,47,38
17588,Kay Martinez,2008,2009,Jackson State,SWAC,25,144,15,71,11,33,4,38,4,5,10,16,26,3,7,1,13,26,38
17589,Josh Mishler,2017,2017,Cal Poly,Big West,16,183,12,36,5,11,7,25,7,11,5,11,16,9,4,0,6,17,38
17590,Brandon Mitchell,2010,2012,Arkansas,SEC,14,142,17,44,17,38,0,6,4,11,8,17,25,7,2,2,6,25,38
17591,Sunday Okeke,2018,2019,Wake Forest,ACC,43,236,11,34,11,34,0,0,16,28,39,35,74,8,8,6,14,72,38
17592,Malik Ondigo,2018,2019,Texas Tech,Big 12,32,181,15,36,15,31,0,5,8,13,16,17,33,0,1,4,18,26,38
17593,Wayne Parks,2008,2008,Mississippi Valley State,SWAC,16,182,11,44,5,25,6,19,10,14,1,15,16,6,2,0,11,17,38
17594,Ryan Parsons,2011,2014,Eastern Kentucky,OVC,40,101,12,35,1,2,11,33,3,6,1,8,9,2,5,2,2,10,38
17595,Matt Pollard,2014,2015,San Jose State,MWC,33,323,18,42,18,42,0,0,2,11,20,39,59,4,3,18,15,45,38
17596,Nick Powell,2015,2018,North Carolina-Wilmington,CAA,48,199,14,52,7,22,7,30,3,6,11,13,24,5,3,0,9,17,38
17597,Lamont Prosser,2013,2014,Portland State,Big Sky,22,153,14,26,14,26,0,0,10,20,11,28,39,4,3,6,16,26,38
17598,Kavon Rose,2009,2009,Texas Christian,MWC,16,255,13,50,8,27,5,23,7,10,2,27,29,23,8,1,18,24,38
17599,Steven Shpreyregin,2017,2018,Washington State,Pac-12,22,143,13,43,3,6,10,37,2,3,1,8,9,2,1,0,2,14,38
17600,Michael Simpson,2013,2014,Missouri State,MVC,31,203,15,67,7,21,8,46,0,0,4,11,15,9,3,3,2,14,38
17601,Brian Smith,2008,2008,Mississippi,SEC,33,294,12,35,1,2,11,33,3,6,0,22,22,46,12,0,16,13,38
17602,Trey Stacey,2015,2018,Wright State,Horizon,38,89,13,26,3,6,10,20,2,2,3,8,11,3,4,0,6,7,38
17603,Conrad Stephens,2015,2017,Robert Morris,NEC,32,221,16,32,16,31,0,1,6,9,20,19,39,5,7,0,14,25,38
17604,Josiah Talbert,2017,2017,Liberty,Big South,25,125,17,39,16,26,1,13,3,9,4,20,24,1,2,6,10,18,38
17605,J.B. Tanner,2008,2009,North Carolina,ACC,39,74,13,32,3,6,10,26,2,6,3,6,9,1,2,0,2,5,38
17606,Troy Temara,2017,2017,George Mason,A-10,24,200,16,41,16,41,0,0,6,15,11,18,29,4,1,1,13,32,38
17607,Thomas de Thaey,2012,2013,North Carolina State,ACC,22,134,15,44,10,24,5,20,3,4,12,16,28,7,3,1,6,13,38
17608,Ji Xiang,2009,2010,Hawaii,WAC,28,112,9,22,9,20,0,2,20,36,15,20,35,4,1,5,5,21,38
17609,Levi Yancy,2016,2016,Northwestern State,Southland,24,235,14,36,14,34,0,2,10,10,12,27,39,14,6,7,16,31,38
17610,Jefkins Agyeman-Budu,2015,2016,Grambling,SWAC,29,263,13,53,7,38,6,15,5,13,12,14,26,7,11,2,33,32,37
17611,Brandon Bailey,2012,2012,Howard,MEAC,25,223,16,29,16,29,0,0,5,9,12,25,37,4,2,5,20,42,37
17612,Maurice Barksdale,2008,2008,Louisiana,Sun Belt,22,191,8,32,6,16,2,16,19,28,2,12,14,14,11,0,15,20,37
17613,York Benjamin,2018,2018,Texas A&M-Corpus Christi,Southland,15,162,11,25,11,24,0,1,15,17,16,21,37,5,5,2,31,26,37
17614,Noah Bigirumwami,2019,2019,Chicago State,WAC,26,211,8,28,7,21,1,7,20,27,5,18,23,7,6,2,17,48,37
17615,Travis Bunker,2008,2008,Wyoming,MWC,27,226,11,43,4,7,7,36,8,8,2,21,23,13,7,0,16,16,37
17616,Lawrence Cage,2009,2009,Alcorn State,SWAC,13,114,11,23,7,15,4,8,11,13,4,10,14,5,2,0,10,7,37
17617,Kyle Chones,2008,2008,Colgate,Patriot,11,120,15,28,8,15,7,13,0,0,6,12,18,4,5,1,6,9,37
17618,Matt Cortez,2008,2008,Centenary (LA),Summit,20,,11,27,0,0,11,27,4,4,,,12,3,5,0,7,,37
17619,Sam Craft,2016,2016,Memphis,AAC,17,211,14,44,10,29,4,15,5,6,4,16,20,16,6,1,8,23,37
17620,David Czerapowicz,2019,2019,Davidson,A-10,25,209,12,41,2,4,10,37,3,4,1,19,20,6,1,0,3,8,37
17621,Georges Darwiche,2019,2019,Siena,MAAC,19,270,12,45,4,12,8,33,5,6,6,7,13,17,4,0,20,33,37
17622,Charles DeCosta,2010,2011,Howard,MEAC,38,280,13,24,13,24,0,0,11,33,16,28,44,3,6,13,15,43,37
17623,Chris Echols,2009,2009,Georgia State,CAA,5,108,15,34,15,33,0,1,7,13,14,14,28,4,0,6,16,9,37
17624,A.J. Gasporra,2009,2009,Texas-San Antonio,Southland,16,109,12,28,4,10,8,18,5,6,1,4,5,11,3,0,12,11,37
17625,Terrance Grier,2008,2008,Charleston Southern,Big South,21,138,14,43,7,15,7,28,2,4,4,18,22,5,3,2,10,12,37
17626,Bruce Grimm,2010,2010,East Tennessee State,A-Sun,17,178,8,41,3,15,5,26,16,23,3,7,10,20,17,3,17,7,37
17627,Benedikt Haid,2017,2018,North Florida,A-Sun,25,127,12,31,4,4,8,27,5,6,6,14,20,3,1,1,6,6,37
17628,Austin Haldorson,2013,2014,Wyoming,MWC,41,216,14,43,9,26,5,17,4,4,7,21,28,4,6,7,6,25,37
17629,KC Hankton,2019,2019,Saint Louis,A-10,22,123,12,41,5,16,7,25,6,8,9,13,22,3,2,1,2,10,37
17630,Raekwon Harney,2017,2018,North Carolina Central,MEAC,27,277,16,54,12,39,4,15,1,8,3,22,25,62,20,0,26,21,37
17631,Shaquille Harris,2012,2012,Mercer,A-Sun,27,91,14,35,9,19,5,16,4,10,3,8,11,3,9,2,8,17,37
17632,John Hawkins,2014,2015,Miami (OH),MAC,32,165,16,38,16,37,0,1,5,9,9,21,30,3,3,6,11,21,37
17633,Alec Hickman,2018,2018,UC-Riverside,Big West,18,207,15,46,8,15,7,31,0,1,5,15,20,8,6,1,2,9,37
17634,David Hinton,2010,2013,Virginia Commonwealth,Total,75,281,16,38,16,38,0,0,5,16,12,28,40,5,6,9,11,35,37
17635,Stanley Honorat,2010,2011,Charleston Southern,Big South,20,184,14,48,7,23,7,25,2,4,12,17,29,13,9,1,12,10,37
17636,Daron Hood,2008,2011,Tennessee-Martin,OVC,46,201,15,29,15,29,0,0,7,11,11,21,32,7,5,7,9,36,37
17637,Cortney Horton,2008,2008,Loyola (IL),Horizon,22,217,16,50,16,49,0,1,5,7,6,20,26,6,8,1,21,20,37
17638,Chris Johnson,2008,2008,UC-Riverside,Big West,14,119,13,45,7,23,6,22,5,9,1,6,7,5,1,2,9,7,37
17639,Josh Johnson,2011,2012,Army,Patriot,41,229,17,34,17,34,0,0,3,14,21,19,40,4,5,14,18,47,37
17640,Seth Kisler,2013,2014,Arkansas State,Sun Belt,19,123,13,24,9,15,4,9,7,11,8,6,14,2,3,0,7,20,37
17641,DJ Laster,2016,2016,Gardner-Webb,Big South,15,105,15,33,13,23,2,10,5,10,11,6,17,2,3,2,10,23,37
17642,Larry Lewis Jr.,2017,2017,Hawaii,Big West,21,136,11,32,11,24,0,8,15,23,7,12,19,3,6,0,6,12,37
17643,Zaire Mateen,2019,2019,Northern Illinois,MAC,21,152,13,34,6,15,7,19,4,7,1,11,12,11,7,0,7,7,37
17644,Jaan Montgomery,2008,2009,Binghamton,AEC,49,303,16,45,16,45,0,0,5,19,28,41,69,5,4,8,33,80,37
17645,Terrance Moore,2008,2008,Prairie View,SWAC,24,201,13,35,13,35,0,0,11,29,17,24,41,5,6,5,23,37,37
17646,Jamaine Nance,2008,2008,Weber State,Big Sky,19,121,9,23,5,11,4,12,15,18,1,10,11,4,3,1,17,17,37
17647,Greg Nelson,2014,2014,Florida A&M,MEAC,21,128,9,29,2,6,7,23,12,14,5,9,14,2,3,1,8,11,37
17648,Maurice O'Field,2016,2018,Total,Total,37,234,15,35,11,21,4,14,3,8,10,25,35,8,3,2,10,23,37
17649,Jared Ravenscraft,2014,2016,Morehead State,OVC,18,77,13,27,5,6,8,21,3,7,5,7,12,9,7,1,2,7,37
17650,Vittorio Reynoso-Avila,2017,2019,Princeton,Ivy,30,113,14,25,12,22,2,3,7,12,8,11,19,8,3,0,7,7,37
17651,Duane Ricks,2008,2008,Radford,Big South,23,199,12,23,12,23,0,0,13,26,14,30,44,5,1,7,12,20,37
17652,Ryon Riggins,2013,2013,Tennessee Tech,OVC,22,189,18,37,18,36,0,1,1,4,16,9,25,9,4,7,13,22,37
17653,Tanner Sanders,2015,2018,Oregon State,Pac-12,57,387,15,56,8,17,7,39,0,2,9,42,51,19,15,4,19,38,37
17654,Aaron Scott,2014,2014,Appalachian State,Southern,10,99,13,26,8,11,5,15,6,10,2,3,5,4,1,0,3,6,37
17655,K.J. Scott,2019,2019,Mount St. Mary's,NEC,7,146,15,45,10,27,5,18,2,5,0,20,20,11,6,1,15,9,37
17656,Shaquille Seville,2019,2019,Alabama A&M,SWAC,19,117,17,31,17,31,0,0,3,11,9,19,28,0,3,2,7,26,37
17657,Joe Sharkey,2013,2013,Brown,Ivy,27,333,14,45,5,14,9,31,0,0,4,37,41,15,12,1,18,30,37
17658,Randy Spaid,2008,2009,Saint Francis (PA),NEC,24,164,15,27,14,25,1,2,6,11,13,16,29,1,2,4,6,19,37
17659,Trevor Stanback,2017,2019,Stanford,Pac-12,42,229,13,33,13,33,0,0,11,30,22,19,41,9,6,11,16,23,37
17660,Jordan Stasyszyn,2008,2009,Fairleigh Dickinson,NEC,17,225,11,40,2,8,9,32,6,8,3,23,26,8,4,0,12,10,37
17661,Babacar Thiombane,2018,2018,Army,Patriot,30,281,16,27,16,27,0,0,5,15,24,59,83,10,14,19,23,59,37
17662,DeQuavious Wagner,2013,2014,Arkansas,SEC,28,163,11,41,5,18,6,23,9,10,1,7,8,30,10,0,9,20,37
17663,Phillip Ward,2010,2010,Nicholls State,Southland,13,146,18,39,18,39,0,0,1,4,12,13,25,4,1,3,8,22,37
17664,KaJuan Watson,2010,2010,Southeast Missouri State,OVC,15,115,13,27,12,25,1,2,10,12,5,8,13,4,3,2,9,16,37
17665,Cole Welle,2015,2018,University of California,Pac-12,38,125,15,44,15,39,0,5,7,19,21,20,41,0,5,3,1,26,37
17666,Josh Wiegand,2009,2011,Loyola (MD),MAAC,39,246,15,28,14,25,1,3,6,12,23,19,42,5,3,10,8,43,37
17667,Romello Wilbert,2019,2019,Incarnate Word,Southland,17,260,15,48,13,29,2,19,5,15,16,34,50,14,10,4,35,35,37
17668,T.J. Williams,2014,2014,Chattanooga,Southern,24,182,16,28,16,28,0,0,5,10,16,22,38,0,2,14,14,34,37
17669,Nolan Wilson,2015,2017,Prairie View,SWAC,77,528,12,32,12,32,0,0,13,31,26,54,80,11,10,25,18,100,37
17670,Andrew Anderson,2010,2010,Savannah State,Ind,24,235,12,50,9,31,3,19,9,17,7,9,16,10,9,2,14,14,36
17671,Justin Armstrong,2008,2008,Columbia,Ivy,9,121,13,31,11,24,2,7,8,15,9,19,28,10,5,2,11,18,36
17672,Adarius Avery,2018,2018,Loyola (IL),MVC,12,94,13,27,13,26,0,1,10,15,8,15,23,4,1,2,7,7,36
17673,Marcus Bell,2013,2013,Idaho,WAC,14,160,17,39,17,39,0,0,2,8,16,31,47,2,5,7,11,27,36
17674,Stephen Burches,2009,2010,Southeastern Louisiana,Southland,36,236,13,34,12,25,1,9,9,13,6,19,25,23,13,0,28,38,36
17675,Chris Carter,2012,2012,Air Force,MWC,24,232,8,30,8,20,0,10,20,35,4,31,35,17,12,1,19,25,36
17676,Antoine Chandler,2012,2013,Eastern Michigan,MAC,28,128,13,32,8,14,5,18,5,10,4,7,11,11,4,0,11,14,36
17677,Nikola Colovic,2017,2019,Hartford,AEC,22,87,14,17,14,17,0,0,8,15,4,9,13,2,1,1,6,29,36
17678,Christian Crockett,2013,2015,Total,Total,21,165,11,38,11,35,0,3,14,38,8,26,34,3,3,0,8,26,36
17679,Trey Dawkins,2019,2019,Georgia Southern,Sun Belt,16,97,11,26,6,11,5,15,9,12,9,8,17,1,3,8,6,18,36
17680,Leo Edwards,2015,2017,Total,Total,38,180,16,34,16,34,0,0,4,7,18,27,45,1,3,7,11,32,36
17681,Kedrick Flomo,2015,2015,Murray State,OVC,29,312,10,53,1,18,9,35,7,10,3,27,30,30,10,4,22,30,36
17682,Hamid Ford,2009,2009,Texas Southern,SWAC,23,222,13,42,9,32,4,10,6,10,1,15,16,16,9,1,27,16,36
17683,Rokas Gricius,2010,2011,Canisius,MAAC,25,107,10,24,4,10,6,14,10,17,3,11,14,0,2,2,3,12,36
17684,Jordan Hardwick,2018,2019,Coppin State,MEAC,19,171,14,34,13,26,1,8,7,12,16,19,35,1,1,13,14,25,36
17685,Jeremy Harn,2010,2012,North Carolina-Asheville,Big South,36,171,16,34,16,33,0,1,4,12,11,34,45,6,8,5,5,21,36
17686,Uriah Hethington,2008,2008,Middle Tennessee,Sun Belt,15,124,15,37,15,37,0,0,6,13,8,11,19,2,7,1,3,13,36
17687,Evan Horn,2018,2018,New Hampshire,AEC,14,141,11,38,6,21,5,17,9,15,4,27,31,9,5,2,15,27,36
17688,Alex Jackson,2012,2012,Quinnipiac,NEC,24,202,11,42,11,39,0,3,14,29,20,28,48,7,1,4,13,25,36
17689,Jeremiah Jackson,2012,2012,Northern Illinois,MAC,25,124,12,26,12,26,0,0,12,22,10,7,17,2,2,4,8,18,36
17690,Miroslav Jaksic,2015,2015,Grand Canyon,WAC,13,74,15,29,15,27,0,2,6,13,5,11,16,0,0,4,8,14,36
17691,Nathan Josephs,2016,2017,Texas State,Sun Belt,23,79,10,28,2,10,8,18,8,10,0,3,3,9,4,1,5,8,36
17692,KJ Langston,2017,2018,Washington State,Pac-12,28,185,15,54,9,23,6,31,0,2,2,9,11,6,5,0,7,11,36
17693,Kevin Laue,2010,2012,Manhattan,MAAC,60,223,17,30,17,30,0,0,2,9,26,16,42,1,1,15,7,43,36
17694,David Long,2008,2008,Coastal Carolina,Big South,21,210,14,27,8,17,6,10,2,4,18,17,35,19,4,1,14,13,36
17695,Tyler Loose,2016,2018,Northern Colorado,Big Sky,72,585,10,38,9,33,1,5,15,34,7,62,69,56,25,0,28,58,36
17696,Donte Lopez,2010,2010,Lamar,Southland,22,170,12,45,9,21,3,24,9,13,7,18,25,13,7,2,10,17,36
17697,Ladarius Marshall,2019,2019,Southern Mississippi,CUSA,11,82,16,26,16,25,0,1,4,12,5,14,19,2,2,3,4,4,36
17698,Dobrivoje Mavrak,2011,2011,Southern Illinois-Edwardsville,Ind,25,237,15,38,15,37,0,1,6,19,15,56,71,6,2,7,14,35,36
17699,Lat Mayen,2019,2019,Texas Christian,Big 12,17,134,11,26,4,6,7,20,7,9,5,16,21,4,4,4,11,14,36
17700,Michael Mayo,2010,2010,Mississippi Valley State,SWAC,7,92,12,36,3,9,9,27,3,4,1,3,4,2,3,0,3,9,36
17701,Marcus Monk,2009,2009,Arkansas,SEC,8,129,13,28,13,28,0,0,10,12,8,17,25,4,8,4,5,12,36
17702,Thomas Montigel,2011,2014,Texas Christian,Total,51,312,10,37,7,18,3,19,13,16,15,22,37,7,8,0,7,31,36
17703,Dylan Moody,2012,2013,Fairleigh Dickinson,NEC,46,483,13,37,5,12,8,25,2,2,3,20,23,33,19,0,36,50,36
17704,Conor Mullen,2008,2009,Cornell,Ivy,26,75,12,23,5,9,7,14,5,10,4,13,17,13,5,1,7,6,36
17705,Robinson Odoch Opong,2011,2012,Long Island University,NEC,27,105,10,28,5,10,5,18,11,18,8,8,16,2,1,0,11,14,36
17706,Chidi Okoli,2008,2008,Norfolk State,MEAC,21,119,15,25,15,25,0,0,6,15,20,17,37,0,2,3,15,21,36
17707,T.J. Oliver,2016,2016,Tulane,AAC,17,101,16,41,14,32,2,9,2,5,16,18,34,2,0,1,9,16,36
17708,Tyler Ott,2013,2016,Total,Total,17,76,12,35,4,9,8,26,4,7,0,12,12,1,3,0,5,14,36
17709,Andrew Patterson,2008,2008,Niagara,MAAC,29,248,11,51,2,10,9,41,5,11,8,11,19,5,8,3,16,46,36
17710,Everett Ray,2018,2018,Southern Methodist,AAC,16,160,14,22,12,19,2,3,6,20,19,24,43,7,2,1,9,27,36
17711,River Reed,2018,2018,Loyola (MD),Patriot,15,135,14,23,14,21,0,2,8,16,8,15,23,6,2,4,5,24,36
17712,Marc Renelique,2008,2008,Chicago State,Ind,18,83,11,40,5,15,6,25,8,10,1,6,7,2,3,0,9,6,36
17713,P.J. Reyes,2011,2011,South Alabama,Sun Belt,10,81,10,28,5,11,5,17,11,17,5,12,17,6,1,2,7,6,36
17714,Darius Richardson,2009,2009,Northwestern State,Southland,25,213,12,41,11,32,1,9,11,16,8,21,29,20,13,2,23,16,36
17715,Eli Robison,2014,2015,Utah Valley,WAC,33,147,12,40,8,22,4,18,8,11,12,14,26,4,2,1,10,14,36
17716,Van Rolle,2014,2018,Total,Total,30,139,11,46,5,25,6,21,8,18,4,5,9,12,2,1,14,10,36
17717,Josh Rosario,2018,2019,Maryland-Baltimore County,AEC,34,158,10,43,5,19,5,24,11,15,3,16,19,17,8,1,18,22,36
17718,Brady Schuck,2017,2019,Furman,Southern,33,91,10,24,8,14,2,10,14,18,2,12,14,1,1,0,4,5,36
17719,George Sharp,2008,2008,Northern Arizona,Big Sky,29,192,15,29,15,29,0,0,6,8,7,18,25,15,8,1,10,26,36
17720,Dan Stonkus,2010,2010,NJIT,GWC,20,376,12,26,12,26,0,0,12,25,24,42,66,5,11,19,15,45,36
17721,Anthony Stover,2011,2012,UCLA,Total,60,490,13,38,13,38,0,0,10,32,38,53,91,3,5,67,21,74,36
17722,Hunter Summy,2016,2018,San Diego,WCC,24,149,13,44,4,8,9,36,1,3,2,1,3,8,4,0,6,13,36
17723,Kendrick Thompson,2017,2017,Longwood,Big South,8,192,13,42,3,10,10,32,0,2,3,14,17,27,10,2,11,22,36
17724,Warren Washington,2019,2019,Oregon State,Pac-12,26,211,15,28,15,27,0,1,6,12,15,22,37,6,0,8,7,54,36
17725,Joe Williams,2013,2013,Charleston Southern,Big South,13,77,16,24,16,23,0,1,4,6,8,9,17,0,2,7,3,4,36
17726,Paxton Wilson,2018,2018,Rider,MAAC,23,121,10,24,2,3,8,21,8,10,3,9,12,5,3,0,4,11,36
17727,Matt Zitani,2008,2008,Florida State,ACC,26,193,14,30,7,12,7,18,1,2,13,16,29,7,5,2,7,35,36
17728,Bul Ajang,2018,2019,Tulane,AAC,34,309,11,41,10,39,1,2,12,22,24,35,59,11,3,3,19,48,35
17729,Malik Amos,2016,2017,Prairie View,SWAC,18,86,11,44,2,10,9,34,4,5,0,1,1,1,2,0,4,5,35
17730,Corrie Austin,2008,2009,Grambling,SWAC,27,258,16,27,16,27,0,0,3,12,18,25,43,5,3,10,14,23,35
17731,Vaughn Autry,2011,2011,Montana,Big Sky,23,158,10,40,2,11,8,29,7,9,4,13,17,11,6,0,7,9,35
17732,Jack Bentz,2012,2015,Wyoming,MWC,71,414,12,44,12,37,0,7,11,23,4,39,43,50,11,0,16,19,35
17733,Sam Berlin,2018,2019,High Point,Big South,38,184,15,36,15,36,0,0,5,16,25,34,59,5,2,8,10,24,35
17734,D'Andre Bernard,2019,2019,East Tennessee State,Southern,19,144,15,32,11,18,4,14,1,3,10,32,42,7,7,1,7,22,35
17735,Richard Bivens,2017,2017,Florida International,CUSA,13,142,14,25,9,17,5,8,2,3,8,20,28,0,1,2,8,16,35
17736,Quinn Blair,2019,2019,William & Mary,CAA,19,154,12,33,6,13,6,20,5,7,7,20,27,10,2,5,8,15,35
17737,Brett Bowling,2015,2016,Marshall,CUSA,24,90,11,37,6,9,5,28,8,10,2,3,5,1,1,0,4,10,35
17738,Marcel Burton,2019,2019,Southern,SWAC,16,107,12,31,5,11,7,20,4,4,5,4,9,8,2,0,9,14,35
17739,Kyle Carrabine,2008,2008,William & Mary,CAA,26,199,12,41,5,14,7,27,4,7,6,17,23,7,4,0,8,14,35
17740,Ben Coupet,2017,2019,Nevada-Las Vegas,MWC,26,154,11,32,11,17,0,15,13,17,11,27,38,11,2,3,10,19,35
17741,Kindon Crowder,2014,2014,Ball State,MAC,17,141,13,36,5,6,8,30,1,4,0,10,10,11,5,1,8,17,35
17742,Ivan Dorsey,2013,2013,Eastern Washington,Big Sky,17,125,14,58,11,43,3,15,4,7,1,7,8,2,2,2,13,11,35
17743,Darrion Eastmon,2014,2014,South Carolina State,MEAC,25,257,10,22,7,14,3,8,12,20,5,26,31,35,10,2,32,35,35
17744,Daquon Ervin,2016,2017,Maryland-Baltimore County,AEC,23,252,9,45,8,31,1,14,16,28,6,19,25,23,8,0,14,23,35
17745,Simon Falokun,2019,2019,Tulsa,AAC,21,124,10,23,10,23,0,0,15,28,11,20,31,2,2,7,15,24,35
17746,Bik Gill,2015,2016,Ball State,MAC,20,144,8,27,4,12,4,15,15,19,8,24,32,4,4,4,16,12,35
17747,Sean Good,2019,2019,Lafayette,Patriot,30,247,16,23,16,23,0,0,3,10,11,37,48,5,8,26,13,45,35
17748,Josh Humphrey,2012,2015,Green Bay,Horizon,55,434,11,50,11,47,0,3,13,29,26,41,67,20,9,8,23,54,35
17749,Berrick JeanLouis,2019,2019,New Mexico State,WAC,15,92,14,34,11,15,3,19,4,8,5,8,13,5,1,1,5,8,35
17750,Courtney Julien,2016,2017,Texas State,Sun Belt,33,131,10,37,4,17,6,20,9,12,3,13,16,7,4,3,5,10,35
17751,Nikola Kecman,2009,2010,Ohio State,Big Ten,16,81,15,30,13,15,2,15,3,5,4,17,21,2,1,2,2,17,35
17752,Kevin Kerley,2016,2019,Appalachian State,Sun Belt,22,68,10,17,2,4,8,13,7,12,0,2,2,12,3,0,5,4,35
17753,Ben Kinker,2019,2019,Army,Patriot,15,90,14,30,8,11,6,19,1,6,3,12,15,1,1,1,4,12,35
17754,Zach Korkowski,2013,2016,Wofford,Southern,36,96,11,16,11,13,0,3,13,13,7,15,22,7,3,0,9,17,35
17755,Louis Larizza,2010,2012,Fairleigh Dickinson,NEC,24,164,11,41,4,16,7,25,6,10,2,8,10,8,4,0,9,11,35
17756,Ryan Martin,2009,2009,Maine,AEC,10,54,13,26,4,6,9,20,0,0,1,3,4,7,3,0,3,2,35
17757,Jason McMillan,2017,2019,Western Carolina,Southern,44,200,12,47,1,4,11,43,0,3,3,11,14,7,6,0,10,12,35
17758,Brandon Mims,2008,2008,Louisiana Tech,WAC,23,284,15,53,15,51,0,2,5,9,16,27,43,5,5,16,20,41,35
17759,Kenzo Nudo,2017,2017,Grand Canyon,WAC,9,117,13,50,8,23,5,27,4,8,1,11,12,3,2,0,10,7,35
17760,Brian Okam,2010,2013,Total,Total,41,246,11,30,11,30,0,0,13,27,23,39,62,3,4,22,15,57,35
17761,Nick Parker,2016,2018,Campbell,Big South,20,72,13,28,6,11,7,17,2,2,4,14,18,10,2,1,4,9,35
17762,Antanee Pinkard,2018,2019,James Madison,CAA,28,217,14,44,12,31,2,13,5,16,14,20,34,4,7,2,18,26,35
17763,Wendell Preadom,2008,2008,Wichita State,MVC,28,349,13,46,10,30,3,16,6,18,10,27,37,22,10,2,19,24,35
17764,Brandon Ray,2008,2008,IUPUI,Summit,14,84,15,23,14,20,1,3,4,8,11,9,20,2,7,1,2,7,35
17765,Mike Robbins,2015,2017,Temple,AAC,31,136,11,21,6,9,5,12,8,14,4,12,16,11,4,3,5,20,35
17766,Ignas Sargiunas,2019,2019,Georgia,SEC,20,115,12,30,7,13,5,17,6,7,3,7,10,9,3,0,10,8,35
17767,Nate Schwarze,2009,2012,Rice,CUSA,97,554,11,36,1,7,10,29,3,11,10,38,48,46,29,0,28,59,35
17768,Therren Shelton-Szmidt,2018,2018,Middle Tennessee,CUSA,26,133,13,39,4,13,9,26,0,1,6,14,20,9,6,0,10,11,35
17769,Kashif Sweet,2008,2008,Columbia,Ivy,25,239,14,35,12,26,2,9,5,14,3,14,17,24,11,0,26,24,35
17770,Ike Udanoh,2008,2009,Long Island University,NEC,25,202,17,43,17,43,0,0,1,6,28,20,48,2,8,11,14,29,35
17771,Ted Wang,2011,2013,Texas A&M-Corpus Christi,Southland,34,246,13,37,13,36,0,1,9,19,11,22,33,2,0,13,12,30,35
17772,Harry Whitt,2012,2012,Southern Illinois,MVC,23,155,11,46,8,36,3,10,10,14,9,15,24,1,3,6,8,26,35
17773,A.J. Wilson,2010,2010,Murray State,OVC,21,89,15,20,14,19,1,1,4,8,9,19,28,1,0,9,8,8,35
17774,Joel Wincowski,2016,2017,Maryland-Baltimore County,AEC,30,300,13,45,6,17,7,28,2,2,16,17,33,9,8,3,6,21,35
17775,Zach Young,2015,2018,Nicholls State,Southland,67,362,4,42,3,21,1,21,26,38,5,18,23,36,8,1,30,30,35
17776,Menghe a'Nyam,2008,2008,Canisius,MAAC,13,163,11,28,11,28,0,0,12,18,18,29,47,1,6,1,16,28,34
17777,Trevan Abraham,2011,2011,Rice,CUSA,30,282,11,46,8,24,3,22,9,10,3,17,20,36,7,0,16,39,34
17778,Dru Anthrop,2010,2013,Purdue,Big Ten,50,260,13,26,10,15,3,11,5,8,11,30,41,24,18,1,16,20,34
17779,Phillip Bach,2009,2012,Santa Clara,WCC,31,115,13,37,9,15,4,22,4,11,7,13,20,10,5,0,11,8,34
17780,Drew Baker,2010,2012,Chattanooga,Southern,17,129,13,22,13,22,0,0,8,25,13,19,32,3,6,5,13,20,34
17781,Nate Basalyga,2012,2013,Maryland-Baltimore County,AEC,24,201,16,30,16,30,0,0,2,5,19,18,37,9,3,3,9,42,34
17782,Pierre Beasley,2008,2008,Rice,CUSA,21,,10,47,7,30,3,17,11,25,14,47,61,21,24,7,17,31,34
17783,Kenny Belton,2008,2008,Cincinnati,Big East,21,140,13,32,13,32,0,0,8,22,12,10,22,2,2,0,12,28,34
17784,Pat Branin,2012,2015,College of Charleston,Total,54,155,11,31,4,9,7,22,5,11,2,12,14,5,1,0,6,21,34
17785,Harris Brown,2016,2016,Evansville,MVC,24,187,8,35,3,17,5,18,13,19,2,8,10,17,3,0,12,27,34
17786,Rocky Brown,2011,2012,Eastern Washington,Big Sky,22,186,12,38,9,27,3,11,7,15,16,28,44,6,8,7,12,16,34
17787,Matei Daian,2009,2010,Stanford,Pac-10,32,234,14,29,14,28,0,1,6,13,20,13,33,2,1,2,9,32,34
17788,Rodrigo DaSilva,2008,2009,Texas Southern,SWAC,22,186,13,35,11,31,2,4,6,18,9,22,31,3,7,0,13,31,34
17789,Ismaila Dauda,2014,2016,Total,Total,38,178,11,27,11,27,0,0,12,17,7,31,38,1,1,5,15,27,34
17790,Chris Deanes,2013,2013,Jacksonville State,OVC,20,164,12,22,12,21,0,1,10,19,4,9,13,9,3,0,12,19,34
17791,Ramiir Dixon-Conover,2019,2019,Saint Francis (PA),NEC,27,206,13,44,11,35,2,9,6,7,4,14,18,27,17,2,22,18,34
17792,Ryan Ebner,2009,2009,Bucknell,Patriot,21,181,15,29,15,29,0,0,4,6,12,24,36,2,3,5,7,21,34
17793,Royal Edwards,2009,2010,Pacific,Big West,11,75,12,34,2,7,10,27,0,0,0,13,13,2,0,0,4,7,34
17794,Thaddeus Fauntleroy,2014,2014,Mississippi Valley State,SWAC,21,163,10,44,9,27,1,17,13,18,4,18,22,24,11,0,20,21,34
17795,Hunter Ford,2014,2015,UC-Santa Barbara,Big West,19,77,12,21,3,3,9,18,1,2,7,5,12,7,1,1,2,4,34
17796,Richard Freudenberg,2017,2017,St. John's (NY),Big East,26,242,12,48,5,13,7,35,3,4,6,28,34,12,1,2,17,30,34
17797,Chance Garvin,2017,2019,Idaho,Big Sky,26,242,12,37,7,14,5,23,5,9,0,23,23,22,7,0,14,25,34
17798,Kendall Groom,2011,2014,Sacramento State,Big Sky,60,276,14,50,13,44,1,6,5,13,9,16,25,27,29,1,19,17,34
17799,David Hall,2019,2019,New Hampshire,AEC,22,203,10,27,6,13,4,14,10,23,10,23,33,6,9,1,19,20,34
17800,Simon Harris,2008,2009,North Carolina State,ACC,35,309,14,28,13,22,1,6,5,8,17,37,54,9,5,5,12,37,34
17801,Isaac Hippolyte,2019,2019,Coastal Carolina,Sun Belt,32,209,10,44,9,33,1,11,13,13,16,37,53,4,3,0,20,24,34
17802,Hayden Hunter,2015,2015,Weber State,Big Sky,28,387,5,28,1,16,4,12,20,28,6,30,36,59,7,0,35,39,34
17803,Edwin Jarrow,2008,2008,Jackson State,SWAC,34,505,11,44,9,32,2,12,10,17,24,36,60,19,14,2,21,43,34
17804,Jonathan Jean,2016,2016,Furman,Southern,21,150,13,37,11,26,2,11,6,6,0,13,13,18,3,0,18,13,34
17805,Tajai Johnson,2013,2013,UC-Riverside,Big West,20,129,13,32,12,23,1,9,7,8,2,7,9,9,5,3,13,12,34
17806,Martin Jones,2016,2017,North Carolina A&T,MEAC,29,153,12,50,6,12,6,38,4,7,7,9,16,5,3,0,3,23,34
17807,Ryan Keenan,2016,2017,Pepperdine,WCC,34,226,15,25,15,25,0,0,4,12,12,13,25,3,1,2,12,30,34
17808,Tra'Quan Knight,2019,2019,Detroit Mercy,Horizon,9,137,11,29,11,24,0,5,12,28,8,16,24,8,8,1,6,11,34
17809,Jamin Lackey,2016,2016,North Carolina A&T,MEAC,18,169,17,31,17,31,0,0,0,4,11,29,40,7,0,4,14,29,34
17810,Emmanuel Lambright,2018,2019,North Florida,A-Sun,25,235,12,36,7,13,5,23,5,9,6,37,43,10,6,15,16,19,34
17811,Jacques Leeds,2009,2009,Jacksonville State,OVC,16,124,11,28,11,28,0,0,12,26,7,18,25,1,3,1,7,19,34
17812,Pat Lepper,2008,2008,Purdue-Fort Wayne,Summit,21,123,12,31,6,9,6,22,4,4,2,17,19,4,5,0,7,12,34
17813,Chris Lewis,2013,2014,Delaware State,MEAC,18,111,11,24,7,14,4,10,8,13,1,8,9,16,6,0,9,7,34
17814,Myles Mann,2014,2016,Fairleigh Dickinson,NEC,46,211,15,38,15,38,0,0,4,13,22,31,53,2,3,9,11,45,34
17815,Marquis Marshall,2014,2014,Towson,CAA,25,105,11,31,5,7,6,24,6,9,1,7,8,2,3,0,3,7,34
17816,Marcus Mathieu,2014,2015,McNeese State,Southland,29,196,11,40,7,22,4,18,8,14,2,7,9,16,3,0,18,26,34
17817,Brandon Maxwell,2017,2017,Northern Kentucky,Horizon,24,201,12,41,5,13,7,28,3,8,2,20,22,10,5,2,26,26,34
17818,Anaclet Mulumba Mbayi,2010,2010,Fairleigh Dickinson,NEC,20,308,11,29,10,24,1,5,11,18,15,42,57,7,9,1,15,21,34
17819,Jacquan McClinton,2011,2011,Central Arkansas,Southland,27,186,10,22,10,21,0,1,14,27,16,24,40,14,10,5,11,41,34
17820,Aubrey McRae,2016,2017,Georgia Southern,Sun Belt,22,74,13,42,7,15,6,27,2,5,4,4,8,3,11,0,3,15,34
17821,Daniel Melifonwu,2016,2016,Southern Utah,Big Sky,29,270,14,31,14,31,0,0,6,15,14,31,45,1,2,18,19,60,34
17822,DeShawn Mitchell,2009,2009,Nevada-Las Vegas,MWC,21,113,14,28,14,28,0,0,6,13,9,8,17,5,1,7,8,8,34
17823,Vaughn Morgan,2013,2013,Robert Morris,NEC,15,216,15,39,15,39,0,0,4,15,23,11,34,3,8,21,17,35,34
17824,Duane Moss,2018,2019,Chattanooga,Southern,9,142,11,24,3,9,8,15,4,7,4,16,20,9,3,1,7,20,34
17825,Mikko Niemi,2008,2009,Youngstown State,Horizon,49,512,9,40,1,10,8,30,8,17,10,42,52,57,13,0,45,43,34
17826,Brandon Oliver,2010,2013,Delaware State,MEAC,69,409,14,34,14,33,0,1,6,18,5,26,31,37,22,4,40,45,34
17827,Tide Osifeso,2016,2017,UC-Santa Barbara,Big West,22,136,11,43,3,11,8,32,4,9,2,13,15,11,2,0,7,9,34
17828,Hannes Polla,2018,2019,Oklahoma,Big 12,32,104,14,27,14,27,0,0,6,8,15,13,28,1,0,6,12,21,34
17829,Azariah Seay,2019,2019,Alabama State,SWAC,19,127,12,42,6,17,6,25,4,7,8,9,17,8,6,1,7,21,34
17830,Chris Simms,2008,2008,Alcorn State,SWAC,8,84,9,31,4,14,5,17,11,11,7,7,14,5,4,0,8,9,34
17831,Lucas Smith,2018,2018,Akron,MAC,25,284,10,40,6,17,4,23,10,15,19,42,61,8,4,1,10,50,34
17832,Tunji Soroye,2008,2009,Virginia,ACC,20,197,13,23,13,23,0,0,8,14,20,22,42,1,5,18,13,32,34
17833,Henry Taylor,2018,2018,Mississippi Valley State,SWAC,31,145,11,34,6,12,5,22,7,11,2,17,19,10,6,0,13,24,34
17834,Anthony Wells,2010,2011,Cleveland State,Horizon,33,289,15,31,14,28,1,3,3,6,5,22,27,16,6,1,13,27,34
17835,Rashun Williams,2019,2019,South Florida,AAC,15,126,13,34,9,18,4,16,4,4,4,15,19,10,1,3,4,6,34
17836,Brandon Wilson,2011,2011,Grambling,SWAC,3,74,12,29,11,23,1,6,9,21,6,9,15,2,2,0,11,7,34
17837,Logan Windeler,2019,2019,North Alabama,A-Sun,28,176,15,49,15,36,0,13,4,13,12,26,38,5,4,9,16,16,34
17838,Mo Ahmed,2018,2018,Missouri-Kansas City,WAC,18,135,13,28,13,28,0,0,7,14,8,19,27,0,4,6,8,20,33
17839,Yuat Alok,2019,2019,Texas Christian,Big 12,10,131,13,30,13,30,0,0,7,9,4,21,25,2,0,3,14,29,33
17840,Mason Alwan,2013,2014,Bradley,MVC,34,163,12,24,8,15,4,9,5,7,4,11,15,5,6,0,9,6,33
17841,Marquis Barnett,2012,2014,Quinnipiac,Total,32,189,14,27,14,27,0,0,5,9,21,8,29,4,2,7,8,33,33
17842,Amir Bell,2010,2010,Delaware State,MEAC,21,150,12,40,12,38,0,2,9,11,8,10,18,3,3,1,17,8,33
17843,Andreas Bigum,2015,2015,Texas-Rio Grande Valley,WAC,29,329,12,40,12,39,0,1,9,22,13,23,36,17,3,6,24,57,33
17844,Jal Bijiek,2019,2019,North Dakota,Summit,17,91,12,27,6,14,6,13,3,4,8,13,21,2,1,6,10,14,33
17845,Henry Bolton,2015,2016,Utah State,MWC,38,326,12,29,11,23,1,6,8,13,4,24,28,32,10,4,23,19,33
17846,Charles Bronson,2008,2008,Xavier,A-10,16,69,12,21,12,21,0,0,9,12,7,10,17,2,1,3,6,11,33
17847,Melvin Brooks,2016,2016,Charleston Southern,Big South,18,168,13,29,13,29,0,0,7,10,13,27,40,1,1,5,3,40,33
17848,Tyler Bullock,2008,2008,Denver,Sun Belt,6,191,9,35,3,12,6,23,9,12,1,10,11,17,4,7,14,13,33
17849,Ian Burke,2019,2019,Seattle,WAC,21,177,9,25,1,5,8,20,7,12,4,21,25,10,4,0,9,16,33
17850,Joey Cantafio,2008,2009,Virginia Military Institute,Big South,21,95,9,22,4,11,5,11,10,14,1,11,12,16,4,0,14,11,33
17851,Nick Carlos,2014,2014,Central Michigan,MAC,24,108,13,42,6,14,7,28,0,0,5,4,9,3,3,0,6,11,33
17852,Robby Carmody,2019,2019,Notre Dame,ACC,9,90,11,34,10,23,1,11,10,13,9,6,15,2,4,1,11,11,33
17853,Miguel Cartagena,2014,2014,George Washington,A-10,32,206,11,49,7,25,4,24,7,13,0,12,12,32,4,0,23,27,33
17854,Mike Clifford,2010,2011,Buffalo,MAC,25,71,14,24,14,24,0,0,5,9,10,16,26,2,0,2,5,12,33
17855,Jarrell Crayton,2012,2012,Boise State,MWC,22,128,12,21,12,20,0,1,9,18,14,18,32,2,5,4,8,24,33
17856,Jesse Deloach,2016,2017,Western Carolina,Southern,42,283,12,38,12,37,0,1,9,29,15,51,66,6,8,21,15,39,33
17857,Alou Dillon,2019,2019,South Dakota State,Summit,18,125,14,29,14,27,0,2,5,7,9,15,24,4,2,3,5,14,33
17858,Roland Dunston,2010,2010,Maryland-Eastern Shore,MEAC,13,82,13,26,7,13,6,13,1,2,2,3,5,3,2,1,7,3,33
17859,Zeljko Egeric,2008,2008,Purdue-Fort Wayne,Summit,17,202,12,39,7,16,5,23,4,6,7,31,38,12,1,6,17,29,33
17860,Tyler Egli,2013,2013,Omaha,Summit,23,130,9,34,2,7,7,27,8,10,2,9,11,4,2,0,3,9,33
17861,David Favorite,2016,2018,Colgate,Patriot,20,126,11,34,0,0,11,34,0,2,1,5,6,2,3,0,1,9,33
17862,Zach Ferrell,2008,2009,Chattanooga,Southern,43,248,11,28,4,8,7,20,4,6,0,18,18,19,5,1,22,27,33
17863,Andrew Francis,2008,2008,Texas-San Antonio,Southland,17,222,9,31,6,20,3,11,12,24,17,23,40,9,13,3,15,29,33
17864,Carlyle Francis,2012,2012,Binghamton,AEC,10,143,10,30,9,18,1,12,12,16,5,13,18,8,8,3,21,13,33
17865,Alex Giergen,2012,2012,Towson,CAA,27,283,11,36,3,7,8,29,3,6,8,22,30,2,3,0,14,29,33
17866,Zack Gordon,2010,2011,Pennsylvania,Ivy,28,154,11,34,8,20,3,14,8,13,10,20,30,5,4,2,10,19,33
17867,Juwan Grant,2018,2018,Savannah State,MEAC,15,68,13,26,10,16,3,10,4,6,5,10,15,1,0,1,3,6,33
17868,Kyle Groothuis,2010,2011,North Florida,A-Sun,35,240,13,27,13,27,0,0,7,27,12,21,33,4,9,3,10,37,33
17869,Tanner Hamilton,2017,2017,Northwestern State,Southland,29,174,13,29,8,17,5,12,2,7,8,11,19,11,2,0,13,18,33
17870,Jevon Harden,2011,2012,Central Michigan,MAC,46,264,14,31,14,31,0,0,5,12,22,34,56,1,7,15,14,67,33
17871,Dadrian Harris,2013,2014,Northwestern State,Southland,35,172,12,48,7,24,5,24,4,7,8,12,20,9,5,0,17,26,33
17872,Ryan Hiepler,2016,2017,Liberty,Big South,40,323,10,23,3,5,7,18,6,7,4,16,20,18,4,0,10,34,33
17873,Lance Holloway,2008,2008,San Jose State,WAC,32,315,12,30,12,30,0,0,9,14,31,30,61,6,3,19,10,32,33
17874,Nick Hough,2018,2019,Appalachian State,Sun Belt,15,60,10,21,4,5,6,16,7,10,5,7,12,4,3,0,5,6,33
17875,Devin Jackson,2018,2018,Sam Houston State,Southland,19,110,11,48,0,0,11,48,0,0,2,8,10,4,1,0,2,9,33
17876,Joey Lane,2016,2019,Ohio State,Big Ten,36,89,10,31,2,7,8,24,5,8,0,12,12,8,4,0,7,9,33
17877,Arvydas Lidzius,2008,2008,Saint Joseph's,A-10,24,193,13,27,10,20,3,7,4,9,9,11,20,1,0,1,6,23,33
17878,James Long,2013,2017,Total,Total,30,113,11,30,3,7,8,23,3,5,2,3,5,3,8,0,3,10,33
17879,Jesse Lopez Low,2008,2008,UC-Davis,Big West,14,138,9,23,9,21,0,2,15,26,5,12,17,9,4,5,13,18,33
17880,Brandon Macklin,2008,2008,Charleston Southern,Big South,9,138,15,34,15,34,0,0,3,4,8,17,25,4,3,1,7,17,33
17881,Eugene Marshall III,2017,2019,Hampton,Total,26,100,11,32,6,10,5,22,6,8,5,8,13,5,3,0,4,9,33
17882,Aram Martin,2014,2018,Total,Total,26,186,13,46,12,30,1,16,6,8,5,27,32,7,3,19,15,33,33
17883,Tommy Matthews,2013,2016,Eastern Kentucky,OVC,70,238,9,37,5,20,4,17,11,20,8,33,41,15,19,2,13,62,33
17884,Jake McDowell,2014,2017,Memphis,AAC,59,271,14,36,13,32,1,4,4,10,14,20,34,7,11,1,8,39,33
17885,Rob Murphy,2009,2013,Total,Total,18,54,9,12,9,12,0,0,15,17,4,7,11,1,2,1,9,14,33
17886,Dwayne Pow,2017,2017,Niagara,MAAC,10,145,11,29,10,23,1,6,10,14,1,14,15,15,8,0,18,18,33
17887,Dondre Rhoden,2016,2018,Fairleigh Dickinson,NEC,60,210,13,25,13,25,0,0,7,19,10,23,33,2,6,9,9,40,33
17888,T.J. Riley,2009,2009,Lamar,Southland,14,98,12,28,9,19,3,9,6,9,12,4,16,4,4,0,8,20,33
17889,Derek Sabin,2019,2019,Belmont,OVC,18,82,12,17,12,15,0,2,9,15,5,13,18,5,0,1,9,10,33
17890,Jake Scoggins,2018,2019,Arkansas State,Sun Belt,33,218,15,31,15,31,0,0,3,12,9,24,33,7,6,1,11,44,33
17891,Darrius Sellers,2008,2011,North Carolina-Greensboro,Southern,51,275,12,29,12,27,0,2,9,24,8,24,32,1,9,5,27,49,33
17892,Pat Smith,2015,2016,Cornell,Ivy,13,112,11,33,6,13,5,20,6,8,2,5,7,6,1,1,1,10,33
17893,Quadree Smith,2016,2016,Providence,Big East,19,96,10,19,10,19,0,0,13,17,7,13,20,1,3,1,5,21,33
17894,Bruno Solomun,2017,2017,Miami (OH),MAC,13,129,13,35,10,17,3,18,4,8,5,17,22,2,1,2,4,16,33
17895,T.J. Thomas,2015,2015,Southeast Missouri State,OVC,15,120,9,19,9,19,0,0,15,20,12,12,24,4,2,4,7,17,33
17896,T.J. Traylor,2015,2017,Total,Total,22,209,13,37,11,29,2,8,5,13,11,24,35,6,4,9,6,36,33
17897,Brauhnye' Turner,2013,2014,Grambling,SWAC,29,195,14,52,14,50,0,2,5,16,21,20,41,5,0,2,9,10,33
17898,Skyler White,2014,2016,Total,Total,25,71,12,33,7,16,5,17,4,7,6,21,27,7,2,2,2,9,33
17899,Antroine Williford,2010,2010,Bethune-Cookman,MEAC,28,262,13,36,13,36,0,0,7,18,17,24,41,5,10,15,5,40,33
17900,Trevante Anderson,2019,2019,San Francisco,WCC,15,90,12,27,5,11,7,16,1,4,3,2,5,11,1,0,7,15,32
17901,John Anglin,2008,2008,Northwestern State,Southland,17,69,11,20,3,6,8,14,2,3,0,2,2,3,0,0,6,4,32
17902,Casey Arent,2012,2013,Oklahoma,Big 12,30,178,13,32,13,32,0,0,6,6,22,27,49,1,6,3,15,33,32
17903,Will Bond,2011,2011,NJIT,GWC,15,131,11,24,5,11,6,13,4,4,2,9,11,7,5,1,12,17,32
17904,Greg Bowman,2015,2018,Washington,Pac-12,31,64,15,23,15,21,0,2,2,7,12,12,24,2,1,0,1,3,32
17905,Kyle Brown,2015,2018,Cornell,Ivy,53,142,11,40,4,8,7,32,3,7,5,13,18,4,8,3,13,17,32
17906,Tony Bryer,2012,2013,Southern Illinois,MVC,21,161,15,29,15,28,0,1,2,2,7,16,23,2,1,4,7,31,32
17907,Byron Byrd,2009,2010,Southern Utah,Summit,20,75,13,40,10,28,3,12,3,4,8,11,19,3,3,0,4,7,32
17908,Barry Cheaney,2012,2016,Nevada-Las Vegas,MWC,36,95,11,27,8,15,3,12,7,10,2,4,6,3,3,0,3,11,32
17909,TJ Clifford,2018,2019,Western Michigan,MAC,30,121,14,27,12,22,2,5,2,6,11,11,22,2,2,2,12,13,32
17910,Alex Comanita,2019,2019,Northwestern State,Southland,19,122,10,28,4,7,6,21,6,14,0,13,13,3,3,0,14,15,32
17911,KeShawn Curry,2019,2019,Virginia Commonwealth,A-10,15,84,15,27,14,19,1,8,1,2,4,7,11,2,2,1,9,11,32
17912,Tyler Cutter,2009,2009,Indiana State,MVC,17,256,7,30,4,15,3,15,15,22,3,12,15,32,10,2,31,34,32
17913,E.B. Davis,2008,2010,Total,Southland,26,128,13,40,9,25,4,15,2,6,4,8,12,5,3,2,6,13,32
17914,Kiir Deng,2018,2018,Louisiana-Monroe,Sun Belt,17,188,14,27,14,27,0,0,4,9,22,15,37,4,5,6,5,18,32
17915,Chad Dewitt,2009,2010,Winthrop,Big South,20,102,12,39,6,18,6,21,2,2,2,12,14,7,4,0,8,12,32
17916,Curtis Eatmon,2010,2010,Detroit Mercy,Horizon,20,138,10,25,10,17,0,8,12,23,5,14,19,11,3,1,15,22,32
17917,Michael Fletcher,2009,2010,Oral Roberts,Summit,21,131,11,46,1,6,10,40,0,0,2,13,15,2,2,0,9,15,32
17918,Alyx Foster,2013,2014,Portland State,Big Sky,41,318,10,23,6,14,4,9,8,14,1,35,36,11,6,1,9,56,32
17919,Damon Franklin,2008,2008,Texas-Rio Grande Valley,Ind,13,63,14,23,13,20,1,3,3,6,3,14,17,2,1,0,8,5,32
17920,Myles Franklin,2017,2017,Idaho,Big Sky,20,181,8,24,7,14,1,10,15,21,0,18,18,24,4,0,12,8,32
17921,Alex Godette,2011,2011,Army,Patriot,13,103,10,27,6,16,4,11,8,15,0,9,9,9,2,0,4,7,32
17922,Darion Goins,2008,2010,Total,Total,32,169,14,46,12,27,2,19,2,6,3,8,11,5,3,0,17,9,32
17923,Sean Goodwin,2015,2015,Sam Houston State,Southland,17,87,10,15,10,15,0,0,12,18,11,12,23,9,3,0,3,12,32
17924,Marcus Graham,2011,2014,Total,Total,25,76,11,30,9,22,2,8,8,12,8,6,14,5,5,0,2,6,32
17925,Jordan Grant,2017,2019,Central Arkansas,Southland,44,188,11,18,1,1,10,17,0,0,3,12,15,13,11,0,6,10,32
17926,Zac Grossenbacher,2014,2014,Wofford,Southern,17,94,11,28,3,7,8,21,2,4,3,9,12,2,1,2,4,12,32
17927,Jakob Hartsock,2016,2016,Brigham Young,WCC,24,145,11,42,1,6,10,36,0,0,4,25,29,4,2,3,5,18,32
17928,Jamaal Hester,2013,2013,Alcorn State,SWAC,29,179,13,27,13,27,0,0,6,13,14,28,42,4,1,7,10,21,32
17929,Alex Hill,2009,2009,Cornell,Ivy,12,46,11,23,2,3,9,20,1,2,0,3,3,1,1,0,0,4,32
17930,Jeremy Joyner,2019,2019,Tennessee-Martin,OVC,9,83,12,16,12,16,0,0,8,27,9,9,18,0,3,3,7,12,32
17931,Losini Kamara,2019,2019,Idaho,Big Sky,25,362,8,33,3,19,5,14,11,12,9,39,48,28,6,0,15,25,32
17932,Marty Leahy,2017,2017,Western Kentucky,CUSA,17,168,8,22,2,10,6,12,10,11,4,12,16,5,4,0,6,15,32
17933,Kevin McCarthy,2011,2011,Lehigh,Patriot,22,118,11,25,11,25,0,0,10,18,5,12,17,2,3,4,6,20,32
17934,Brennen Melvin,2010,2010,Fordham,A-10,18,210,9,41,4,17,5,24,9,12,6,19,25,17,11,1,14,19,32
17935,Reggie Miller,2018,2018,Texas State,Sun Belt,18,129,9,28,5,16,4,12,10,12,4,13,17,16,3,0,13,13,32
17936,Rodney Miller,2017,2018,Miami (FL),ACC,29,109,13,25,13,25,0,0,6,21,7,9,16,0,0,2,4,13,32
17937,Juwan Moody,2014,2014,North Carolina Central,MEAC,24,137,11,31,2,8,9,23,1,3,3,11,14,20,7,0,12,17,32
17938,Jamir Moore,2019,2019,Charleston Southern,Big South,14,74,12,35,7,11,5,24,3,4,3,8,11,4,2,4,3,11,32
17939,Kahlil Mumford,2009,2009,Saint Peter's,MAAC,11,135,11,36,3,5,8,31,2,3,3,7,10,4,4,0,11,7,32
17940,Hamilton Nash,2010,2010,Tennessee State,OVC,21,270,14,37,14,37,0,0,4,6,13,25,38,4,5,8,12,36,32
17941,Chinonso Obokoh,2015,2017,Total,Total,29,211,14,24,14,24,0,0,4,12,17,30,47,4,7,16,9,55,32
17942,Mitch Platt,2008,2008,Oregon,Pac-10,24,174,14,24,14,24,0,0,4,12,6,17,23,12,2,2,10,15,32
17943,Mike Podolsky,2011,2014,Youngstown State,Horizon,65,265,11,43,3,18,8,25,2,9,10,27,37,9,8,2,11,19,32
17944,Anthony Price,2012,2013,Alabama State,SWAC,22,234,12,35,9,21,3,14,5,13,6,8,14,26,13,0,21,20,32
17945,Reggie Revels,2010,2012,Norfolk State,MEAC,34,209,12,46,8,9,4,37,4,7,7,21,28,5,10,2,13,21,32
17946,Troy Robinson,2012,2012,Bryant,NEC,24,306,12,42,11,27,1,15,7,11,13,43,56,19,7,0,18,40,32
17947,Lawson Schaffer,2016,2019,Alabama,SEC,53,131,9,37,1,6,8,31,6,8,3,4,7,20,10,0,11,13,32
17948,Leke Solanke,2013,2014,Stetson,A-Sun,52,265,12,23,12,20,0,3,8,14,11,24,35,6,3,14,13,48,32
17949,Scott Spencer,2017,2018,Clemson,ACC,26,176,14,52,11,27,3,25,1,2,3,12,15,5,2,1,3,16,32
17950,Trei Steward,2008,2008,New Mexico State,WAC,18,125,11,20,11,20,0,0,10,18,13,13,26,2,1,3,10,20,32
17951,Jordan Stoermer,2011,2011,Iowa,Big Ten,19,115,11,28,4,5,7,23,3,5,7,8,15,9,6,1,5,13,32
17952,Shawn Taylor,2008,2008,Fresno State,WAC,20,,15,26,15,26,0,0,2,4,,,42,3,2,15,15,,32
17953,Bryson Triggs,2010,2012,Nicholls State,Southland,25,140,8,17,5,8,3,9,13,16,0,6,6,4,7,0,5,7,32
17954,Brett Valentyn,2008,2011,Wisconsin,Big Ten,51,172,10,29,1,2,9,27,3,4,2,12,14,8,2,0,7,19,32
17955,Riley Walker,2010,2010,Milwaukee,Horizon,23,141,13,34,11,25,2,9,4,9,7,22,29,6,4,1,8,16,32
17956,Robert Wiley,2015,2015,Grambling,SWAC,26,261,13,47,12,36,1,11,5,11,5,19,24,9,8,4,30,36,32
17957,Kwintin Williams,2018,2019,Connecticut,AAC,25,136,9,24,9,20,0,4,14,23,19,26,45,2,2,0,4,18,32
17958,Caleb Woods,2014,2015,Southeast Missouri State,OVC,14,64,11,26,7,16,4,10,6,10,3,4,7,4,3,0,1,7,32
17959,Malte Ziegenhagen,2012,2012,Tulane,CUSA,19,158,11,37,2,4,9,33,1,2,2,5,7,7,1,1,4,19,32
17960,Jordan Akwenuke,2012,2012,Santa Clara,WCC,28,251,13,21,13,21,0,0,5,6,25,36,61,5,11,4,10,61,31
17961,Damezi Anderson,2019,2019,Indiana,Big Ten,21,202,12,43,5,13,7,30,0,1,3,21,24,8,3,0,11,17,31
17962,DeAndre Barber,2015,2016,High Point,Big South,39,293,11,25,6,13,5,12,4,8,0,17,17,26,6,0,11,31,31
17963,Chris Blake,2014,2014,Bradley,MVC,32,303,10,24,10,24,0,0,11,23,22,55,77,3,6,14,14,33,31
17964,Lazar Bogdanovic,2010,2013,Colgate,Patriot,45,174,11,31,11,31,0,0,9,14,14,17,31,3,1,3,6,30,31
17965,George Brock,2017,2017,Southeastern Louisiana,Southland,15,103,11,46,5,22,6,24,3,7,1,3,4,11,2,0,6,11,31
17966,Jayvon Brown,2018,2018,UC-Riverside,Big West,9,89,9,26,7,15,2,11,11,15,1,6,7,5,1,0,10,5,31
17967,Charlie Byers,2014,2015,Kennesaw State,A-Sun,30,177,14,34,13,31,1,3,2,4,8,9,17,12,6,0,9,19,31
17968,Justin Daniel,2013,2013,Coastal Carolina,Big South,23,165,13,26,13,20,0,6,5,10,1,6,7,4,9,0,6,22,31
17969,Anthony Davis Jr.,2019,2019,Arkansas-Pine Bluff,SWAC,23,182,11,43,6,14,5,29,4,4,5,9,14,10,7,0,14,26,31
17970,Kyle Denning,2012,2015,Iowa,Big Ten,35,100,12,24,7,7,5,17,2,2,2,5,7,8,3,0,5,3,31
17971,Greg Dorleus,2012,2014,Charleston Southern,Big South,29,104,11,22,11,21,0,1,9,15,14,15,29,1,5,5,8,21,31
17972,Dalton Dry,2015,2018,Texas Christian,Big 12,48,155,8,28,3,16,5,12,10,22,7,15,22,5,7,1,10,23,31
17973,Marcellus Earlington,2019,2019,St. John's (NY),Big East,15,58,13,28,11,19,2,9,3,7,11,12,23,0,1,4,2,8,31
17974,Samba Fall,2008,2008,Gardner-Webb,A-Sun,27,232,11,22,11,22,0,0,9,18,16,31,47,3,3,10,11,44,31
17975,Harold Givens,2016,2019,Total,Total,22,178,13,24,13,24,0,0,5,8,12,20,32,7,7,6,8,12,31
17976,Cle'von Greene,2019,2019,Radford,Big South,15,67,12,23,7,11,5,12,2,2,0,6,6,4,1,0,4,3,31
17977,Zion Griffin,2019,2019,Iowa State,Big 12,17,112,11,32,5,7,6,25,3,7,5,22,27,1,2,1,2,7,31
17978,Peter Hanley,2016,2019,Bradley,MVC,44,226,12,31,10,24,2,7,5,7,10,31,41,9,5,3,11,16,31
17979,Vante Hendrix,2019,2019,Utah,Pac-12,4,71,9,20,3,3,6,17,7,8,2,10,12,6,1,0,4,8,31
17980,Jamil Hood,2015,2015,Long Island University,NEC,24,174,10,29,10,21,0,8,11,16,4,22,26,6,4,1,13,19,31
17981,Marcus Jackson,2008,2009,Wofford,Southern,19,120,11,25,2,5,9,20,0,1,2,10,12,1,4,1,11,12,31
17982,Brodricks Jones,2016,2018,Total,Total,31,208,8,38,7,30,1,8,14,20,8,21,29,6,4,10,12,28,31
17983,Darnel Jones,2010,2011,Savannah State,Ind,38,287,9,34,7,22,2,12,11,25,2,19,21,21,13,1,29,37,31
17984,Jonathan Kabongo,2019,2019,Virginia Tech,ACC,21,102,11,28,4,6,7,22,2,4,0,12,12,4,3,1,4,10,31
17985,Ray Kasongo,2016,2016,Tennessee,SEC,22,121,12,23,12,23,0,0,7,11,13,19,32,1,1,7,6,26,31
17986,James Kennedy,2012,2014,Boston University,Total,39,241,15,35,15,33,0,2,1,7,22,23,45,4,2,0,15,37,31
17987,Steven Kite,2008,2009,Mississippi Valley State,SWAC,16,63,9,24,8,16,1,8,12,15,2,3,5,3,4,0,4,9,31
17988,Adam Knollmeyer,2008,2008,Saint Louis,A-10,22,127,11,24,11,24,0,0,9,12,11,15,26,1,3,0,11,16,31
17989,DeAndre Leatherwood,2014,2014,Morehead State,OVC,17,88,14,23,14,23,0,0,3,9,9,12,21,2,2,5,6,17,31
17990,Jordan Lester,2016,2017,Robert Morris,NEC,25,266,13,39,11,25,2,14,3,4,3,21,24,19,11,0,18,27,31
17991,Isaac Letoa,2018,2019,Dartmouth,Ivy,27,154,13,30,13,24,0,6,5,11,2,16,18,19,8,1,11,8,31
17992,Sean Light,2009,2011,Quinnipiac,NEC,47,290,11,40,11,38,0,2,9,19,21,23,44,12,13,1,18,25,31
17993,Bryan Louff,2010,2010,Montana State,Big Sky,18,207,10,35,5,25,5,10,6,9,2,17,19,25,16,0,16,12,31
17994,James Manns,2019,2019,Wright State,Horizon,15,45,11,29,6,14,5,15,4,5,2,3,5,1,1,2,4,6,31
17995,Garrett Mayleben,2015,2016,Bowling Green State,MAC,38,286,12,42,9,25,3,17,4,7,10,26,36,2,0,3,11,36,31
17996,Isaih Moore,2019,2019,College of Charleston,CAA,11,99,10,25,9,17,1,8,10,16,7,16,23,2,4,3,3,13,31
17997,Martiese Morones,2008,2008,Texas Christian,MWC,24,203,10,34,5,17,5,17,6,12,4,17,21,19,9,0,15,27,31
17998,Anson Moye,2014,2017,Long Beach State,Big West,67,299,12,38,7,17,5,21,2,10,5,20,25,13,9,1,15,33,31
17999,Brendan Newton,2019,2019,Liberty,A-Sun,23,66,13,19,13,18,0,1,5,16,9,7,16,2,1,5,7,10,31
18000,Johnathan Nicely,2011,2012,North Carolina Central,Total,44,216,14,31,14,29,0,2,3,4,9,27,36,2,6,5,9,24,31
18001,Thomas Nolan,2017,2019,Fairfield,MAAC,32,216,11,46,3,11,8,35,1,2,3,10,13,8,6,1,7,24,31
18002,Justice Obasohan,2016,2019,East Carolina,AAC,38,233,12,40,12,37,0,3,7,10,11,23,34,8,5,13,11,30,31
18003,Kene Obi,2009,2010,DePaul,Big East,23,127,9,25,9,25,0,0,13,22,9,20,29,1,2,3,6,15,31
18004,Clarke Overlander,2013,2013,North Texas,Sun Belt,28,207,10,52,3,6,7,46,4,7,2,7,9,5,6,1,5,28,31
18005,Kevin Payton,2008,2009,Minnesota,Big Ten,36,301,10,41,7,19,3,22,8,16,13,16,29,38,15,7,31,29,31
18006,Devon Peterson,2011,2011,Kansas State,Big 12,16,75,12,22,11,21,1,1,6,10,2,8,10,5,5,0,3,14,31
18007,Case Rada,2014,2014,Sacramento State,Big Sky,20,85,11,38,3,6,8,32,1,4,2,8,10,3,2,0,2,7,31
18008,Jordan Reed,2019,2019,Chicago State,WAC,17,134,10,23,1,5,9,18,2,2,2,4,6,8,2,0,3,12,31
18009,John Riek,2010,2011,Mississippi State,SEC,25,107,10,18,10,18,0,0,11,16,14,18,32,2,0,9,7,21,31
18010,Patrick Shaughnessy,2010,2010,Charleston Southern,Big South,19,103,12,20,12,20,0,0,7,12,14,9,23,1,4,5,9,16,31
18011,Hunter Shelton,2019,2019,Jackson State,SWAC,18,140,10,39,1,3,9,36,2,4,2,13,15,4,4,0,6,6,31
18012,Kraig Shields,2015,2015,North Dakota,Big Sky,17,139,12,22,12,22,0,0,7,10,6,24,30,2,2,9,5,21,31
18013,Clyde Smith,2013,2014,Texas Christian,Big 12,39,282,11,44,8,31,3,13,6,13,3,22,25,21,7,2,22,21,31
18014,Erwin Staten,2008,2008,Jacksonville State,OVC,19,130,11,37,3,12,8,25,1,2,2,14,16,5,2,0,11,18,31
18015,William Tchiengang,2017,2017,Southeast Missouri State,OVC,18,212,12,16,12,16,0,0,7,12,13,33,46,0,1,5,15,40,31
18016,Marc-David Vil,2008,2009,Winthrop,Big South,24,126,12,34,9,22,3,12,4,20,3,13,16,9,4,0,9,15,31
18017,Jordan Walker,2018,2018,Seton Hall,Big East,17,123,10,31,4,12,6,19,5,12,2,7,9,15,6,1,12,29,31
18018,Dwayne Watkins,2009,2009,Northwestern State,Southland,12,79,7,28,6,20,1,8,16,23,4,10,14,4,6,1,10,9,31
18019,Jordan Wejnert,2012,2013,Maryland-Baltimore County,AEC,32,109,11,28,10,20,1,8,8,15,3,5,8,4,3,1,10,12,31
18020,Juwan Wells,2013,2014,Radford,Big South,28,147,13,43,9,22,4,21,1,3,13,14,27,8,11,3,11,21,31
18021,Ethan Wilmoth,2014,2015,North Carolina-Asheville,Big South,26,159,11,28,6,7,5,21,4,9,3,13,16,10,5,1,6,22,31
18022,Chase Winchester,2017,2017,Stephen F. Austin,Southland,12,71,7,19,4,9,3,10,14,17,4,8,12,4,2,1,3,14,31
18023,Eric Wortham,2014,2014,Middle Tennessee,CUSA,5,75,10,19,6,11,4,8,7,11,2,9,11,4,1,1,4,16,31
18024,Payton Youngblood,2019,2019,North Alabama,A-Sun,4,105,8,22,5,15,3,7,12,15,4,8,12,5,5,1,8,6,31
18025,Samson Akilo,2015,2016,Manhattan,MAAC,36,239,13,24,13,24,0,0,4,6,9,19,28,3,3,4,14,48,30
18026,Ivan Alipiev,2019,2019,Loyola Marymount,WCC,16,113,11,33,5,14,6,19,2,4,6,9,15,8,0,0,7,6,30
18027,Elijah Barnes,2018,2019,Princeton,Ivy,26,124,9,34,6,18,3,16,9,13,7,22,29,2,2,0,10,10,30
18028,Ben Biles,2008,2008,Navy,Patriot,18,146,10,20,10,20,0,0,10,17,16,14,30,4,3,2,14,27,30
18029,Teris Bourgeois,2014,2014,New Orleans,Southland,6,150,11,31,9,22,2,9,6,8,5,14,19,10,2,0,8,18,30
18030,Brandon Brady,2017,2018,Little Rock,Sun Belt,17,138,11,30,6,9,5,21,3,5,2,10,12,7,3,0,5,10,30
18031,Ryan Buck,2008,2008,Texas-Rio Grande Valley,Ind,17,164,11,20,11,19,0,1,8,15,9,16,25,9,3,1,8,28,30
18032,Emmanuel Calloway,2008,2008,Grambling,SWAC,19,169,10,42,5,14,5,28,5,8,1,12,13,12,3,2,10,23,30
18033,Jermaine Calvin,2009,2009,Northern Arizona,Big Sky,20,211,12,35,11,33,1,2,5,13,4,9,13,30,16,2,22,28,30
18034,Nic Combs,2012,2012,Troy,Sun Belt,10,96,12,24,10,22,2,2,4,8,3,10,13,12,1,0,5,3,30
18035,Sean Costigan,2008,2008,Maine,AEC,21,215,12,46,8,28,4,18,2,7,12,13,25,11,3,4,10,12,30
18036,Jason Cudd,2018,2019,South Carolina,SEC,28,184,9,24,9,24,0,0,12,17,9,16,25,3,0,3,6,22,30
18037,Gavin DeJong,2016,2017,Montana,Big Sky,28,127,12,29,12,29,0,0,6,11,10,20,30,3,4,3,9,21,30
18038,Duncan Demuth,2019,2019,Oklahoma State,Big 12,32,284,10,34,9,31,1,3,9,24,22,20,42,5,5,4,12,28,30
18039,Bobby Duncan,2016,2017,Citadel,Southern,34,167,10,17,10,16,0,1,10,22,14,38,52,5,8,0,10,45,30
18040,Alex English,2008,2009,Colgate,Patriot,26,153,12,35,12,35,0,0,6,12,14,18,32,7,0,5,13,22,30
18041,Jordan Fee,2009,2010,Detroit Mercy,Horizon,35,242,8,19,5,16,3,3,11,16,3,13,16,21,6,0,19,21,30
18042,Hassan Fofana,2008,2008,Loyola (MD),MAAC,28,304,10,34,10,34,0,0,10,13,26,52,78,6,7,20,22,72,30
18043,Chris Ford,2019,2019,Norfolk State,MEAC,32,218,10,27,10,27,0,0,10,22,22,14,36,4,3,8,13,49,30
18044,Sasha French,2019,2019,Albany (NY),AEC,21,125,11,23,11,23,0,0,8,11,12,15,27,3,0,5,14,24,30
18045,Spenser Gales,2013,2013,Houston Baptist,GWC,15,133,12,24,12,23,0,1,6,9,18,27,45,4,0,3,12,17,30
18046,Bobby Garbade,2012,2015,Princeton,Ivy,53,164,9,27,7,19,2,8,10,13,7,20,27,17,1,7,15,26,30
18047,Aaron Hawk-Harris,2012,2012,Northern Colorado,Big Sky,16,123,12,31,8,19,4,12,2,9,2,13,15,4,5,0,8,16,30
18048,Shane Heirman,2010,2011,Tulsa,CUSA,39,237,8,28,1,6,7,22,7,11,2,25,27,24,6,1,14,20,30
18049,Gilroy Hemsley,2008,2008,Morgan State,MEAC,33,268,11,29,11,29,0,0,8,13,19,25,44,2,6,18,14,51,30
18050,Zachary Hollis,2015,2015,Lamar,Southland,21,209,10,34,10,34,0,0,10,16,17,34,51,6,2,4,11,33,30
18051,Marcus Hutchins,2013,2013,Savannah State,MEAC,19,145,6,20,5,13,1,7,17,24,3,7,10,6,4,2,15,19,30
18052,Boban Jacdonmi,2019,2019,Southern Mississippi,CUSA,23,131,13,31,13,31,0,0,4,12,14,24,38,2,3,3,7,24,30
18053,Miles Jackson,2013,2014,Hampton,MEAC,24,127,11,20,7,12,4,8,4,7,3,16,19,7,4,2,7,10,30
18054,Ray Jerome,2017,2019,Pennsylvania,Ivy,22,133,10,36,2,11,8,25,2,3,3,12,15,9,3,0,8,11,30
18055,Dajuan Jones,2018,2018,Sam Houston State,Southland,14,91,11,27,8,15,3,12,5,14,1,10,11,16,1,0,13,8,30
18056,Garrett Kelly,2008,2010,Loyola (MD),MAAC,42,162,10,28,4,10,6,18,4,7,6,7,13,7,0,0,13,16,30
18057,Jonas Lalehzadeh,2009,2011,UC-Irvine,Big West,21,122,11,31,7,19,4,12,4,7,9,8,17,8,4,4,6,26,30
18058,Reggie Lassiter,2009,2009,Louisiana-Monroe,Sun Belt,16,178,10,30,9,25,1,5,9,14,3,12,15,17,6,0,23,15,30
18059,Oliver Lewinson,2009,2010,Duquesne,A-10,38,293,12,39,12,38,0,1,6,13,19,35,54,5,5,3,24,45,30
18060,Matty Madigan,2014,2014,Brown,Ivy,29,296,9,33,5,18,4,15,8,13,2,26,28,19,15,2,14,38,30
18061,Tim Magowan,2008,2009,Western Carolina,Southern,22,86,11,31,4,11,7,20,1,2,5,3,8,4,4,0,3,9,30
18062,Youssoupha Mbao,2010,2014,Total,Total,78,491,9,28,9,28,0,0,12,28,37,77,114,9,4,51,39,114,30
18063,Jalen McCallum,2014,2015,IUPUI,Summit,13,65,11,19,5,8,6,11,2,3,0,1,1,8,7,0,8,16,30
18064,Peter McMillan,2010,2013,Cornell,Ivy,43,161,10,43,2,12,8,31,2,4,6,21,27,3,1,3,9,9,30
18065,Kelly Merker,2009,2010,New Mexico State,WAC,29,212,10,28,10,27,0,1,10,12,10,29,39,4,5,3,8,32,30
18066,Demetrius Mims,2019,2019,Long Beach State,Big West,28,134,11,32,8,26,3,6,5,18,11,15,26,2,9,7,8,38,30
18067,Josh Murray,2014,2015,Jacksonville,A-Sun,37,278,11,34,11,34,0,0,8,9,22,27,49,4,10,20,9,30,30
18068,Viko Noma'aea,2014,2015,Utah State,MWC,28,147,10,35,4,11,6,24,4,5,4,7,11,6,6,0,4,17,30
18069,Brian Oddo,2014,2016,Miami (OH),MAC,30,147,11,28,6,10,5,18,3,5,6,13,19,3,3,0,6,13,30
18070,Ak Ojo,2016,2017,Manhattan,MAAC,35,281,11,20,11,20,0,0,8,18,17,41,58,2,6,18,24,77,30
18071,Alpha Okoli,2019,2019,St. Bonaventure,A-10,27,194,11,41,8,24,3,17,5,10,13,24,37,5,7,2,11,31,30
18072,Drew Onyebuchi,2011,2011,NJIT,GWC,16,125,12,21,12,20,0,1,6,18,11,14,25,3,5,7,4,26,30
18073,Eli Parquet,2019,2019,Colorado,Pac-12,26,222,11,41,6,20,5,21,3,7,9,18,27,8,6,10,13,23,30
18074,A.J. Patty,2016,2016,Murray State,OVC,18,93,10,29,10,24,0,5,10,12,8,15,23,0,3,3,4,16,30
18075,Andrew Pavloff,2010,2013,William & Mary,CAA,44,192,9,28,8,19,1,9,11,14,8,32,40,10,2,7,14,26,30
18076,Tavian Percy,2019,2019,New Mexico,MWC,22,168,10,34,5,14,5,20,5,9,9,11,20,9,8,1,6,19,30
18077,Antonio Pilipovic,2018,2019,Drake,MVC,24,149,11,45,3,4,8,41,0,0,3,10,13,7,3,1,5,18,30
18078,Michael Porter Jr.,2018,2018,Missouri,SEC,3,53,10,30,7,20,3,10,7,9,4,16,20,1,3,1,3,6,30
18079,Danny Powell,2013,2014,Eastern Washington,Big Sky,8,49,10,28,5,11,5,17,5,6,3,9,12,0,4,1,4,13,30
18080,Mike Sagay,2017,2017,Boston College,ACC,15,67,11,29,7,22,4,7,4,10,3,11,14,0,2,1,7,6,30
18081,Greyson Sargent,2008,2010,East Carolina,CUSA,36,98,10,23,2,5,8,18,2,2,2,4,6,2,1,0,4,6,30
18082,Zeke Schneider,2011,2013,Southern Illinois-Edwardsville,Total,58,370,11,22,11,22,0,0,8,11,16,34,50,5,5,10,13,64,30
18083,John Staley,2013,2013,Northern Kentucky,A-Sun,26,247,14,29,14,28,0,1,2,8,13,16,29,7,1,1,14,41,30
18084,Sean Starkey,2011,2012,Long Beach State,Big West,32,108,11,33,7,12,4,21,4,4,2,6,8,1,0,0,2,8,30
18085,Kody Stattmann,2019,2019,Virginia,ACC,18,73,9,21,5,6,4,15,8,9,2,9,11,2,1,0,5,8,30
18086,Lyle Sutton,2018,2019,Idaho State,Big Sky,33,107,8,22,8,13,0,9,14,24,4,6,10,9,8,0,3,29,30
18087,Jonathan Thomas,2015,2016,Jackson State,SWAC,38,272,9,17,9,17,0,0,12,20,12,18,30,6,6,0,17,73,30
18088,Zach Thornhill,2019,2019,Omaha,Summit,10,103,12,23,8,16,4,7,2,2,6,11,17,5,4,1,3,7,30
18089,Jacob Trader,2008,2010,Texas-Rio Grande Valley,Total,48,126,12,26,11,25,1,1,5,9,8,14,22,1,2,3,7,26,30
18090,Micah Walker,2014,2014,New Orleans,Southland,11,119,9,33,4,14,5,19,7,12,5,9,14,2,6,0,10,23,30
18091,John Williams,2009,2009,San Jose State,WAC,15,136,11,35,8,16,3,19,5,11,6,5,11,5,6,0,9,11,30
18092,Trey Woodbury,2019,2019,Nevada-Las Vegas,MWC,22,139,11,36,5,15,6,21,2,5,1,14,15,5,10,2,11,19,30
18093,Chase Adams,2011,2011,Montana,Big Sky,19,108,10,30,3,5,7,25,2,2,2,11,13,6,2,1,10,12,29
18094,Japeth Aguilar,2008,2009,Western Kentucky,Sun Belt,16,111,11,21,11,19,0,2,7,10,7,13,20,3,4,9,10,12,29
18095,Luka Andjusic,2015,2015,South Alabama,Sun Belt,18,140,9,33,1,5,8,28,3,3,2,16,18,6,2,0,5,11,29
18096,Matt Battaglia,2017,2017,Sacramento State,Big Sky,20,96,9,33,0,5,9,28,2,3,1,7,8,5,2,1,0,7,29
18097,Steven Bennett,2014,2017,Butler,Big East,32,112,10,28,1,4,9,24,0,1,3,11,14,8,0,0,6,11,29
18098,Jamal Bey,2019,2019,Washington,Pac-12,29,187,9,20,5,10,4,10,7,13,2,16,18,8,8,3,5,23,29
18099,Terrance Birdie,2013,2013,Alcorn State,SWAC,17,117,11,31,8,18,3,13,4,10,1,8,9,8,4,2,8,11,29
18100,Alek Blankenau,2008,2008,Harvard,Ivy,9,52,9,21,0,1,9,20,2,3,1,5,6,2,0,0,5,6,29
18101,Bo Blight,2018,2019,Charlotte,CUSA,30,244,11,38,8,22,3,16,4,6,8,43,51,6,4,8,9,23,29
18102,Warren Boyd,2013,2013,Arkansas-Pine Bluff,SWAC,24,199,8,30,8,28,0,2,13,20,15,18,33,5,2,1,7,20,29
18103,John Caprio,2011,2014,Georgetown,Big East,52,154,10,30,10,27,0,3,9,22,12,31,43,15,5,10,17,27,29
18104,Rokas Cesnulevicius,2012,2014,Evansville,MVC,31,200,11,23,11,23,0,0,7,19,21,20,41,7,4,5,11,45,29
18105,Cam Copeland,2019,2019,North Florida,A-Sun,12,80,9,35,6,19,3,16,8,8,1,3,4,5,3,0,4,5,29
18106,James Craft,2008,2008,Tennessee State,OVC,25,188,14,34,14,34,0,0,1,3,11,28,39,7,0,11,9,47,29
18107,Derrick Davis,2008,2008,South Carolina State,MEAC,8,162,10,39,8,24,2,15,7,9,5,11,16,18,4,0,25,22,29
18108,Josh Davis,2009,2009,Florida A&M,MEAC,7,,12,33,9,22,3,11,2,2,6,13,19,3,2,0,8,10,29
18109,Micah Delph,2012,2012,Stephen F. Austin,Southland,19,126,11,35,7,23,4,12,3,4,0,6,6,13,8,0,7,13,29
18110,Antonio DiMaria,2011,2011,Utah,MWC,26,156,9,28,3,6,6,22,5,7,6,12,18,5,1,0,8,13,29
18111,Trevonte Dixon,2012,2013,College of Charleston,Southern,39,122,10,34,8,23,2,11,7,10,7,11,18,4,6,1,15,23,29
18112,Raymond Doby,2016,2016,South Carolina,SEC,16,108,10,27,10,26,0,1,9,15,11,9,20,4,4,2,6,10,29
18113,Quincy Drye,2012,2015,High Point,Big South,25,79,12,32,12,28,0,4,5,9,3,7,10,2,5,2,3,7,29
18114,Treaven Duffy,2014,2015,Saint Mary's (CA),WCC,29,95,8,20,7,16,1,4,12,20,6,12,18,5,5,0,13,10,29
18115,Andre Edwards,2018,2018,East Tennessee State,Southern,4,60,12,28,8,16,4,12,1,2,4,7,11,3,5,3,2,4,29
18116,Trey Ford,2016,2019,Appalachian State,Sun Belt,22,59,9,14,2,2,7,12,4,5,1,5,6,10,3,0,3,5,29
18117,Joniya Gadson,2018,2019,Bowling Green State,MAC,25,106,11,19,11,19,0,0,7,17,12,22,34,2,3,4,11,31,29
18118,Boston Gubler,2015,2015,Utah Valley,WAC,27,252,11,37,11,37,0,0,7,13,15,32,47,11,3,6,19,29,29
18119,Drew Hackett,2016,2016,Illinois-Chicago,Horizon,21,184,8,36,5,14,3,22,10,15,4,13,17,11,6,1,16,18,29
18120,Martez Harris,2012,2012,Tennessee-Martin,OVC,15,194,11,37,7,26,4,11,3,6,19,17,36,8,6,5,13,9,29
18121,Zay Henderson,2013,2014,Murray State,OVC,33,166,13,18,13,18,0,0,3,13,9,33,42,1,2,1,9,30,29
18122,Bo Henning,2009,2009,Cal Poly,Big West,17,157,11,46,8,29,3,17,4,8,3,11,14,17,8,1,17,9,29
18123,Christian Hildebrandt,2014,2014,Texas-Rio Grande Valley,WAC,24,139,8,34,2,11,6,23,7,9,5,13,18,9,1,0,4,19,29
18124,Addison Hill,2017,2019,East Carolina,AAC,35,286,10,23,6,11,4,12,5,6,3,31,34,12,10,2,12,27,29
18125,Travis Hill,2008,2009,Centenary (LA),Summit,39,,8,34,5,13,3,21,10,13,,,23,18,6,0,10,,29
18126,John Hoskins,2010,2011,Detroit Mercy,Horizon,40,206,7,31,7,31,0,0,15,33,12,12,24,1,5,9,14,27,29
18127,Jeremy Jackson,2008,2008,Tennessee Tech,OVC,18,104,11,28,11,22,0,6,7,10,7,16,23,8,7,3,9,8,29
18128,Tyreak Johnson,2010,2010,Howard,MEAC,9,126,9,43,8,29,1,14,10,15,5,7,12,12,1,0,17,14,29
18129,Terrance Joyner,2009,2009,New Mexico State,WAC,16,170,10,28,7,20,3,8,6,9,4,13,17,16,9,0,16,32,29
18130,Jordan Kirschke,2011,2012,Texas State,Southland,21,75,7,19,1,6,6,13,9,15,2,2,4,5,3,0,6,12,29
18131,Isaac Knight,2008,2008,Kent State,MAC,28,154,11,24,11,24,0,0,7,12,7,22,29,4,0,7,9,30,29
18132,Uros Komadinic,2009,2009,Western Kentucky,Sun Belt,10,57,10,18,1,1,9,17,0,0,3,5,8,1,2,1,5,5,29
18133,Dusan Langura,2014,2016,Total,Total,22,88,10,34,1,4,9,30,0,0,1,7,8,0,0,1,2,9,29
18134,Anthony Lanier,2012,2013,Alabama A&M,SWAC,25,143,11,30,11,30,0,0,7,10,13,16,29,4,4,4,8,34,29
18135,J.D. Lewis,2008,2008,Texas,Big 12,25,98,10,18,2,2,8,16,1,3,3,8,11,4,3,0,4,14,29
18136,Kellen Manek,2017,2018,Oral Roberts,Summit,13,60,6,19,2,9,4,10,13,18,5,9,14,3,3,1,5,9,29
18137,Franck Ndongo,2008,2008,Virginia Commonwealth,CAA,20,153,8,34,5,26,3,8,10,15,13,19,32,7,7,0,15,23,29
18138,Michael Obindu,2017,2018,Howard,MEAC,32,251,11,27,11,27,0,0,7,16,20,25,45,5,6,7,12,38,29
18139,Christian Oshita,2016,2016,San Diego,WCC,18,152,10,34,5,15,5,19,4,9,9,20,29,4,2,0,12,17,29
18140,Thomas Pierre-Louis,2015,2016,Southern,SWAC,20,120,13,25,13,25,0,0,3,13,11,10,21,1,4,8,8,16,29
18141,Tate Pierson,2019,2019,Belmont,OVC,28,161,9,27,3,8,6,19,5,8,9,15,24,7,0,1,1,5,29
18142,Jesse Pistokache,2016,2017,Richmond,A-10,19,109,11,29,5,10,6,19,1,6,2,3,5,6,0,2,6,11,29
18143,Brandon Reese,2009,2012,Syracuse,Big East,49,95,9,27,8,20,1,7,10,17,9,10,19,17,9,0,9,9,29
18144,Pete Reynolds,2008,2010,Cornell,Ivy,53,143,13,25,13,20,0,5,3,7,5,19,24,10,3,9,9,15,29
18145,Nathan Robinson,2019,2019,South Dakota,Summit,18,177,6,43,5,17,1,26,16,27,7,17,24,6,1,0,6,9,29
18146,David Santiago,2012,2012,Canisius,MAAC,23,172,11,35,10,26,1,9,6,10,8,11,19,7,4,2,9,24,29
18147,Alexander Scotland-Williamson,2012,2013,Alabama-Birmingham,CUSA,48,211,7,12,7,12,0,0,15,23,10,15,25,5,1,4,21,47,29
18148,Caleb Simmons,2018,2018,San Jose State,MWC,24,219,8,29,3,8,5,21,8,10,6,26,32,16,7,0,18,19,29
18149,Charles Smith,2014,2016,Lipscomb,A-Sun,31,146,8,20,8,20,0,0,13,21,10,11,21,1,1,8,4,23,29
18150,Melvin Smith,2008,2008,Delaware State,MEAC,18,174,10,23,7,15,3,8,6,6,6,8,14,11,6,0,9,26,29
18151,Todd Starks,2010,2010,Idaho State,Big Sky,9,67,10,18,6,10,4,8,5,6,1,3,4,5,4,0,7,6,29
18152,Kevion Stewart,2018,2018,Southern Illinois-Edwardsville,OVC,17,127,8,27,0,4,8,23,5,6,4,14,18,8,3,0,6,13,29
18153,Logan Stumpf,2014,2014,Gardner-Webb,Big South,13,66,10,20,6,6,4,14,5,6,3,12,15,2,2,1,4,8,29
18154,Stacey Thomas,2019,2019,Louisiana Tech,CUSA,22,175,12,21,12,20,0,1,5,16,10,20,30,2,2,6,7,17,29
18155,Zac Tiedeman,2008,2008,Santa Clara,WCC,18,228,7,20,2,8,5,12,10,15,1,12,13,19,5,1,3,13,29
18156,Zack Tobler,2014,2017,Cincinnati,AAC,34,69,7,27,5,18,2,9,13,23,6,7,13,2,2,0,5,12,29
18157,Matthew Urbach,2019,2019,James Madison,CAA,12,85,11,15,4,5,7,10,0,0,3,4,7,2,1,0,1,2,29
18158,Devin Waddell,2014,2017,Auburn,SEC,66,452,10,38,6,19,4,19,5,11,14,34,48,10,6,4,14,69,29
18159,Austin Waddoups,2015,2015,Southern Utah,Big Sky,16,132,10,27,3,11,7,16,2,5,1,13,14,11,0,1,6,18,29
18160,Mark Washington,2008,2008,Northeastern,CAA,28,292,12,22,12,22,0,0,5,11,14,24,38,13,6,6,16,39,29
18161,Dayshawn Watkins,2015,2015,Florida State,ACC,22,198,7,25,6,17,1,8,14,21,2,20,22,20,8,0,17,25,29
18162,Collin Weaver,2015,2017,Total,Total,20,94,10,32,3,5,7,27,2,2,3,14,17,3,4,0,3,7,29
18163,Jonathan Wilfong,2014,2017,Southern Methodist,AAC,53,165,13,34,11,21,2,13,1,3,4,16,20,6,3,0,12,18,29
18164,Telvin Wilkerson,2012,2012,Southeast Missouri State,OVC,16,130,11,38,5,26,6,12,1,3,4,17,21,6,1,0,6,8,29
18165,Talek Williams,2018,2018,Central Connecticut State,NEC,11,118,9,26,8,17,1,9,10,13,1,8,9,9,3,1,7,12,29
18166,Kaijae Yee-Stephens,2017,2018,Pepperdine,WCC,15,125,12,33,8,17,4,16,1,3,3,5,8,6,2,0,1,16,29
18167,Vic Adams,2014,2014,Saint Peter's,MAAC,5,67,9,25,5,10,4,15,6,7,2,4,6,5,5,0,9,5,28
18168,Darius Allen,2019,2019,Baylor,Big 12,14,113,11,33,8,13,3,20,3,9,4,9,13,5,8,6,5,13,28
18169,Hansel Atencia,2016,2016,Liberty,Big South,19,165,8,27,7,21,1,6,11,19,3,12,15,17,4,0,10,22,28
18170,Bret Barclay,2015,2015,Southeastern Louisiana,Southland,29,148,11,27,10,24,1,3,5,6,11,14,25,3,2,2,8,21,28
18171,Phil Benson,2009,2011,Saint Mary's (CA),WCC,47,124,11,26,11,21,0,5,6,11,11,21,32,7,2,4,8,25,28
18172,David Bloom,2015,2018,Texas A&M-Corpus Christi,Southland,55,296,4,32,3,17,1,15,19,27,10,18,28,15,4,3,13,24,28
18173,Bryden Boehning,2016,2016,Montana,Big Sky,22,135,13,28,13,28,0,0,2,7,6,22,28,6,2,1,10,35,28
18174,Ari Boya,2019,2019,Bradley,MVC,13,93,9,23,9,23,0,0,10,24,8,14,22,2,3,9,8,17,28
18175,Adam Braswell,2010,2011,Morgan State,MEAC,26,157,9,23,1,3,8,20,2,4,3,7,10,9,5,0,6,19,28
18176,Daniel Bridges,2015,2015,South Carolina Upstate,A-Sun,9,80,11,33,6,14,5,19,1,2,6,13,19,6,1,0,7,3,28
18177,Jacob Broussard,2016,2018,Louisiana,Sun Belt,32,99,9,25,1,3,8,22,2,2,1,6,7,7,6,0,7,12,28
18178,Avery Brown,2016,2016,Green Bay,Horizon,15,81,10,29,4,14,6,15,2,8,5,8,13,6,4,0,4,2,28
18179,Robert Brown,2019,2019,New Mexico State,WAC,8,51,10,14,10,14,0,0,8,10,3,3,6,0,1,1,2,9,28
18180,Shane Burrell,2009,2009,Alabama A&M,SWAC,15,102,9,14,9,14,0,0,10,15,11,10,21,3,9,0,16,18,28
18181,Jakari Bush,2013,2013,Florida A&M,MEAC,12,143,10,24,9,21,1,3,7,8,0,7,7,18,1,0,18,12,28
18182,Tyjhai Byers,2017,2018,Morgan State,MEAC,31,288,14,27,14,27,0,0,0,3,27,30,57,1,5,32,8,48,28
18183,Jeremy Canty,2012,2012,Morgan State,MEAC,23,106,10,33,3,14,7,19,1,2,3,6,9,1,1,0,5,15,28
18184,Vonte Carter,2018,2019,Portland State,Big Sky,13,35,12,20,9,14,3,6,1,2,0,5,5,0,4,1,2,4,28
18185,Cam Christon,2018,2018,Boise State,MWC,14,83,9,23,3,7,6,16,4,7,5,12,17,8,1,1,7,8,28
18186,Kegan Clark,2011,2011,Wright State,Horizon,24,195,11,35,8,24,3,11,3,10,7,17,24,13,6,0,12,28,28
18187,Josh Conley,2017,2018,Southern Mississippi,CUSA,23,123,10,31,10,28,0,3,8,15,3,16,19,3,5,2,7,18,28
18188,Derrick Cook,2018,2018,Northeastern,CAA,17,86,11,23,8,19,3,4,3,6,1,10,11,5,3,0,7,3,28
18189,Marcus Cowan,2010,2010,Tennessee State,OVC,26,190,9,15,9,15,0,0,10,17,11,25,36,2,6,1,8,36,28
18190,Paul Darkwa,2010,2010,Wright State,Horizon,26,131,11,28,11,28,0,0,6,14,12,25,37,1,0,10,11,31,28
18191,Adam Demuyakor,2008,2008,Harvard,Ivy,18,127,12,25,12,25,0,0,4,9,8,11,19,3,3,2,15,20,28
18192,Souleymane Diakite,2019,2019,NJIT,A-Sun,16,135,10,19,10,19,0,0,8,12,14,32,46,6,3,10,5,25,28
18193,Brennan Doty,2013,2013,Lamar,Southland,11,79,7,19,6,17,1,2,13,18,5,9,14,3,2,0,18,8,28
18194,Quinche Dowdell,2009,2009,Appalachian State,Southern,18,117,11,17,11,17,0,0,6,10,8,18,26,2,6,4,9,25,28
18195,Quinton Drayton,2019,2019,Towson,CAA,10,49,10,22,7,13,3,9,5,7,2,7,9,3,2,0,5,7,28
18196,Kobie Eubanks,2016,2017,Texas A&M,SEC,24,153,11,41,5,9,6,32,0,5,8,17,25,5,3,1,9,11,28
18197,Markcus Falley,2012,2012,Pacific,Big West,13,107,9,40,3,10,6,30,4,8,5,11,16,7,4,1,7,10,28
18198,Stefon Fisher,2018,2018,Stephen F. Austin,Southland,11,61,11,19,11,19,0,0,6,10,6,7,13,4,1,2,7,14,28
18199,Daivon Gamble,2018,2018,Delaware State,MEAC,10,100,9,21,8,19,1,2,9,11,6,10,16,1,4,4,4,13,28
18200,Phillip Gates,2010,2010,Prairie View,SWAC,15,68,10,24,5,8,5,16,3,5,2,1,3,2,4,0,5,8,28
18201,Carlton Geathers,2012,2012,South Carolina,SEC,28,219,10,23,10,23,0,0,8,12,15,28,43,1,6,17,7,24,28
18202,Lionel Gomis,2013,2015,Total,Total,28,261,10,33,10,33,0,0,8,17,15,27,42,5,4,2,13,59,28
18203,Myles Green,2008,2009,Fresno State,WAC,27,141,8,31,3,9,5,22,7,11,3,13,16,17,3,0,14,7,28
18204,Larry Haley,2014,2015,Delaware State,MEAC,16,74,9,30,3,9,6,21,4,4,2,6,8,3,0,0,1,6,28
18205,Nick Haugen,2011,2012,North Dakota,GWC,32,186,10,33,4,13,6,20,2,2,2,11,13,7,1,0,4,15,28
18206,Josh Higgins,2008,2008,Santa Clara,WCC,12,66,12,23,11,22,1,1,3,5,7,8,15,3,0,1,15,17,28
18207,Andrew House,2008,2008,Belmont,A-Sun,9,41,10,23,5,8,5,15,3,4,3,4,7,2,3,0,2,1,28
18208,Casdon Jardine,2018,2018,Boise State,MWC,18,78,9,26,6,9,3,17,7,8,14,8,22,2,0,0,3,12,28
18209,Carl Johnson,2010,2010,Rider,MAAC,22,140,10,26,8,19,2,7,6,8,3,6,9,8,3,1,13,16,28
18210,Cory Jones,2013,2013,Prairie View,SWAC,24,185,8,20,6,14,2,6,10,21,6,10,16,13,8,0,19,28,28
18211,James Jones,2017,2017,Buffalo,MAC,14,83,10,26,5,11,5,15,3,5,1,4,5,4,0,0,3,8,28
18212,Jimmie Jones,2012,2014,Houston,Total,31,223,11,21,8,10,3,11,3,6,2,9,11,28,16,0,20,11,28
18213,Nick Kitcoff,2011,2013,IUPUI,Summit,35,178,10,39,6,11,4,28,4,6,1,16,17,4,2,8,4,13,28
18214,Aaron Leblanc,2013,2015,Louisiana,Sun Belt,35,141,13,26,12,24,1,2,1,6,9,9,18,3,1,12,9,15,28
18215,Josh Lemons,2013,2013,Toledo,MAC,27,382,10,38,8,22,2,16,6,10,5,12,17,24,29,5,17,41,28
18216,Nick Luttrell,2008,2008,Purdue-Fort Wayne,Summit,18,89,9,19,9,19,0,0,10,18,5,10,15,4,2,1,8,23,28
18217,Telvin Marshall,2015,2015,Grambling,SWAC,5,97,13,40,13,29,0,11,2,4,4,10,14,2,2,0,4,5,28
18218,ZaQwaun Matthews,2016,2019,Total,Total,29,145,12,42,8,17,4,25,0,2,4,13,17,13,1,0,5,9,28
18219,Stan Mays,2014,2015,Texas Tech,Big 12,15,49,8,17,2,2,6,15,6,8,2,2,4,2,1,0,6,2,28
18220,Reed McConnell,2013,2015,UC-Irvine,Big West,32,110,10,29,5,14,5,15,3,4,2,7,9,7,5,0,3,13,28
18221,C.J. McElrath,2010,2011,Army,Patriot,20,143,11,30,6,11,5,19,1,3,2,16,18,8,1,1,18,25,28
18222,Stefan Micovic,2013,2014,Maine,AEC,21,175,10,26,10,24,0,2,8,14,10,22,32,1,6,6,15,30,28
18223,Jordan Mitchell,2011,2013,Cal State Northridge,Big West,43,297,9,21,9,21,0,0,10,17,18,41,59,3,6,16,19,65,28
18224,Logan Mortenson,2013,2015,New Hampshire,AEC,19,140,9,33,4,14,5,19,5,6,7,13,20,7,5,0,7,13,28
18225,Rhys Murphy,2011,2012,Oregon State,Total,22,122,9,23,3,5,6,18,4,9,4,13,17,1,6,0,5,16,28
18226,Montenia Nelson,2018,2018,Presbyterian,Big South,6,104,11,24,7,13,4,11,2,5,1,9,10,6,0,0,9,8,28
18227,Daniel Noe,2015,2015,Navy,Patriot,7,93,11,34,7,13,4,21,2,3,6,10,16,3,3,1,6,7,28
18228,Joel Okafor,2016,2016,Bradley,MVC,26,280,10,40,10,28,0,12,8,19,5,25,30,29,9,1,32,41,28
18229,Julius Palmer,2018,2018,Oakland,Horizon,26,183,8,21,8,21,0,0,12,17,15,28,43,3,2,18,9,31,28
18230,J.D. Pelham,2009,2012,Lafayette,Patriot,82,399,10,30,7,18,3,12,5,9,20,41,61,12,3,17,21,65,28
18231,Aron Phillips-Nwankwo,2011,2015,Pittsburgh,Total,38,120,11,28,10,24,1,4,5,7,12,17,29,2,3,1,5,15,28
18232,Andrew Poulter,2013,2016,Total,Total,20,56,14,27,14,27,0,0,0,2,7,9,16,0,0,0,1,5,28
18233,Matt Read,2010,2010,Utah,MWC,16,107,8,19,4,10,4,9,8,9,7,11,18,1,0,0,8,15,28
18234,Bol Riek,2018,2019,New Orleans,Southland,19,92,9,20,7,16,2,4,8,13,6,15,21,3,1,6,11,13,28
18235,Nican Robinson,2008,2009,University of California,Pac-10,27,133,9,18,3,8,6,10,4,6,1,7,8,16,5,0,8,17,28
18236,John Sally Jr.,2019,2019,Youngstown State,Horizon,16,125,13,20,13,20,0,0,2,4,8,12,20,3,4,9,5,19,28
18237,Anthony Searcy,2008,2008,Alcorn State,SWAC,20,255,6,29,6,29,0,0,16,44,18,52,70,3,0,4,21,34,28
18238,Osinachi Smart,2018,2019,College of Charleston,CAA,33,236,8,22,8,22,0,0,12,20,21,47,68,3,7,9,8,44,28
18239,J'Breun Sprinkle,2016,2019,Arkansas-Pine Bluff,SWAC,37,291,12,24,10,19,2,5,2,7,6,8,14,17,14,0,20,17,28
18240,Myles Stewart,2015,2015,St. John's (NY),Big East,20,96,10,33,2,6,8,27,0,0,1,7,8,2,2,3,3,10,28
18241,Tai Strickland,2019,2019,Wisconsin,Big Ten,16,50,9,23,5,15,4,8,6,8,1,4,5,7,2,0,5,5,28
18242,Spencer Sutton,2018,2018,Oral Roberts,Summit,22,127,10,26,3,7,7,19,1,3,4,4,8,9,2,0,13,15,28
18243,Chance Talbert,2008,2008,Rice,CUSA,21,174,10,26,10,23,0,3,8,14,10,18,28,4,4,1,10,41,28
18244,Brandon Wade,2019,2019,Duquesne,A-10,27,249,8,41,5,15,3,26,9,13,3,15,18,22,7,1,23,31,28
18245,Maurice Wilkerson,2010,2010,Grambling,SWAC,11,144,12,21,11,20,1,1,3,4,10,14,24,5,5,2,9,31,28
18246,CJ Williamson,2019,2019,Mercer,Southern,26,120,12,29,12,29,0,0,4,9,20,9,29,5,13,2,6,17,28
18247,Mohammed Abdulsalam,2019,2019,North Carolina-Greensboro,Southern,31,168,12,24,12,24,0,0,3,7,21,22,43,2,7,1,2,36,27
18248,Rio Adams,2013,2013,Kansas,Big 12,24,83,10,25,8,20,2,5,5,13,3,3,6,6,6,0,11,14,27
18249,James Ametepe,2019,2019,Florida International,CUSA,13,50,12,21,12,21,0,0,3,4,5,6,11,1,2,2,2,10,27
18250,Tomie Aromona,2012,2013,Missouri State,MVC,33,163,9,26,6,12,3,14,6,10,5,11,16,6,7,0,6,18,27
18251,Courtney Austin,2014,2016,Texas-Arlington,Sun Belt,38,131,9,25,6,13,3,12,6,10,5,11,16,10,5,0,13,24,27
18252,Dante Bachus,2012,2012,Texas State,Southland,19,107,11,27,11,27,0,0,5,10,4,20,24,2,3,4,7,14,27
18253,Jamie Baker,2018,2019,Presbyterian,Big South,10,59,8,22,4,12,4,10,7,9,2,10,12,7,0,0,3,2,27
18254,Khalil Batie,2015,2017,Rutgers,Big Ten,35,127,10,35,3,16,7,19,0,3,4,17,21,9,3,4,4,12,27
18255,Charles Brown,2016,2016,Murray State,OVC,16,127,9,18,9,18,0,0,9,13,9,18,27,4,1,2,5,29,27
18256,Zach Buscher,2016,2018,Hawaii,Big West,38,102,11,24,11,15,0,9,5,9,2,14,16,5,3,0,11,14,27
18257,Isiah Carson,2008,2009,Miami (OH),MAC,28,121,11,28,8,20,3,8,2,3,5,11,16,10,5,1,12,19,27
18258,Darian Cartharn,2010,2010,Wright State,Horizon,27,170,9,27,4,12,5,15,4,4,0,10,10,13,5,0,13,18,27
18259,Maleek Catchings,2018,2019,Presbyterian,Big South,22,122,11,22,10,16,1,6,4,7,10,20,30,2,2,2,4,24,27
18260,Nikola Cicic,2010,2010,Little Rock,Sun Belt,15,105,8,36,3,5,5,31,6,8,0,7,7,11,4,1,9,14,27
18261,Deitrich Cole,2015,2016,Jacksonville State,OVC,21,196,11,29,11,28,0,1,5,11,11,17,28,6,2,12,11,42,27
18262,Ruben Cotto,2009,2009,Saint Louis,A-10,7,87,9,27,4,9,5,18,4,5,2,5,7,7,5,0,9,3,27
18263,Tyler Crawford,2008,2008,Georgetown,Big East,27,165,10,36,7,14,3,22,4,6,10,19,29,9,7,0,9,17,27
18264,Trace Cureton,2015,2016,Utah State,MWC,20,117,8,29,5,18,3,11,8,15,2,11,13,6,4,0,7,6,27
18265,Jake Dadika,2015,2018,Rutgers,Big Ten,51,277,9,34,6,17,3,17,6,14,0,14,14,17,5,0,14,19,27
18266,Duke DaRe,2013,2014,UC-Santa Barbara,Big West,30,316,9,47,5,15,4,32,5,7,6,25,31,30,13,0,27,47,27
18267,Jonathan Davis,2017,2018,Baylor,Big 12,22,52,9,18,6,10,3,8,6,7,2,1,3,2,0,0,4,4,27
18268,Kris Drees,2013,2014,Kennesaw State,A-Sun,35,221,11,21,11,21,0,0,5,10,14,21,35,3,3,0,8,30,27
18269,Stephen Edwards,2015,2015,Santa Clara,WCC,20,130,9,26,8,18,1,8,8,14,0,10,10,5,1,0,18,3,27
18270,Rene Esparza,2016,2016,New Mexico State,WAC,17,113,9,30,4,14,5,16,4,9,1,9,10,9,2,2,10,4,27
18271,Jake Forrester,2019,2019,Indiana,Big Ten,13,55,12,22,12,22,0,0,3,9,6,11,17,0,1,4,5,15,27
18272,Ruben Fuamba,2018,2018,Northern Arizona,Big Sky,19,215,11,23,11,23,0,0,5,9,21,39,60,2,2,11,14,42,27
18273,Antonio Gilkey,2009,2010,Eastern Kentucky,OVC,33,83,10,20,10,20,0,0,7,14,6,6,12,8,7,0,6,14,27
18274,Tim Graham,2019,2019,Wagner,NEC,9,65,10,24,5,8,5,16,2,4,3,7,10,3,1,3,4,15,27
18275,Johan Gunterberg,2008,2008,Northeastern,CAA,21,74,9,29,2,5,7,24,2,2,1,3,4,1,0,0,5,6,27
18276,Todd Halvorsen,2012,2014,East Tennessee State,A-Sun,25,111,9,24,4,9,5,15,4,5,3,8,11,9,11,0,10,11,27
18277,Jordan Harris,2011,2012,Bryant,NEC,21,105,10,29,7,19,3,10,4,12,8,7,15,5,3,2,13,19,27
18278,AJ Hawkins,2009,2009,Canisius,MAAC,22,166,12,24,12,24,0,0,3,7,4,26,30,5,3,0,9,24,27
18279,Shedrick Haynes,2011,2011,South Florida,Big East,25,152,10,32,6,14,4,18,3,4,1,9,10,17,5,0,22,21,27
18280,Jeff Howard,2011,2014,Indiana,Big Ten,56,206,7,19,7,19,0,0,13,23,16,22,38,7,3,6,10,24,27
18281,Michael Hueitt Jr,2018,2018,Old Dominion,CUSA,13,77,9,22,0,3,9,19,0,0,5,22,27,7,1,0,2,2,27
18282,D'Angalo Jackson,2008,2008,Green Bay,Horizon,8,109,10,30,6,19,4,11,3,9,3,6,9,9,3,0,1,13,27
18283,De'Shaud Johnson,2010,2011,East Tennessee State,A-Sun,24,158,10,25,8,19,2,6,5,6,1,7,8,14,4,0,10,20,27
18284,Tyson Jolly,2018,2018,Baylor,Big 12,20,178,9,43,7,24,2,19,7,10,9,27,36,17,4,5,14,32,27
18285,Adam Jones ,2012,2012,Fairfield,MAAC,23,164,10,24,10,24,0,0,7,10,6,14,20,3,4,7,5,20,27
18286,Jarred Jourdan,2013,2013,Liberty,Big South,6,110,11,26,10,22,1,4,4,9,4,7,11,7,2,2,10,16,27
18287,Samba Kane,2019,2019,Illinois,Big Ten,17,87,13,22,13,22,0,0,1,7,4,5,9,2,2,10,8,10,27
18288,Joeviair Kennedy,2017,2017,Western Michigan,MAC,8,59,12,24,10,18,2,6,1,1,4,3,7,2,2,0,2,7,27
18289,Jeremy King,2013,2014,Loyola (IL),Total,18,77,12,14,12,14,0,0,3,9,7,8,15,1,3,0,7,16,27
18290,Paul Kohlheim,2008,2008,Jacksonville,A-Sun,22,157,7,40,7,38,0,2,13,19,10,15,25,2,2,5,13,24,27
18291,Stephon Lamar,2010,2011,Pacific,Big West,17,89,9,27,6,17,3,10,6,9,1,14,15,8,2,0,10,5,27
18292,Josh Lamons,2008,2008,High Point,Big South,25,203,11,17,11,17,0,0,5,15,14,20,34,2,1,5,9,21,27
18293,Jaraan Lands,2017,2017,Albany (NY),AEC,5,85,8,21,8,21,0,0,11,21,7,12,19,2,3,0,9,6,27
18294,Jamarcus Little,2009,2010,McNeese State,Southland,46,179,12,36,12,36,0,0,3,9,15,24,39,3,1,6,15,35,27
18295,John Long,2009,2010,Morgan State,MEAC,38,158,12,24,12,24,0,0,3,13,29,24,53,2,3,3,4,38,27
18296,Liam McManimon,2014,2016,Mount St. Mary's,NEC,38,114,7,33,2,8,5,25,8,10,3,8,11,8,5,0,7,12,27
18297,Patrick Moody,2008,2009,North Carolina,ACC,38,77,8,19,8,19,0,0,11,19,10,14,24,2,5,3,7,9,27
18298,Brandon Nevens,2011,2011,Long Beach State,Big West,16,117,11,23,10,17,1,6,4,6,11,11,22,1,1,0,3,14,27
18299,Wes Noble,2016,2017,Morehead State,OVC,13,55,7,22,4,13,3,9,10,13,5,5,10,5,5,1,6,8,27
18300,Tristan Owens,2018,2019,Radford,Big South,39,144,10,37,5,15,5,22,2,6,9,20,29,9,3,0,9,12,27
18301,Matt Peeler,2011,2012,Evansville,MVC,31,171,11,27,11,27,0,0,5,16,15,24,39,0,5,6,14,36,27
18302,Bobby Perez,2015,2018,Wofford,Southern,27,96,10,18,5,12,5,6,2,5,0,0,0,9,3,0,11,7,27
18303,Corbin Ray,2009,2010,Texas Tech,Big 12,19,103,11,21,8,15,3,6,2,2,8,13,21,4,3,0,6,21,27
18304,Ben Resner,2011,2014,Stony Brook,AEC,34,115,6,25,5,18,1,7,14,20,4,12,16,15,4,0,26,5,27
18305,Breamon Richard,2018,2019,Long Beach State,Big West,44,230,5,25,2,13,3,12,14,19,2,16,18,10,10,0,17,32,27
18306,Rainier Rickards,2008,2009,St. Francis (NY),NEC,15,112,9,32,6,20,3,12,6,19,9,6,15,7,4,2,2,8,27
18307,Luis Rodriguez,2019,2019,Mississippi,SEC,25,154,10,22,10,20,0,2,7,8,10,17,27,15,5,7,7,15,27
18308,Ed Rolax,2011,2012,Florida Gulf Coast,A-Sun,31,181,8,28,4,17,4,11,7,10,14,18,32,7,7,4,12,21,27
18309,Stefan Rosic,2017,2017,Youngstown State,Horizon,16,90,10,29,7,14,3,15,4,6,1,8,9,3,1,2,5,9,27
18310,Keondre Schumacher,2019,2019,Winthrop,Big South,9,50,10,18,5,6,5,12,2,2,0,5,5,6,1,0,6,4,27
18311,Braxton Shaw,2019,2019,Eastern Illinois,OVC,8,68,11,28,10,22,1,6,4,6,3,8,11,0,4,0,8,11,27
18312,Rashaad Singleton,2008,2008,Georgia,SEC,10,136,12,28,12,28,0,0,3,9,13,20,33,4,1,17,11,10,27
18313,Matt Slatnick,2008,2008,Texas A&M-Corpus Christi,Southland,20,134,8,32,2,9,6,23,5,7,2,7,9,11,5,0,8,12,27
18314,Kendall Smith,2009,2012,North Carolina State,ACC,28,44,9,18,9,18,0,0,9,15,5,12,17,1,1,0,3,6,27
18315,Robbie Stenzel,2012,2014,Eastern Kentucky,OVC,31,99,8,25,2,3,6,22,5,6,0,12,12,13,8,0,4,8,27
18316,Taylor Stevens,2011,2011,Seattle,Ind,13,88,9,34,1,3,8,31,1,2,5,9,14,4,0,1,4,17,27
18317,Ted Talkington,2008,2008,West Virginia,Big East,22,113,8,18,2,5,6,13,5,8,1,10,11,10,3,2,6,8,27
18318,Taylor Trevisan,2011,2013,Saint Joseph's,A-10,24,38,9,15,6,8,3,7,6,10,3,5,8,3,1,0,3,5,27
18319,Jay Wey,2012,2012,San Francisco,WCC,12,66,9,23,1,4,8,19,1,2,0,6,6,6,3,0,3,4,27
18320,Mike White,2009,2011,Total,Total,22,126,13,28,13,28,0,0,1,8,14,15,29,0,3,5,6,16,27
18321,Nick Wood,2013,2016,Tulsa,Total,27,42,9,21,4,8,5,13,4,5,2,0,2,0,0,0,3,2,27
18322,Charonn Woods,2010,2012,Bradley,MVC,41,276,7,29,5,14,2,15,11,16,5,16,21,9,18,0,8,51,27
18323,Marice Wright,2018,2018,Alabama State,SWAC,20,129,12,30,11,23,1,7,2,9,13,24,37,2,1,2,7,27,27
18324,Bola Alade,2016,2017,Total,Total,23,108,10,38,8,24,2,14,4,9,6,8,14,4,2,0,8,8,26
18325,Jaylen Alston,2019,2019,Gardner-Webb,Big South,9,60,8,18,7,16,1,2,9,12,9,16,25,5,4,1,6,4,26
18326,Ron Alston,2017,2017,NJIT,A-Sun,21,111,11,31,7,15,4,16,0,0,6,11,17,7,3,2,9,17,26
18327,Keenan Barlow,2009,2009,Indiana State,MVC,16,96,8,24,2,9,6,15,4,6,4,8,12,3,1,0,6,8,26
18328,Jake Bischoff,2016,2017,Miami (OH),MAC,27,179,7,29,4,9,3,20,9,13,1,12,13,16,1,0,8,9,26
18329,Gavin Bizeau,2019,2019,Duquesne,A-10,20,112,8,30,5,13,3,17,7,11,5,9,14,1,1,4,8,20,26
18330,Montez Blair,2010,2014,Total,Total,18,70,8,28,2,6,6,22,4,6,2,6,8,3,1,0,8,4,26
18331,Robert Braswell,2019,2019,Syracuse,ACC,12,55,8,12,7,10,1,2,9,12,2,8,10,5,6,1,7,2,26
18332,Michael Briscoe,2014,2014,North Carolina A&T,MEAC,31,276,11,37,10,26,1,11,3,11,6,19,25,29,16,1,24,26,26
18333,Mike Brown,2012,2012,Weber State,Big Sky,16,99,8,16,2,6,6,10,4,6,2,5,7,4,4,2,7,6,26
18334,Grant Bryant,2015,2016,East Carolina,AAC,16,103,11,19,11,19,0,0,4,7,5,10,15,2,2,1,7,15,26
18335,Austin Burnette,2017,2019,Campbell,Big South,26,176,9,31,7,18,2,13,6,8,8,23,31,10,2,5,6,17,26
18336,Malik Carter,2016,2016,Delaware State,MEAC,9,106,9,36,7,24,2,12,6,10,5,10,15,13,4,1,12,12,26
18337,Gabriel Chami,2008,2008,James Madison,CAA,26,169,8,26,8,26,0,0,10,13,19,7,26,5,3,2,14,43,26
18338,Daniel Collie,2013,2016,Wright State,Horizon,41,221,10,33,6,16,4,17,2,3,3,10,13,13,10,1,11,24,26
18339,Cameron Craig,2014,2014,Southern Illinois-Edwardsville,OVC,20,176,9,29,8,20,1,9,7,9,4,13,17,18,10,1,22,23,26
18340,Cory Dixon,2010,2010,Northwestern State,Southland,18,93,9,22,8,18,1,4,7,11,5,9,14,9,3,1,8,10,26
18341,Trey Doomes,2019,2019,West Virginia,Big 12,12,46,7,18,7,18,0,0,12,18,5,6,11,2,3,0,3,4,26
18342,Akil Douglas,2017,2017,Santa Clara,WCC,12,42,10,22,10,15,0,7,6,10,3,6,9,0,1,3,4,6,26
18343,Derick Echols,2009,2009,Morehead State,OVC,20,64,7,14,7,14,0,0,12,26,4,19,23,0,0,1,6,16,26
18344,Tra'Von Fagan,2019,2019,Buffalo,MAC,22,84,12,23,12,18,0,5,2,4,10,16,26,4,5,3,3,13,26
18345,KJ Fitzgerald,2019,2019,Jacksonville,A-Sun,12,71,10,25,8,17,2,8,4,7,1,8,9,13,4,0,9,9,26
18346,Monice Garrett,2008,2008,Northern Colorado,Big Sky,25,248,10,50,9,34,1,16,5,10,4,18,22,37,1,1,34,15,26
18347,Jerald Gillens-Butler,2018,2019,Butler,Big East,24,129,8,34,5,16,3,18,7,10,6,14,20,4,2,0,8,21,26
18348,Primitivo Gomez,2016,2016,UC-Riverside,Big West,12,101,6,23,3,16,3,7,11,14,7,13,20,3,2,0,9,5,26
18349,Landon Harris,2012,2013,High Point,Big South,29,120,12,20,11,14,1,6,1,2,7,20,27,2,3,3,1,12,26
18350,Mykel Harris,2012,2012,Monmouth,NEC,20,115,8,28,8,21,0,7,10,13,3,12,15,1,2,1,8,15,26
18351,Jared Harrison,2013,2013,Stephen F. Austin,Southland,17,99,6,26,0,8,6,18,8,10,1,5,6,11,3,0,11,8,26
18352,Akeem Hemingway,2008,2008,Missouri-Kansas City,Summit,24,267,9,28,5,13,4,15,4,4,1,13,14,26,12,2,16,19,26
18353,Mateen Hirbod,2017,2019,Total,Total,17,64,7,21,4,8,3,13,9,11,4,4,8,7,4,1,6,7,26
18354,Mike Horn,2010,2013,Binghamton,AEC,51,676,9,53,6,24,3,29,5,12,15,42,57,17,31,2,10,53,26
18355,Blake Huggins,2019,2019,Ball State,MAC,12,84,9,22,9,22,0,0,8,15,10,12,22,5,0,4,3,12,26
18356,Riley Hunley,2009,2012,Tennessee Tech,OVC,44,153,10,30,10,21,0,9,6,11,11,20,31,23,8,0,12,13,26
18357,Brandon Johnson,2016,2017,Boston University,Patriot,20,58,10,23,5,6,5,17,1,1,3,6,9,2,0,0,4,7,26
18358,Bates Jones,2018,2019,Davidson,A-10,44,222,9,28,8,21,1,7,7,10,17,37,54,21,0,1,12,35,26
18359,Tom Kopko,2008,2011,Notre Dame,Big East,31,62,10,26,6,11,4,15,2,5,3,2,5,6,2,0,2,3,26
18360,Aaron Law,2013,2016,Total,Total,29,121,10,29,8,17,2,12,4,6,3,12,15,12,8,0,6,9,26
18361,Deng Leek,2015,2016,Southern Illinois,MVC,31,114,12,17,12,17,0,0,2,9,7,20,27,2,1,15,5,16,26
18362,Donnie Lewis,2018,2019,Southeast Missouri State,OVC,53,490,7,17,3,6,4,11,8,18,9,22,31,60,14,0,19,50,26
18363,Colby Long,2013,2014,Southern Illinois,MVC,33,128,9,28,2,7,7,21,1,3,2,6,8,8,1,0,12,6,26
18364,Kenny Manigault,2010,2010,Wichita State,MVC,16,115,7,17,7,16,0,1,12,21,3,12,15,17,5,0,9,10,26
18365,Evan Manning,2013,2016,Kansas,Big 12,42,108,9,22,2,4,7,18,1,2,0,11,11,5,10,0,9,18,26
18366,Mitch McCormick,2013,2016,Sam Houston State,Southland,38,99,8,29,1,5,7,24,3,5,1,4,5,4,3,0,2,5,26
18367,Norman Mitchell,2008,2008,Georgia State,CAA,22,141,11,24,7,14,4,10,0,1,7,10,17,4,4,1,6,10,26
18368,Russell Monroe,2008,2008,Liberty,Big South,20,86,10,17,10,17,0,0,6,10,7,14,21,3,1,4,6,14,26
18369,Austin Montgomery,2016,2016,Utah,Pac-12,8,36,10,13,9,12,1,1,5,6,5,7,12,2,0,1,4,5,26
18370,Billy Murphy,2013,2016,Lafayette,Patriot,46,67,11,28,7,12,4,16,0,1,3,6,9,3,1,1,2,9,26
18371,Richard Njoku,2019,2019,Navy,Patriot,21,143,9,19,9,19,0,0,8,17,16,20,36,1,1,6,7,24,26
18372,Calvin Poulina,2019,2019,Binghamton,AEC,18,155,9,38,4,9,5,29,3,6,4,9,13,2,2,2,9,16,26
18373,Tim Priller,2015,2018,Indiana,Big Ten,35,71,9,18,9,13,0,5,8,10,8,13,21,3,3,4,4,15,26
18374,Zeke Quinlan,2019,2019,Montana State,Big Sky,24,179,6,32,6,30,0,2,14,26,9,37,46,11,4,2,17,36,26
18375,Sean Raboin,2008,2008,Towson,CAA,19,149,10,33,9,31,1,2,5,6,13,14,27,7,4,1,7,13,26
18376,Andrew Riley,2017,2018,Arkansas State,Sun Belt,19,41,10,18,6,9,4,9,2,2,3,2,5,3,2,0,0,5,26
18377,DeAngelo Riley,2010,2010,Mississippi,SEC,17,104,10,18,10,18,0,0,6,9,6,17,23,8,7,9,6,16,26
18378,Chris Rollins,2018,2018,Purdue-Fort Wayne,Summit,11,52,12,23,11,16,1,7,1,2,3,2,5,5,2,0,3,3,26
18379,Jamie Rutherford,2017,2017,Texas Southern,SWAC,21,131,8,42,0,4,8,38,2,6,3,16,19,2,3,1,1,9,26
18380,Howard Sellars,2014,2014,Saint Peter's,MAAC,20,145,10,35,9,24,1,11,5,7,2,15,17,5,2,0,5,13,26
18381,Wayne Simon,2011,2012,American,Patriot,33,218,10,28,9,22,1,6,5,16,6,22,28,14,7,1,15,25,26
18382,Dylan Sinnickson,2016,2016,Vermont,AEC,18,84,11,20,7,11,4,9,0,1,12,17,29,1,2,0,5,15,26
18383,Malik Smith,2017,2017,North Carolina-Asheville,Big South,20,130,8,27,7,21,1,6,9,11,6,23,29,7,4,2,8,23,26
18384,Asrangue Souleymane,2008,2008,New Orleans,Sun Belt,19,211,9,21,9,20,0,1,8,17,22,24,46,2,5,14,7,34,26
18385,Greg Spurgetis,2008,2008,Montana,Big Sky,15,68,8,18,3,6,5,12,5,7,1,6,7,2,0,0,4,6,26
18386,Stephen Spurlock,2015,2016,Maryland-Eastern Shore,MEAC,32,153,10,29,10,27,0,2,6,10,12,19,31,3,2,1,4,15,26
18387,Steven Stanley,2016,2017,Northern Arizona,Big Sky,16,89,9,14,9,14,0,0,8,9,5,11,16,4,0,0,9,14,26
18388,Derrick Stewart,2013,2013,Rider,MAAC,10,69,8,17,8,17,0,0,10,10,9,16,25,1,2,2,4,11,26
18389,Jackson Stormo,2019,2019,Pepperdine,WCC,20,122,10,22,10,22,0,0,6,6,6,17,23,3,1,2,9,13,26
18390,Branden Stubbs,2011,2012,Iowa,Big Ten,16,54,8,13,4,7,4,6,6,6,0,4,4,6,5,0,7,3,26
18391,Gordon Taylor,2008,2009,Texas State,Southland,22,100,8,23,5,17,3,6,7,11,6,10,16,6,1,1,7,10,26
18392,Cheick Thiero,2015,2015,UC-Riverside,Big West,16,96,12,17,12,17,0,0,2,2,4,20,24,0,2,0,6,19,26
18393,Lance Thomas,2018,2018,Louisville,ACC,12,50,9,14,7,7,2,7,6,8,3,12,15,0,2,2,3,11,26
18394,Matt Tomaszewski,2011,2012,Syracuse,Big East,19,39,9,15,2,5,7,10,1,2,3,4,7,1,2,0,0,5,26
18395,Mike Underwood,2019,2019,Central Connecticut State,NEC,16,170,9,35,3,12,6,23,2,3,1,7,8,4,3,1,6,13,26
18396,Markus Vallien,2018,2018,Saint Francis (PA),NEC,13,53,7,21,4,13,3,8,9,14,0,2,2,3,6,0,5,6,26
18397,Paulius Vinogradovas,2013,2015,Norfolk State,MEAC,58,240,10,29,10,29,0,0,6,18,15,27,42,2,4,4,13,40,26
18398,Jesse Wade,2018,2018,Gonzaga,WCC,19,103,9,29,2,4,7,25,1,3,2,5,7,4,6,0,3,4,26
18399,Dantley Walker,2015,2015,Nevada-Las Vegas,MWC,11,64,9,24,1,4,8,20,0,0,0,5,5,1,0,0,0,7,26
18400,Wyatt Wilkes,2018,2019,Florida State,ACC,21,101,10,30,6,8,4,22,2,4,6,15,21,5,4,3,10,11,26
18401,Chris Zurcher,2012,2013,Texas Christian,Total,37,190,9,22,5,10,4,12,4,4,1,7,8,14,5,0,11,22,26
18402,James Anacreon,2012,2012,Wichita State,MVC,12,80,11,22,11,20,0,2,3,7,3,13,16,1,5,3,3,7,25
18403,Chris Beattie,2010,2010,Louisiana State,SEC,13,93,8,24,1,7,7,17,2,3,2,5,7,4,1,0,3,2,25
18404,Thomas Brandsma,2016,2017,Total,Total,29,131,8,16,6,11,2,5,7,9,3,8,11,1,2,1,6,9,25
18405,Dylan Brewster,2017,2018,Chattanooga,Southern,13,90,8,20,1,1,7,19,2,4,3,7,10,8,0,0,6,6,25
18406,Eddie Brown,2008,2008,Campbell,A-Sun,7,89,10,27,8,18,2,9,3,6,8,6,14,5,3,3,10,24,25
18407,Olivier Cadieux,2017,2018,Fairfield,MAAC,20,139,8,27,5,15,3,12,6,8,2,17,19,4,2,0,11,18,25
18408,Brian Cameron,2010,2012,Southern Utah,Summit,22,104,10,26,9,18,1,8,4,7,4,8,12,13,5,2,12,9,25
18409,Adam Carp,2008,2011,Nevada,WAC,36,110,6,19,6,18,0,1,13,20,8,12,20,3,1,2,5,17,25
18410,Rance Cole,2019,2019,Stephen F. Austin,Southland,14,76,10,21,7,12,3,9,2,4,1,2,3,5,4,1,3,4,25
18411,C.J. Davis,2015,2015,Tennessee-Martin,OVC,15,37,9,22,3,6,6,16,1,3,1,1,2,1,3,0,0,1,25
18412,Marlo Davis,2008,2009,North Carolina-Wilmington,CAA,34,172,9,25,8,18,1,7,6,6,5,14,19,21,16,1,19,22,25
18413,Ricardo De Bem,2008,2008,Texas Tech,Big 12,13,89,9,31,9,31,0,0,7,12,5,12,17,4,2,1,8,18,25
18414,Mahamoud Diakite,2009,2009,Wyoming,MWC,20,147,9,27,9,27,0,0,7,14,15,20,35,0,1,10,10,24,25
18415,Kyle Dobbins,2013,2016,Texas A&M,SEC,35,55,7,16,7,15,0,1,11,24,2,2,4,11,3,0,10,6,25
18416,Ibrahim Dosunmu,2018,2018,Howard,MEAC,10,69,12,15,12,14,0,1,1,4,10,12,22,3,1,0,5,11,25
18417,Jake Drum,2009,2012,Auburn,SEC,29,92,7,14,6,11,1,3,10,14,8,10,18,3,6,1,8,14,25
18418,Michael Dunne,2019,2019,Hartford,AEC,14,48,9,13,2,2,7,11,0,2,2,7,9,1,2,0,1,6,25
18419,Brandon Eddlestone,2014,2017,Louisiana State,SEC,29,133,10,26,7,18,3,8,2,4,18,17,35,2,3,1,5,16,25
18420,Savoy Fraine,2008,2008,Samford,OVC,17,152,8,33,6,12,2,21,7,8,5,17,22,8,3,4,6,11,25
18421,Paul Friendshuh,2016,2018,Richmond,A-10,39,130,9,18,8,16,1,2,6,12,5,9,14,4,1,1,15,27,25
18422,Kelvin Gaines,2012,2013,Cincinnati,Big East,39,276,11,29,11,29,0,0,3,13,25,44,69,3,10,38,17,51,25
18423,Jaylan Gainey,2019,2019,Brown,Ivy,11,64,9,12,9,12,0,0,7,11,5,19,24,4,1,8,5,6,25
18424,Bryce Golden,2019,2019,Butler,Big East,15,89,12,23,12,19,0,4,1,1,6,5,11,0,1,0,4,10,25
18425,Kevin Granger,2018,2019,Texas Southern,SWAC,16,108,11,20,11,20,0,0,3,16,9,19,28,2,2,4,4,13,25
18426,Raekwon Harney,2014,2014,Stetson,A-Sun,9,110,10,26,6,19,4,7,1,3,1,12,13,11,3,0,13,8,25
18427,Gregory Hayden,2014,2016,Hampton,MEAC,27,57,6,18,4,12,2,6,11,21,3,3,6,7,4,0,15,7,25
18428,Darius Hicks,2017,2018,North Carolina State,ACC,25,166,9,18,9,17,0,1,7,21,18,18,36,8,1,3,7,19,25
18429,Juan Hood,2018,2018,Prairie View,SWAC,27,83,8,17,8,14,0,3,9,10,2,7,9,8,1,0,3,10,25
18430,Doug Howard,2010,2013,William & Mary,CAA,30,83,10,21,10,19,0,2,5,7,2,6,8,7,7,0,6,10,25
18431,Gentry Hunt,2016,2017,Chicago State,WAC,26,85,8,23,3,6,5,17,4,6,3,7,10,2,2,1,6,7,25
18432,D'Angelo Hunter,2018,2018,West Virginia,Big 12,17,93,7,28,1,11,6,17,5,6,6,10,16,3,2,3,2,12,25
18433,Brian Ishola,2015,2016,North Dakota State,Summit,33,190,8,20,8,19,0,1,9,12,8,16,24,4,3,1,8,27,25
18434,Xavier Jackson,2018,2019,Virginia Commonwealth,A-10,28,177,8,27,4,12,4,15,5,6,4,17,21,10,5,1,9,12,25
18435,Isiah Jasey,2018,2019,Texas A&M,SEC,20,95,11,15,11,14,0,1,3,8,8,12,20,1,5,9,4,12,25
18436,Jordan Jefferson,2010,2011,Alabama State,SWAC,16,86,12,19,12,17,0,2,1,6,2,4,6,1,1,0,8,10,25
18437,Bobby Jolliff,2008,2008,Eastern Illinois,OVC,9,120,11,27,11,27,0,0,3,4,5,12,17,5,2,1,5,11,25
18438,Alex Kellogg,2008,2009,Providence,Big East,43,279,12,30,12,30,0,0,1,2,19,21,40,8,8,1,9,35,25
18439,Joshua Ko,2014,2018,Total,Total,32,64,10,35,5,18,5,17,0,2,1,12,13,5,4,1,4,2,25
18440,Nathan Laing,2016,2018,Total,Total,60,415,6,47,5,21,1,26,12,18,6,26,32,27,6,0,37,39,25
18441,Preston Laird,2009,2012,Memphis,CUSA,38,71,6,21,3,12,3,9,10,16,4,3,7,5,0,0,5,5,25
18442,Jonathan Landry,2010,2010,Coppin State,MEAC,4,70,10,25,6,16,4,9,1,4,5,6,11,1,2,0,0,4,25
18443,John David Little,2010,2010,Middle Tennessee,Sun Belt,12,46,9,15,5,9,4,6,3,7,0,6,6,3,1,0,3,0,25
18444,Matt Maresca,2008,2009,Western Kentucky,Sun Belt,43,124,12,23,11,20,1,3,0,6,17,27,44,13,4,1,6,23,25
18445,Geoff Middleton,2008,2008,Fairfield,MAAC,17,52,9,19,9,14,0,5,7,10,2,6,8,2,1,4,1,8,25
18446,Jonathan Miller,2012,2012,Eastern Illinois,OVC,12,58,8,19,5,13,3,6,6,9,2,4,6,2,4,0,7,7,25
18447,Clifton Moore,2018,2019,Indiana,Big Ten,24,103,10,23,10,21,0,2,5,12,9,24,33,6,4,9,6,15,25
18448,Joey Naccarato,2018,2018,Massachusetts-Lowell,AEC,13,68,5,15,4,9,1,6,14,19,4,7,11,3,0,0,4,8,25
18449,Ben Nelson,2008,2010,Nebraska,Big 12,33,104,5,16,5,16,0,0,15,25,7,12,19,3,4,2,7,14,25
18450,Thomas Odom,2011,2014,Charleston Southern,Big South,25,80,8,24,1,4,7,20,2,3,0,3,3,1,0,0,3,1,25
18451,Robert Ojeah,2015,2016,Alabama State,SWAC,21,121,10,21,10,21,0,0,5,11,13,21,34,1,1,4,8,32,25
18452,Dylan Painter,2017,2019,Villanova,Big East,24,138,8,17,8,14,0,3,9,16,10,27,37,1,1,2,5,15,25
18453,Freddy Poole,2015,2018,Winthrop,Big South,42,99,9,22,6,12,3,10,4,9,4,13,17,1,5,0,9,16,25
18454,Matt Poplawski,2014,2015,Pennsylvania,Ivy,21,106,7,26,3,6,4,20,7,12,0,4,4,5,2,0,7,10,25
18455,Donald Pritchard,2009,2009,Mississippi Valley State,SWAC,17,58,9,18,8,16,1,2,6,9,2,5,7,4,3,0,8,8,25
18456,Tyson Queen,2011,2012,McNeese State,Southland,31,124,8,22,7,17,1,5,8,15,8,14,22,1,2,0,6,27,25
18457,James Rader,2010,2010,South Dakota State,Summit,12,52,7,16,3,6,4,10,7,8,2,9,11,1,0,0,4,10,25
18458,Elton Roy,2011,2011,Robert Morris,NEC,8,104,9,35,3,16,6,19,1,2,3,8,11,7,1,0,4,11,25
18459,Solomon Ruddell,2019,2019,UC-Irvine,Big West,19,71,9,15,9,15,0,0,7,10,4,8,12,1,0,5,5,20,25
18460,Clyde Santee,2014,2014,Massachusetts,A-10,15,42,9,15,5,6,4,9,3,5,1,6,7,2,1,2,3,5,25
18461,Rigoberto Sargeant,2009,2009,Coppin State,MEAC,6,91,10,19,9,18,1,1,4,6,10,11,21,1,3,2,7,15,25
18462,Noah Saunders,2019,2019,Campbell,Big South,14,114,7,23,4,6,3,17,8,10,3,16,19,1,3,2,4,16,25
18463,Adam Savion,2013,2014,Hofstra,CAA,28,226,8,21,8,21,0,0,9,19,8,16,24,9,5,0,19,18,25
18464,T.J. Schlundt,2016,2018,Wisconsin,Big Ten,41,217,9,42,3,11,6,31,1,1,7,10,17,7,4,3,4,11,25
18465,Gerald Smith,2015,2018,Samford,Southern,45,239,9,34,6,20,3,14,4,7,4,12,16,10,3,1,6,24,25
18466,Blake Spellman,2017,2017,Northern Kentucky,Horizon,11,141,8,23,1,2,7,21,2,2,1,13,14,8,2,0,7,6,25
18467,Keith Stackhouse,2012,2013,San Diego,WCC,22,131,10,28,7,13,3,15,2,5,4,10,14,6,7,0,12,8,25
18468,James Still,2010,2010,Providence,Big East,26,145,10,26,10,24,0,2,5,14,18,17,35,3,0,10,9,26,25
18469,Steve Swiech,2009,2010,Akron,MAC,14,44,12,21,12,21,0,0,1,6,3,6,9,1,0,4,2,8,25
18470,Myles Tate,2015,2017,George Mason,A-10,35,156,6,26,2,14,4,12,9,13,7,18,25,14,7,0,12,22,25
18471,Kendrell Thompson,2009,2009,Sam Houston State,Southland,23,119,7,25,5,16,2,9,9,16,6,11,17,3,5,0,9,5,25
18472,JoJo Toppin,2019,2019,Georgia,SEC,18,99,8,22,7,17,1,5,8,10,7,6,13,3,1,1,10,13,25
18473,Jethro Tshisumpa,2017,2017,Arizona State,Pac-12,26,192,11,26,11,26,0,0,3,9,16,23,39,0,4,25,8,55,25
18474,Henry Uwadiae,2015,2016,Green Bay,Horizon,29,118,11,17,11,17,0,0,3,12,10,15,25,2,1,16,15,37,25
18475,Nathan Watkins,2013,2016,Vanderbilt,SEC,37,106,7,23,4,5,3,18,8,13,3,12,15,1,1,0,7,8,25
18476,Malik William,2018,2018,Clemson,ACC,17,74,10,27,9,24,1,3,4,6,14,12,26,3,1,3,2,11,25
18477,Lateff Willis,2008,2008,St. Francis (NY),NEC,25,219,8,20,1,1,7,19,2,4,2,16,18,36,3,0,20,8,25
18478,Payton Wilson,2018,2018,Jackson State,SWAC,12,88,8,18,4,12,4,6,5,10,8,9,17,2,2,4,9,12,25
18479,Jan Wojcik,2019,2019,Missouri State,MVC,18,112,8,16,5,7,3,9,6,11,2,14,16,3,7,4,7,22,25
18480,Derek Wolfley,2009,2009,Iona,MAAC,25,187,9,28,9,25,0,3,7,10,12,10,22,3,6,11,26,28,25
18481,Jalen Adams,2015,2015,St. Bonaventure,A-10,14,62,8,23,5,12,3,11,5,7,0,1,1,3,3,0,2,6,24
18482,Rashaad Armstrong,2008,2008,Tennessee State,OVC,20,121,9,17,9,17,0,0,6,13,7,11,18,1,8,3,6,24,24
18483,Rex Baxter,2013,2013,Stephen F. Austin,Southland,13,60,9,24,8,14,1,10,5,8,6,8,14,2,5,1,5,4,24
18484,Pedro Bradshaw,2019,2019,Eastern Kentucky,OVC,10,73,10,24,9,18,1,6,3,5,7,11,18,4,6,2,3,3,24
18485,Blake Brown,2016,2017,Eastern Michigan,MAC,36,174,9,16,9,16,0,0,6,13,19,20,39,1,2,4,5,36,24
18486,Darnell Brown,2009,2009,Bowling Green State,MAC,4,,9,18,6,12,3,6,3,4,,,7,8,4,0,8,,24
18487,C.J. Cole,2014,2017,Oklahoma,Big 12,51,133,10,23,10,20,0,3,4,14,8,24,32,2,1,0,7,24,24
18488,Lincoln Conrey,2016,2019,Northern Iowa,MVC,21,67,9,17,6,10,3,7,3,5,3,4,7,4,1,0,5,3,24
18489,Rakeem Couch,2010,2010,Texas-Rio Grande Valley,GWC,18,178,7,13,7,13,0,0,10,16,7,17,24,5,3,0,11,21,24
18490,Noah Cummings,2017,2017,Grambling,SWAC,24,162,9,18,9,18,0,0,6,9,12,12,24,1,1,8,17,36,24
18491,Lavonne Davis,2016,2017,Prairie View,SWAC,30,157,8,16,8,16,0,0,8,13,11,23,34,1,5,0,10,44,24
18492,Matt Deady,2018,2018,Indiana State,MVC,20,151,8,18,8,17,0,1,8,13,8,12,20,5,10,0,9,22,24
18493,Jake Fay,2014,2017,Total,Total,33,124,7,41,0,10,7,31,3,4,7,7,14,3,4,3,8,19,24
18494,CJ Fisher,2017,2017,North Florida,A-Sun,19,100,7,16,7,16,0,0,10,23,4,7,11,11,2,0,9,13,24
18495,Beau Gamble,2011,2014,Total,Total,18,41,8,21,2,5,6,16,2,4,1,10,11,11,2,0,5,4,24
18496,Nick Goshay,2011,2011,Florida Gulf Coast,A-Sun,16,81,8,20,5,12,3,8,5,8,4,8,12,3,1,1,6,9,24
18497,Nigel Holley,2016,2016,East Tennessee State,Southern,19,125,10,22,10,22,0,0,4,7,5,12,17,5,0,1,8,23,24
18498,Jake Houseknecht,2010,2012,St. Bonaventure,A-10,49,241,9,29,9,29,0,0,6,9,11,34,45,4,6,20,14,32,24
18499,Owen Hulland,2019,2019,Hawaii,Big West,8,55,9,22,8,16,1,6,5,6,4,7,11,1,2,1,3,5,24
18500,Delveion Jackson,2018,2018,UC-Davis,Big West,18,205,9,33,5,17,4,16,2,7,12,20,32,14,7,1,8,13,24
18501,Justin Jamison,2015,2015,Texas Tech,Big 12,9,64,8,19,6,15,2,4,6,9,9,9,18,2,1,1,4,13,24
18502,Branden Jenkins,2017,2017,Louisiana State,SEC,19,152,8,40,4,27,4,13,4,11,2,8,10,11,5,1,7,18,24
18503,Jacob Kilgore,2016,2017,Marshall,CUSA,22,91,8,22,1,2,7,20,1,2,4,8,12,1,3,3,0,7,24
18504,Abe Kinrade,2019,2019,Air Force,MWC,19,65,8,18,6,14,2,4,6,7,4,14,18,1,1,1,1,5,24
18505,Marko Kovacevic,2014,2014,Utah,Pac-12,14,69,9,15,9,15,0,0,6,8,5,5,10,3,0,1,7,12,24
18506,Diamante Langston,2017,2017,Abilene Christian,Southland,25,199,9,18,9,16,0,2,6,13,0,16,16,16,7,0,19,22,24
18507,Kolby Lee,2019,2019,Brigham Young,WCC,17,54,10,24,9,20,1,4,3,12,6,10,16,1,0,0,2,12,24
18508,Jack Loofburrow,2008,2008,Eastern Washington,Big Sky,14,70,9,22,3,8,6,14,0,1,2,10,12,2,0,2,4,6,24
18509,Alex Lubsey,2012,2013,Eastern Illinois,OVC,35,150,9,18,9,18,0,0,6,10,13,13,26,7,4,4,9,15,24
18510,Griffin McKenzie,2011,2014,Total,Total,36,92,9,24,4,14,5,10,1,1,3,12,15,5,0,2,5,12,24
18511,Ethan Michael,2013,2014,Air Force,MWC,15,81,6,19,5,14,1,5,11,20,7,13,20,16,2,3,7,11,24
18512,Ben Milshtein,2014,2015,Mississippi Valley State,SWAC,22,125,9,29,9,28,0,1,6,14,10,16,26,3,1,0,7,25,24
18513,DJ Mitchell,2019,2019,Hartford,AEC,24,159,6,26,3,13,3,13,9,10,1,12,13,13,5,1,6,23,24
18514,Adam Mitola,2017,2019,George Washington,A-10,41,192,8,30,1,6,7,24,1,2,4,8,12,5,2,0,11,16,24
18515,Kevin Montminy,2012,2015,Penn State,Big Ten,44,101,9,20,5,8,4,12,2,7,7,4,11,0,2,1,2,17,24
18516,K'Len Morris,2008,2008,Michigan,Big Ten,11,113,8,25,3,9,5,16,3,5,2,10,12,5,3,0,10,10,24
18517,David Naves,2011,2011,Howard,MEAC,15,157,10,35,8,29,2,6,2,4,8,6,14,5,5,0,18,8,24
18518,Jack Ocwieja,2016,2016,Grambling,SWAC,16,148,11,24,11,23,0,1,2,2,4,13,17,0,0,4,5,19,24
18519,Derek Oestreicher,2009,2009,UC-Davis,Big West,24,108,7,19,7,18,0,1,10,13,3,9,12,3,3,3,10,24,24
18520,Ugo Okam,2011,2015,Total,Total,33,179,10,21,10,21,0,0,4,11,10,15,25,6,1,10,18,32,24
18521,Cameron Pappas,2015,2016,Charlotte,CUSA,16,69,5,17,3,8,2,9,12,14,1,9,10,5,2,0,3,7,24
18522,Kwe Parker,2017,2017,Tennessee,SEC,25,202,10,31,7,18,3,13,1,8,4,17,21,22,6,3,23,30,24
18523,Tamell Pearson,2019,2019,Alabama-Birmingham,CUSA,32,214,9,34,9,31,0,3,6,10,7,22,29,7,4,3,13,38,24
18524,Antoine Perry,2008,2010,Norfolk State,MEAC,60,403,10,52,9,42,1,10,3,7,9,22,31,33,12,2,44,48,24
18525,Je'Quan Perry,2018,2018,Florida Atlantic,CUSA,12,113,8,26,2,9,6,17,2,3,1,21,22,4,5,0,5,15,24
18526,Jeffon Powell,2015,2015,Bethune-Cookman,MEAC,22,256,7,26,7,21,0,5,10,14,11,26,37,3,2,1,15,38,24
18527,Danny Quinn,2010,2011,Towson,CAA,26,189,10,29,8,19,2,10,2,5,19,18,37,8,1,3,4,21,24
18528,Mike Ranson,2017,2017,Northern Colorado,Big Sky,14,117,7,25,1,5,6,20,4,5,0,11,11,7,1,0,8,7,24
18529,Phillip Reed,2014,2015,Hampton,MEAC,31,242,8,24,8,24,0,0,8,15,21,33,54,5,1,9,12,52,24
18530,Sammis Reyes,2017,2018,Tulane,AAC,32,254,9,34,9,34,0,0,6,23,17,31,48,8,11,12,17,59,24
18531,Julian Richardson,2015,2017,Total,Total,15,98,7,23,4,9,3,14,7,8,1,5,6,8,3,0,5,5,24
18532,Alex Rossi,2012,2013,Total,Total,12,62,9,15,3,3,6,12,0,0,0,5,5,2,1,0,5,3,24
18533,Justin Ryder,2019,2019,Delaware State,MEAC,30,218,9,31,4,15,5,16,1,4,4,17,21,12,10,1,10,26,24
18534,Justin Sample,2008,2008,Detroit Mercy,Horizon,12,126,12,23,12,23,0,0,0,6,6,12,18,1,1,0,12,21,24
18535,Richie Sebuharara,2012,2013,Buffalo,MAC,27,183,7,20,1,6,6,14,4,4,2,5,7,16,4,0,10,8,24
18536,Sean Spooner,2009,2009,North Carolina-Greensboro,Southern,21,140,7,31,7,26,0,5,10,17,7,14,21,12,5,0,21,28,24
18537,Hikeem Stewart,2012,2014,Washington,Pac-12,38,237,10,36,8,20,2,16,2,3,1,12,13,15,9,1,13,15,24
18538,Frank Tchuisi,2008,2009,Villanova,Big East,32,91,8,23,8,23,0,0,8,17,7,15,22,1,0,2,4,16,24
18539,Whit Thornton,2012,2012,Army,Patriot,28,315,9,26,9,24,0,2,6,13,13,41,54,27,4,5,31,54,24
18540,Riley Till,2018,2019,Iowa,Big Ten,24,96,7,17,7,10,0,7,10,15,5,5,10,5,7,2,4,14,24
18541,Cade Towers,2014,2014,Nicholls State,Southland,16,111,10,29,8,24,2,5,2,8,8,7,15,2,2,1,8,27,24
18542,Stephen Toyra,2013,2016,Purdue,Big Ten,35,102,6,19,6,11,0,8,12,18,5,8,13,5,2,0,11,12,24
18543,Jordan Tyrance,2012,2013,Nebraska,Big Ten,25,126,8,23,8,18,0,5,8,11,13,13,26,4,2,2,9,16,24
18544,Luka Voncina,2012,2012,Charlotte,A-10,8,125,9,25,4,9,5,16,1,2,2,4,6,8,3,1,10,8,24
18545,Evan Wessenberg,2015,2017,North Dakota State,Summit,28,112,12,22,12,21,0,1,0,2,5,7,12,4,2,1,7,15,24
18546,DuBois Williams,2008,2008,Saint Mary's (CA),WCC,17,96,8,27,4,14,4,13,4,8,2,15,17,7,4,2,4,14,24
18547,Naasir Williams,2014,2014,Vermont,AEC,18,104,8,27,6,16,2,11,6,9,0,7,7,15,2,0,7,13,24
18548,Pierson Williams,2011,2012,Loyola (MD),MAAC,27,120,9,34,5,14,4,20,2,4,6,8,14,4,2,0,6,9,24
18549,Kareem Wright,2018,2018,Grambling,SWAC,21,148,9,36,7,19,2,17,4,10,1,11,12,12,7,0,20,22,24
18550,Corey Young,2014,2015,Alcorn State,SWAC,22,123,9,26,3,6,6,20,0,0,3,8,11,2,1,0,2,9,24
18551,Wandji Aboubakar,2008,2008,Sacramento State,Big Sky,21,202,9,17,9,17,0,0,5,10,11,17,28,2,3,6,9,44,23
18552,Nate Allen,2016,2016,North Carolina Central,MEAC,16,81,9,35,4,11,5,24,0,4,3,4,7,2,2,0,5,11,23
18553,Dom Antonelli,2016,2019,Navy,Patriot,24,83,8,26,1,4,7,22,0,0,0,11,11,0,2,0,5,0,23
18554,Tyler Barlow,2016,2016,Lafayette,Patriot,20,143,9,24,9,24,0,0,5,8,9,19,28,2,3,5,2,25,23
18555,Jaylen Beckham,2013,2013,Samford,Southern,16,129,7,26,6,21,1,5,8,14,8,5,13,12,8,1,21,16,23
18556,Marcus Bingham,2019,2019,Michigan State,Big Ten,24,83,6,21,0,7,6,14,5,9,4,22,26,7,0,10,4,11,23
18557,Tomas Brock,2008,2008,Missouri State,MVC,20,188,5,22,1,9,4,13,9,11,2,10,12,13,4,0,14,17,23
18558,Domas Budrys,2015,2017,Austin Peay,OVC,31,112,7,36,1,11,6,25,3,7,3,4,7,1,4,0,5,9,23
18559,Michael Creppy,2008,2008,UC-Riverside,Big West,18,140,6,23,4,13,2,10,9,14,2,9,11,10,4,0,11,9,23
18560,Bryant Crowder,2012,2012,Hofstra,CAA,3,55,9,15,9,15,0,0,5,13,4,9,13,0,1,1,7,8,23
18561,Carlos Curtis,2019,2019,East Tennessee State,Southern,10,69,8,24,8,20,0,4,7,10,7,3,10,6,2,0,7,5,23
18562,Marceis Davis,2011,2011,Southern,SWAC,10,96,8,22,3,5,5,17,2,4,3,0,3,2,1,1,4,4,23
18563,London Dokubo,2012,2015,Loyola (IL),Total,93,538,8,25,5,13,3,12,4,10,5,25,30,39,14,0,30,61,23
18564,Deven Dorsett,2017,2017,Maryland-Eastern Shore,MEAC,19,142,10,42,9,31,1,11,2,9,13,20,33,4,3,2,9,13,23
18565,Anthanee Doyle,2014,2014,Chattanooga,Southern,11,72,8,21,4,12,4,9,3,5,2,6,8,6,2,0,4,8,23
18566,Rip Economou,2019,2019,Seattle,WAC,15,64,7,27,1,3,6,24,3,5,4,2,6,0,0,1,2,15,23
18567,Jevon Estelle,2014,2016,Grand Canyon,WAC,29,109,8,24,7,15,1,9,6,9,6,7,13,6,2,0,7,15,23
18568,Elochukwu Eze,2019,2019,Southern Illinois-Edwardsville,OVC,16,168,8,16,8,16,0,0,7,10,13,18,31,2,1,9,5,12,23
18569,Jordan Faciane,2013,2015,Campbell,Big South,13,66,8,22,5,9,3,13,4,5,2,14,16,12,2,0,4,7,23
18570,Jonathan Floyd,2019,2019,Alcorn State,SWAC,2,61,8,14,3,4,5,10,2,3,3,4,7,6,5,0,2,4,23
18571,Langston Gaither,2019,2019,Howard,MEAC,8,39,7,15,6,13,1,2,8,15,2,3,5,3,2,1,6,8,23
18572,Rashad Gill,2008,2009,North Carolina-Asheville,Big South,17,87,8,32,5,15,3,17,4,11,3,8,11,6,6,1,8,12,23
18573,Kyle Gonzalez,2014,2016,Radford,Big South,24,82,8,12,6,6,2,6,5,9,5,11,16,4,3,3,8,7,23
18574,Kevin Hassett,2008,2008,Iona,MAAC,20,136,9,19,7,14,2,5,3,6,8,11,19,2,5,1,9,14,23
18575,Parker Hicks,2018,2019,Texas Tech,Big 12,25,69,7,18,4,7,3,11,6,9,3,10,13,1,2,3,3,6,23
18576,Kevin Hickson,2013,2016,Total,Total,36,145,10,18,10,18,0,0,3,9,6,13,19,0,11,5,7,38,23
18577,Jonathan Holmes,2017,2019,Arkansas,SEC,22,36,9,27,5,12,4,15,1,2,2,2,4,1,1,0,3,3,23
18578,Kyle Jacobs,2008,2008,Stephen F. Austin,Southland,25,192,8,32,8,30,0,2,7,15,10,18,28,10,2,2,12,21,23
18579,Chase Johnson,2018,2019,Florida,SEC,6,45,9,16,9,16,0,0,5,9,7,5,12,1,2,3,1,4,23
18580,Danny Johnson,2008,2008,Weber State,Big Sky,21,115,7,14,7,14,0,0,9,17,9,20,29,3,4,1,12,14,23
18581,Larry Johnson,2014,2015,Youngstown State,Horizon,26,114,8,23,8,23,0,0,7,18,8,22,30,2,5,3,5,29,23
18582,Terrence Johnson,2017,2017,James Madison,CAA,16,159,6,24,2,9,4,15,7,12,3,14,17,6,10,3,8,23,23
18583,Isaiah Jones,2018,2018,Detroit Mercy,Horizon,15,121,10,24,10,24,0,0,3,7,8,13,21,1,1,18,4,26,23
18584,Isaiah Kelly,2019,2019,Yale,Ivy,15,67,9,22,8,17,1,5,4,6,2,9,11,2,3,2,5,13,23
18585,Gavin Kensmil,2018,2018,Iona,MAAC,23,105,10,21,10,21,0,0,3,14,8,16,24,2,3,3,9,29,23
18586,Landon Kirkwood,2018,2019,Cal State Fullerton,Big West,13,92,9,18,5,7,4,11,1,1,3,6,9,4,6,0,7,14,23
18587,Josh Lester,2015,2017,Belmont,OVC,46,115,7,22,5,12,2,10,7,11,4,22,26,3,0,0,5,21,23
18588,O.J. Lewis,2013,2016,La Salle,A-10,32,62,7,22,3,15,4,7,5,12,3,3,6,3,5,1,5,4,23
18589,Merv Lindsay,2012,2014,Total,Total,33,155,10,26,8,18,2,8,1,6,3,23,26,6,2,3,3,24,23
18590,Ryan Maas,2016,2019,Western Illinois,Summit,24,95,9,28,6,17,3,11,2,3,2,11,13,2,1,0,6,3,23
18591,Mike Mathison,2011,2012,North Dakota,GWC,28,95,8,21,6,14,2,7,5,12,3,10,13,0,1,3,11,14,23
18592,Jordan McRae,2016,2018,Binghamton,AEC,28,89,11,23,11,23,0,0,1,1,3,8,11,2,2,3,3,9,23
18593,James Mongomery,2012,2014,Northwestern,Big Ten,61,197,9,35,7,15,2,20,3,13,5,14,19,10,7,6,4,30,23
18594,Pierre Mopo,2011,2014,Tennessee-Martin,OVC,62,415,9,30,9,30,0,0,5,14,35,49,84,3,7,5,19,99,23
18595,Jarvis Omersa,2019,2019,Minnesota,Big Ten,25,206,10,34,10,31,0,3,3,15,17,18,35,5,6,4,12,29,23
18596,Jordan Omogbehin,2013,2015,Total,Total,43,189,11,23,11,23,0,0,1,16,18,24,42,1,2,10,13,41,23
18597,Kyle Perricone,2010,2013,Santa Clara,WCC,27,69,8,21,2,6,6,15,1,2,4,11,15,4,1,0,3,4,23
18598,Corey Person,2010,2013,Michigan,Big Ten,35,57,8,16,6,11,2,5,5,10,3,3,6,5,0,0,5,8,23
18599,Noah Plain,2019,2019,Alcorn State,SWAC,15,84,9,17,9,15,0,2,5,6,4,6,10,0,0,2,3,13,23
18600,Quinn Price,2015,2016,Montana State,Big Sky,27,197,10,27,10,27,0,0,3,6,16,30,46,3,5,14,11,38,23
18601,John Reese,2013,2014,New Orleans,Total,26,99,9,23,5,12,4,11,1,2,2,8,10,6,2,0,4,5,23
18602,Josh Robinson,2017,2017,Southern,SWAC,8,79,8,30,1,3,7,27,0,0,0,6,6,5,3,0,5,10,23
18603,Derek Rongstad,2016,2017,Milwaukee,Horizon,18,85,8,17,4,8,4,9,3,4,9,8,17,4,4,1,4,5,23
18604,Dwayne Rose Jr.,2018,2018,Toledo,MAC,13,48,5,10,3,6,2,4,11,11,3,8,11,4,1,2,4,8,23
18605,Shea Rush,2017,2019,North Carolina,ACC,59,90,7,33,5,25,2,8,7,15,6,10,16,3,7,4,12,13,23
18606,Ameer Shamsud-din,2009,2009,Cal State Fullerton,Big West,24,176,8,33,3,13,5,20,2,6,0,12,12,20,4,1,18,16,23
18607,Kevin Shaw,2012,2014,Georgia State,Total,32,56,7,24,0,2,7,22,2,4,1,5,6,4,1,0,4,1,23
18608,Caleb Smith,2017,2017,Texas A&M,SEC,14,101,9,22,7,14,2,8,3,6,1,11,12,7,3,0,3,7,23
18609,Cory Smith,2009,2009,Southern Mississippi,CUSA,21,180,10,17,10,17,0,0,3,5,9,13,22,1,2,1,12,34,23
18610,Declan Soukup,2014,2014,Bryant,NEC,13,98,6,21,4,11,2,10,9,11,1,7,8,11,6,0,8,10,23
18611,Mario Stowers,2008,2008,Tennessee Tech,OVC,12,100,8,13,6,10,2,3,5,9,4,9,13,11,6,0,8,10,23
18612,Eric Strangis,2011,2012,Southern California,Total,30,317,9,26,6,11,3,15,2,2,2,13,15,9,5,0,6,32,23
18613,Ryan Strollo,2016,2018,Youngstown State,Horizon,31,123,8,24,1,3,7,21,0,1,2,13,15,5,4,1,5,4,23
18614,Scott Thompson,2009,2009,Santa Clara,WCC,26,122,8,16,8,16,0,0,7,14,2,20,22,3,3,7,10,14,23
18615,Randall West,2018,2019,Massachusetts,A-10,15,123,6,16,6,16,0,0,11,16,15,23,38,4,4,3,1,19,23
18616,Xavier Williams,2014,2017,Total,Total,22,113,9,23,9,20,0,3,5,9,8,18,26,3,2,4,8,22,23
18617,Avery Wilson,2018,2019,Boston College,ACC,20,76,9,19,7,14,2,5,3,10,1,5,6,4,6,1,11,6,23
18618,Zach Woolridge,2008,2008,Princeton,Ivy,11,48,8,18,6,10,2,8,5,7,4,5,9,3,2,0,1,2,23
18619,Alec Wulff,2015,2018,UCLA,Pac-12,30,58,7,15,0,1,7,14,2,2,0,1,1,5,3,0,1,3,23
18620,Jeremy Yates,2008,2008,Grambling,SWAC,17,123,11,26,11,24,0,2,1,4,2,11,13,8,2,0,10,15,23
18621,Robert Aery,2011,2012,Oral Roberts,Summit,13,49,7,29,2,7,5,22,3,4,1,2,3,3,1,0,3,4,22
18622,Charles Bargman,2015,2015,Mississippi Valley State,SWAC,19,192,6,32,0,15,6,17,4,6,7,13,20,5,12,2,9,20,22
18623,Colton Bishop,2015,2015,Loyola (MD),Patriot,28,196,7,25,5,16,2,9,6,11,4,12,16,5,4,1,9,19,22
18624,Aaron Bond,2008,2010,Davidson,Southern,13,41,8,18,2,8,6,10,0,0,1,5,6,4,1,0,4,7,22
18625,Joel Boyce,2018,2018,Coppin State,MEAC,6,75,10,18,10,16,0,2,2,5,2,10,12,3,4,0,11,8,22
18626,Harrison Brown,2008,2008,Eastern Kentucky,OVC,7,127,7,22,3,12,4,10,4,5,1,7,8,3,4,0,12,8,22
18627,Jerome Brown,2012,2012,Illinois-Chicago,Horizon,8,43,8,22,2,3,6,19,0,0,2,1,3,2,0,0,1,3,22
18628,Matt Bullock,2017,2018,Rutgers,Big Ten,11,76,9,24,9,17,0,7,4,10,7,8,15,2,1,0,5,9,22
18629,Ryan Burton,2015,2016,Indiana,Big Ten,38,126,9,13,5,6,4,7,0,1,7,13,20,4,1,0,1,18,22
18630,T.J. Carey,2008,2008,Harvard,Ivy,27,307,9,36,5,15,4,21,0,1,2,33,35,23,9,1,30,15,22
18631,Tyler Carr,2008,2008,Pepperdine,WCC,24,166,10,30,10,22,0,8,2,9,9,12,21,9,5,2,14,16,22
18632,Michael Carter III,2018,2018,Washington,Pac-12,17,126,7,28,4,15,3,13,5,8,3,7,10,7,4,3,6,8,22
18633,Stephan Collins,2010,2010,Arkansas-Pine Bluff,SWAC,29,188,9,21,7,15,2,6,2,5,7,8,15,4,2,2,12,39,22
18634,Cameron Curry,2014,2017,Boston University,Patriot,33,188,6,24,2,5,4,19,6,6,3,8,11,22,6,0,9,13,22
18635,Jamal Curry,2010,2011,Radford,Big South,16,160,8,27,8,27,0,0,6,11,13,24,37,2,3,4,12,11,22
18636,Andre' Davis,2008,2009,Southern,SWAC,27,174,8,28,8,28,0,0,6,10,17,14,31,0,4,4,14,33,22
18637,Jermaine Davis,2014,2016,Total,Total,19,101,5,14,4,12,1,2,11,17,5,16,21,2,0,1,12,17,22
18638,Luke Davis,2013,2014,Texas-Arlington,Total,22,108,8,23,2,9,6,14,0,0,5,4,9,4,2,0,1,10,22
18639,Zack Dawson,2018,2018,Oklahoma State,Big 12,5,50,7,17,5,10,2,7,6,9,0,4,4,8,0,0,8,6,22
18640,Riley Dearring,2015,2017,Total,Total,24,71,7,27,3,9,4,18,4,7,1,9,10,2,1,0,10,14,22
18641,Darryl Demp,2008,2009,Florida A&M,MEAC,42,,7,37,7,33,0,4,8,16,11,25,36,2,6,2,6,43,22
18642,Fredens Deneus,2018,2018,Alabama State,SWAC,17,78,8,21,8,21,0,0,6,13,7,10,17,3,2,1,5,10,22
18643,Kyle Desmarais,2009,2009,Central Connecticut State,NEC,17,117,9,16,7,11,2,5,2,7,4,5,9,10,5,0,10,6,22
18644,Keondre Dew,2015,2017,Total,Total,27,185,10,43,10,41,0,2,2,7,17,34,51,7,4,1,22,23,22
18645,Cole Dewey,2009,2011,Campbell,A-Sun,27,83,7,23,5,9,2,14,6,10,0,6,6,3,1,0,7,9,22
18646,Matt Elmore,2017,2019,North Carolina-Wilmington,CAA,25,92,8,20,7,13,1,7,5,6,2,11,13,0,1,2,3,18,22
18647,David Erebor,2017,2018,Brown,Ivy,25,99,9,18,9,18,0,0,4,7,12,14,26,0,6,1,7,32,22
18648,Michael Fabiyi,2013,2013,Florida A&M,MEAC,17,69,8,15,8,13,0,2,6,9,2,10,12,4,4,0,3,6,22
18649,Neville Fincher,2016,2016,Tennessee State,OVC,18,106,8,21,7,18,1,3,5,8,4,18,22,1,3,5,7,18,22
18650,Jameel Forbes,2010,2010,Grambling,SWAC,12,90,10,26,10,25,0,1,2,5,3,6,9,4,2,0,15,15,22
18651,Austin Fowler,2010,2010,Saint Francis (PA),NEC,20,131,9,31,7,23,2,8,2,2,10,5,15,6,5,0,3,21,22
18652,Grant Gelon,2017,2017,Indiana,Big Ten,12,39,7,9,4,4,3,5,5,8,2,3,5,0,1,0,1,6,22
18653,Conner George,2017,2019,Michigan State,Big Ten,44,94,8,25,8,16,0,9,6,11,8,22,30,2,4,0,5,13,22
18654,Zane Gibson,2011,2014,Middle Tennessee,Total,59,251,5,23,1,5,4,18,8,11,6,16,22,21,8,0,10,13,22
18655,Jamie Graham,2008,2009,Vanderbilt,SEC,20,74,9,15,8,11,1,4,3,3,4,7,11,5,3,0,7,10,22
18656,Patrick Gregg,2008,2008,North Carolina A&T,MEAC,8,50,10,18,10,18,0,0,2,5,4,2,6,1,1,2,1,4,22
18657,Sean Grzeck,2008,2010,Fairfield,MAAC,42,115,8,28,3,5,5,23,1,2,9,11,20,6,4,0,6,24,22
18658,Brandon Harriford,2008,2008,Austin Peay,OVC,21,92,8,14,4,4,4,10,2,3,2,9,11,2,3,0,7,12,22
18659,Jalen Harris,2012,2012,Army,Patriot,13,113,6,24,2,13,4,11,6,10,0,7,7,15,6,0,17,14,22
18660,Ian Harward,2013,2013,Brigham Young,WCC,22,89,8,24,8,24,0,0,6,9,11,10,21,1,3,2,9,29,22
18661,Simeon Henton,2018,2018,Chicago State,WAC,11,72,7,15,7,14,0,1,8,13,0,1,1,8,6,0,3,10,22
18662,Max Huc,2009,2009,Princeton,Ivy,13,96,8,18,8,16,0,2,6,8,3,5,8,2,4,0,9,11,22
18663,Idong Ibok,2008,2009,Michigan State,Big Ten,54,306,8,18,8,18,0,0,6,11,23,28,51,5,0,17,22,56,22
18664,Peace Ilegomah,2018,2019,Pittsburgh,ACC,30,165,7,11,7,11,0,0,8,17,8,21,29,4,2,8,14,51,22
18665,Marquisse Jackson,2009,2012,Mercer,A-Sun,37,130,5,15,5,11,0,4,12,16,9,7,16,4,3,0,6,25,22
18666,Shawn Jackson,2013,2013,Iona,MAAC,12,163,10,28,10,28,0,0,2,5,15,16,31,0,6,7,6,32,22
18667,Nick Jenson,2010,2010,Utah Valley,GWC,26,157,10,30,10,30,0,0,2,6,18,19,37,2,4,5,8,20,22
18668,Brandon Johns Jr,2019,2019,Michigan,Big Ten,28,115,9,18,8,15,1,3,3,4,9,20,29,1,2,3,5,15,22
18669,Darryln Johnson,2013,2013,Coppin State,MEAC,19,142,8,37,8,36,0,1,6,8,6,13,19,2,1,2,2,10,22
18670,Abby Kabba,2009,2009,New Hampshire,AEC,9,100,7,17,7,16,0,1,8,19,8,10,18,1,0,1,5,26,22
18671,Tyson Kanseyo,2016,2016,Montana State,Big Sky,26,209,7,14,7,14,0,0,8,17,17,41,58,7,2,6,20,46,22
18672,Austin Kuemper,2013,2013,Oregon,Pac-12,9,51,8,14,7,13,1,1,5,6,1,5,6,1,0,2,1,11,22
18673,Roderick Lawrence,2015,2015,Mississippi,SEC,13,105,8,26,3,12,5,14,1,3,4,13,17,10,4,1,6,9,22
18674,Leonard Livingston,2013,2013,Florida Gulf Coast,A-Sun,14,69,9,15,9,15,0,0,4,5,2,11,13,0,2,2,4,8,22
18675,Theo Livingston,2008,2008,Howard,MEAC,13,101,9,23,8,13,1,10,3,4,6,11,17,7,6,1,11,3,22
18676,Michael Manning Jr.,2018,2019,Wofford,Southern,28,113,10,21,10,21,0,0,2,6,7,14,21,4,2,5,0,12,22
18677,Issa Mase,2009,2010,Columbia,Ivy,21,80,7,18,5,12,2,6,6,12,4,13,17,4,2,2,12,19,22
18678,Dameon Mason,2008,2008,Louisiana State,SEC,7,120,9,28,9,28,0,0,4,11,5,16,21,5,5,4,5,13,22
18679,Jhery Matos,2019,2019,Dayton,A-10,6,117,8,26,7,18,1,8,5,7,4,15,19,7,4,0,4,14,22
18680,Michael Middlebrooks,2014,2014,Illinois State,MVC,4,99,10,14,10,13,0,1,2,3,10,29,39,4,4,8,4,15,22
18681,Tyler Miller,2016,2016,Prairie View,SWAC,12,135,9,23,9,23,0,0,4,10,3,16,19,4,1,3,4,18,22
18682,Jamal Mitchell,2011,2015,Total,Total,19,92,6,17,4,13,2,4,8,10,4,6,10,4,1,1,0,13,22
18683,Kris Monroe,2019,2019,Providence,Big East,20,78,7,33,3,8,4,25,4,4,3,12,15,2,1,0,3,11,22
18684,Andy Moore,2009,2011,Lafayette,Patriot,37,100,7,29,4,8,3,21,5,8,5,6,11,8,1,0,10,5,22
18685,Joey Moreau,2010,2013,Florida State,ACC,29,36,4,15,0,3,4,12,10,10,1,2,3,0,1,0,2,3,22
18686,Ian Persaud,2010,2010,Longwood,Ind,9,53,9,21,5,12,4,9,0,0,0,4,4,1,1,0,4,5,22
18687,Trey Pettus,2015,2017,Butler,Big East,21,80,8,21,5,12,3,9,3,6,1,7,8,12,3,0,3,5,22
18688,Richie Phillips,2008,2009,Nevada,WAC,37,236,10,28,10,28,0,0,2,9,12,35,47,2,5,5,25,69,22
18689,Rob Phillips,2010,2010,South Alabama,Sun Belt,20,139,9,33,5,20,4,13,0,0,1,2,3,3,1,0,8,8,22
18690,Brandon Powell,2009,2009,Marshall,CUSA,4,84,6,15,0,2,6,13,4,6,8,5,13,3,0,1,9,6,22
18691,Tom Pupavac,2018,2019,Winthrop,Big South,25,101,9,18,9,15,0,3,4,8,10,11,21,6,1,6,7,10,22
18692,Jarrod Randall,2009,2009,Maryland-Eastern Shore,MEAC,22,119,5,7,5,7,0,0,12,20,5,10,15,2,1,0,10,21,22
18693,Daniel Relvao,2017,2017,George Mason,A-10,27,187,8,20,8,20,0,0,6,9,16,28,44,3,4,10,12,37,22
18694,Josh Roberts,2019,2019,St. John's (NY),Big East,19,111,11,26,11,26,0,0,0,3,14,14,28,2,3,7,1,20,22
18695,Shawn Rouse,2008,2009,Boise State,WAC,21,115,10,28,9,22,1,6,1,3,7,4,11,8,7,0,12,18,22
18696,Kaleb Roy,2019,2019,Missouri-Kansas City,WAC,19,103,5,20,5,16,0,4,12,17,1,15,16,3,2,0,7,14,22
18697,Admir Sahbegovic,2012,2012,Jacksonville,A-Sun,24,129,7,24,6,22,1,2,7,11,9,5,14,3,6,0,12,16,22
18698,Jack Schwietz,2019,2019,Maryland-Baltimore County,AEC,14,95,8,24,4,12,4,12,2,2,2,12,14,9,6,3,6,9,22
18699,Andy Shannon,2009,2010,Pepperdine,WCC,29,221,10,28,10,28,0,0,2,2,7,34,41,3,4,19,8,31,22
18700,Nick Singleton,2018,2018,Mississippi State,SEC,9,25,9,14,5,7,4,7,0,1,2,3,5,1,0,0,2,0,22
18701,Andre Slavik,2014,2015,Idaho State,Big Sky,24,196,10,14,10,14,0,0,2,7,9,10,19,1,2,4,10,30,22
18702,Landon Slone,2009,2009,Kentucky,SEC,15,104,6,22,2,7,4,15,6,6,6,11,17,9,3,0,2,12,22
18703,Jerron Smith,2012,2012,Portland State,Big Sky,9,52,10,16,9,11,1,5,1,6,2,7,9,4,1,2,2,2,22
18704,Pearson Smith,2008,2008,Texas-El Paso,CUSA,12,63,7,16,3,8,4,8,4,6,5,4,9,4,1,0,4,11,22
18705,Klay Stall,2018,2018,Utah State,MWC,10,86,9,16,9,16,0,0,4,9,8,21,29,2,1,4,7,13,22
18706,Darius Steger,2009,2009,Coastal Carolina,Big South,20,94,8,30,7,16,1,14,5,7,5,6,11,4,1,0,12,8,22
18707,Jamarious Sykes,2011,2012,Jackson State,SWAC,18,67,8,16,8,16,0,0,6,10,4,9,13,0,0,8,3,22,22
18708,Jamar Taylor,2011,2012,Georgia State,CAA,29,126,7,16,7,16,0,0,8,12,10,22,32,0,3,7,10,19,22
18709,Bryant Thomas,2018,2018,Charlotte,CUSA,10,127,8,16,8,16,0,0,6,12,5,20,25,2,2,8,5,12,22
18710,Theo Turner,2015,2015,Seattle,WAC,18,150,9,23,9,22,0,1,4,14,10,26,36,3,4,0,15,17,22
18711,Aamahd Walker,2013,2014,UC-Santa Barbara,Big West,17,73,8,21,7,16,1,5,5,9,4,8,12,2,5,1,5,7,22
18712,Donovan Walker,2018,2018,Louisiana-Monroe,Sun Belt,16,103,8,29,4,20,4,9,2,3,2,3,5,6,5,0,10,12,22
18713,Isaiah Watkins,2014,2016,Total,Total,17,96,7,24,7,22,0,2,8,11,10,12,22,1,7,1,7,19,22
18714,Dougal Weir,2014,2016,Hartford,AEC,49,246,10,23,10,22,0,1,2,2,11,24,35,7,3,4,8,36,22
18715,Ryan Whitehead,2011,2012,Texas-San Antonio,Southland,29,140,7,27,6,18,1,9,7,8,1,12,13,15,2,1,10,12,22
18716,BillyDee Williams,2015,2015,West Virginia,Big 12,18,131,9,40,5,24,4,16,0,1,10,17,27,7,4,1,4,21,22
18717,Gerald Williams,2014,2014,Tennessee State,OVC,6,86,7,24,7,13,0,11,8,10,0,4,4,2,3,0,1,2,22
18718,Paul Williamson,2012,2012,West Virginia,Big East,20,92,7,19,0,2,7,17,1,3,2,6,8,9,1,2,2,11,22
18719,Devyn Wilson,2018,2018,Portland State,Big Sky,14,88,8,32,5,10,3,22,3,3,7,7,14,4,5,0,9,16,22
18720,Brad Woodson,2016,2019,Tennessee,SEC,22,95,6,27,2,9,4,18,6,6,3,6,9,6,3,1,2,9,22
18721,Malcolm Wynter,2017,2019,Davidson,A-10,33,66,7,18,2,4,5,14,3,5,1,1,2,5,1,0,4,7,22
18722,Cody Yelder,2008,2008,Northern Illinois,MAC,6,99,7,20,7,16,0,4,8,9,4,5,9,6,4,0,19,7,22
18723,Neven Zeravica,2008,2008,Citadel,Southern,16,54,10,12,10,12,0,0,2,3,5,10,15,2,0,3,4,9,22
18724,Aaron Alston,2013,2013,Southern,SWAC,14,99,8,14,8,13,0,1,5,13,5,15,20,2,4,2,8,9,21
18725,Jon Andersen,2009,2010,Tulane,CUSA,23,133,10,25,10,25,0,0,1,2,10,13,23,2,7,5,8,30,21
18726,Kaden Archie,2019,2019,Texas Christian,Big 12,10,101,6,25,5,14,1,11,8,13,3,12,15,0,10,2,5,12,21
18727,John Auslander,2012,2014,Maryland,ACC,27,132,7,20,6,12,1,8,6,11,2,9,11,2,2,0,8,21,21
18728,Shaquille Benson,2018,2018,Southern,SWAC,12,78,8,25,8,25,0,0,5,9,16,11,27,0,4,3,7,16,21
18729,Kevin Boyle,2014,2014,Florida Gulf Coast,A-Sun,20,106,4,19,0,4,4,15,9,10,5,6,11,8,5,0,7,20,21
18730,Colin Castleton,2019,2019,Michigan,Big Ten,19,67,9,22,9,19,0,3,3,9,8,13,21,1,1,4,5,14,21
18731,Brett Chance,2009,2009,Canisius,MAAC,8,87,8,19,5,10,3,9,2,2,2,4,6,5,4,0,7,6,21
18732,Ed Chang,2019,2019,San Diego State,MWC,13,53,6,17,0,1,6,16,3,4,2,7,9,4,1,2,5,2,21
18733,Trevon Charles,2010,2010,Sam Houston State,Southland,9,108,8,24,6,15,2,9,3,3,9,12,21,8,4,0,4,13,21
18734,Tharone Chilton,2014,2014,Middle Tennessee,CUSA,11,40,7,12,6,7,1,5,6,7,1,2,3,2,1,0,3,6,21
18735,Hans Christian Lauer,2014,2016,Illinois-Chicago,Horizon,23,84,4,14,4,10,0,4,13,16,0,14,14,0,2,0,2,14,21
18736,Quinn Clinton,2019,2019,Saint Mary's (CA),WCC,20,72,7,23,1,1,6,22,1,2,1,1,2,4,0,0,1,6,21
18737,Chuck Coley,2011,2011,Pacific,Big West,26,163,8,28,5,18,3,10,2,4,13,15,28,12,4,4,13,19,21
18738,Derek Craig,2009,2012,Georgia Tech,ACC,23,80,8,26,5,9,3,17,2,2,1,8,9,6,4,0,8,6,21
18739,Tate de Laveaga,2015,2015,Northern Arizona,Big Sky,26,138,6,27,5,13,1,14,8,10,5,9,14,4,2,0,9,23,21
18740,Jordan Dean,2008,2009,Vermont,AEC,29,60,8,15,5,12,3,3,2,2,5,7,12,2,0,0,8,5,21
18741,Jeremy Dewalt,2008,2009,Texas-Arlington,Southland,25,110,8,36,4,14,4,22,1,6,9,18,27,2,1,1,6,15,21
18742,Oludele Doherty,2008,2009,Norfolk State,MEAC,25,167,8,21,8,21,0,0,5,7,15,28,43,0,4,4,8,30,21
18743,Chris Downing,2016,2019,Fordham,A-10,31,96,9,14,9,14,0,0,3,6,8,9,17,3,3,1,3,12,21
18744,Tre Duncan,2012,2015,High Point,Big South,28,71,8,20,7,13,1,7,4,10,1,7,8,5,3,1,8,10,21
18745,Kendall Durant,2011,2011,Alabama,SEC,8,74,6,17,3,9,3,8,6,6,3,3,6,3,1,0,7,4,21
18746,Zach Durkee,2016,2017,Charleston Southern,Big South,7,26,8,12,6,9,2,3,3,4,1,2,3,3,1,1,1,1,21
18747,Melo Eggleston,2018,2018,Wake Forest,ACC,21,105,7,20,7,17,0,3,7,13,6,18,24,4,3,2,4,12,21
18748,Grant Ellis,2014,2016,Total,Total,25,82,8,24,3,6,5,18,0,0,1,5,6,3,0,1,4,13,21
18749,Austin Evans,2015,2016,Texas State,Sun Belt,23,61,7,11,7,11,0,0,7,16,3,12,15,1,0,3,4,12,21
18750,Ben Fakira,2019,2019,Utah State,MWC,15,81,7,16,6,14,1,2,6,8,15,7,22,2,1,2,7,27,21
18751,Rendijs Feikners,2017,2017,Florida Gulf Coast,A-Sun,8,42,6,9,4,5,2,4,7,8,1,4,5,5,1,0,2,4,21
18752,Danny Feldmann,2011,2014,Total,Total,34,166,10,22,9,12,1,10,0,2,4,14,18,3,3,6,9,19,21
18753,Noah Fischer,2010,2011,Marshall,CUSA,19,58,6,23,0,6,6,17,3,7,1,9,10,2,0,1,2,5,21
18754,Jordan Forehand,2017,2019,Saint Francis (PA),NEC,21,48,7,15,5,10,2,5,5,10,3,2,5,4,2,0,3,5,21
18755,Robert Frozena,2008,2011,Marquette,Big East,40,85,5,16,3,13,2,3,9,15,7,10,17,3,3,0,5,9,21
18756,Jalen Gabbidon,2019,2019,Yale,Ivy,16,128,7,20,2,6,5,14,2,4,3,19,22,5,6,0,5,21,21
18757,Beau Gibb,2008,2008,UC-Santa Barbara,Big West,29,195,7,18,7,18,0,0,7,9,9,26,35,4,3,1,12,35,21
18758,Trevor Gregory,2008,2010,Evansville,MVC,26,75,7,21,6,20,1,1,6,12,12,5,17,2,5,0,8,10,21
18759,Brian Halums,2019,2019,Mississippi,SEC,12,42,6,22,5,16,1,6,8,12,4,1,5,2,0,0,1,6,21
18760,Harrison Henderson,2017,2018,Southern California,Pac-12,24,76,7,24,5,17,2,7,5,12,3,15,18,2,2,4,3,11,21
18761,Kelvin Henry Jr.,2018,2018,McNeese State,Southland,14,95,5,16,5,13,0,3,11,15,2,6,8,9,5,1,8,11,21
18762,Phillip Henry,2013,2013,South Carolina State,MEAC,15,101,7,27,4,13,3,14,4,7,8,9,17,2,4,2,2,5,21
18763,Jacquiese Holcombe,2009,2009,Mississippi State,SEC,7,83,8,14,7,9,1,5,4,6,7,7,14,1,2,0,10,9,21
18764,Tyler Jackson,2017,2017,UC-Santa Barbara,Big West,11,76,9,15,9,15,0,0,3,6,9,17,26,0,2,2,8,17,21
18765,Jakub Jokl,2017,2018,Utah,Pac-12,24,86,7,12,7,12,0,0,7,10,7,18,25,3,0,6,6,20,21
18766,Josh Jones,2009,2010,Middle Tennessee,Sun Belt,30,93,10,21,10,21,0,0,1,8,10,8,18,3,3,3,5,15,21
18767,Kenny Jones,2012,2012,UCLA,Pac-12,9,61,8,25,7,17,1,8,4,6,2,5,7,6,3,0,5,6,21
18768,Mike Jones,2009,2011,Alabama-Birmingham,CUSA,24,69,8,24,4,12,4,12,1,2,3,3,6,2,1,0,9,11,21
18769,Stefan Kaluz,2009,2010,Brown,Ivy,11,65,8,22,8,22,0,0,5,9,6,9,15,1,2,2,1,7,21
18770,Bronson Kaufusi,2013,2013,Brigham Young,WCC,20,128,9,15,9,15,0,0,3,11,15,19,34,2,5,4,4,28,21
18771,Patrick Keim,2015,2018,Auburn,SEC,49,188,5,23,0,4,5,19,6,17,2,17,19,10,4,0,16,25,21
18772,Tim Layer,2008,2008,Liberty,Big South,16,38,6,16,1,2,5,14,4,4,2,5,7,4,1,0,5,3,21
18773,Mike Layssard,2017,2018,Rhode Island,A-10,21,60,10,22,10,21,0,1,1,2,6,14,20,2,0,2,4,8,21
18774,Cameron Lee,2008,2009,Iowa State,Big 12,45,190,8,23,7,16,1,7,4,9,3,27,30,8,11,3,5,30,21
18775,Sean Lonergan,2014,2017,Michigan,Big Ten,45,116,8,16,8,13,0,3,5,8,4,12,16,4,1,2,6,15,21
18776,Myles Luttman,2010,2011,Southern Methodist,CUSA,32,153,5,12,5,12,0,0,11,17,6,28,34,1,1,2,16,41,21
18777,Jamel Marshall,2010,2010,Morehead State,OVC,15,65,8,16,8,16,0,0,5,6,9,9,18,0,0,0,5,10,21
18778,Deyshawn Martin,2018,2018,Austin Peay,OVC,6,62,7,15,5,7,2,8,5,7,2,10,12,3,4,4,6,9,21
18779,TJ Massenburg,2019,2019,Middle Tennessee,CUSA,26,138,8,16,8,16,0,0,5,10,12,20,32,2,1,8,7,13,21
18780,A.J. Mathew,2012,2013,Toledo,MAC,39,235,7,23,3,12,4,11,3,5,6,15,21,13,13,0,6,21,21
18781,Thurston McCarty,2019,2019,Cornell,Ivy,16,69,8,23,4,8,4,15,1,3,2,10,12,0,0,4,6,7,21
18782,Dwight McCombs,2008,2008,Miami (OH),MAC,28,203,7,16,7,16,0,0,7,20,20,16,36,2,5,8,14,34,21
18783,Rashano McRae,2011,2011,Eastern Washington,Big Sky,23,175,6,19,6,19,0,0,9,23,14,15,29,6,5,2,11,42,21
18784,Walker Miller,2018,2019,North Carolina,ACC,39,59,9,19,9,19,0,0,3,6,2,12,14,5,1,3,2,4,21
18785,Brandon Moore,2008,2008,Maryland-Eastern Shore,MEAC,24,286,7,18,7,18,0,0,7,9,18,42,60,5,2,6,11,67,21
18786,Damarri Moore,2019,2019,Tennessee State,OVC,14,204,8,26,8,24,0,2,5,11,8,27,35,17,7,8,24,18,21
18787,Jaime Morgan,2009,2009,Prairie View,SWAC,7,42,9,14,6,7,3,7,0,0,5,2,7,4,2,0,1,6,21
18788,Josh Morgan,2013,2014,Colorado State,MWC,21,49,8,17,5,7,3,10,2,4,0,2,2,2,2,0,4,4,21
18789,David Murray,2010,2010,Middle Tennessee,Sun Belt,18,53,9,23,9,20,0,3,3,4,2,9,11,2,2,2,2,5,21
18790,Boe Nguidjol,2019,2019,Detroit Mercy,Horizon,20,126,8,15,8,15,0,0,5,9,14,23,37,1,8,3,6,25,21
18791,David O'Shaughnessey,2010,2011,Mercer,A-Sun,35,135,6,29,4,6,2,23,7,16,6,8,14,9,5,0,8,25,21
18792,Giovanni Olomo,2008,2008,Binghamton,AEC,18,187,6,16,6,16,0,0,9,15,19,17,36,4,6,3,8,37,21
18793,Stephen Osu,2015,2018,Presbyterian,Big South,29,82,8,21,8,21,0,0,5,14,17,13,30,2,1,0,6,11,21
18794,Grant Pelchen,2014,2014,Florida Atlantic,CUSA,20,131,9,19,9,19,0,0,3,10,12,16,28,10,2,14,2,28,21
18795,Randell Pickett,2017,2017,Maryland-Eastern Shore,MEAC,11,62,7,23,3,7,4,16,3,5,3,6,9,0,2,0,0,2,21
18796,Nick Quick,2008,2009,UC-Santa Barbara,Big West,23,54,7,22,2,7,5,15,2,3,2,2,4,3,2,0,4,11,21
18797,Giir Ring,2019,2019,Coppin State,MEAC,12,69,7,29,4,7,3,22,4,7,5,7,12,2,3,1,6,10,21
18798,Jason Rogers,2008,2008,Stephen F. Austin,Southland,20,79,6,19,0,1,6,18,3,4,0,6,6,1,2,0,1,4,21
18799,Obi Romeo,2015,2017,Total,Total,24,148,7,13,7,13,0,0,7,18,15,25,40,2,3,9,4,23,21
18800,John Sanders,2016,2016,Mississippi Valley State,SWAC,16,132,8,19,5,12,3,7,2,2,3,7,10,6,3,0,8,17,21
18801,Skylar Scrivano,2013,2013,Columbia,Ivy,11,82,9,18,9,18,0,0,3,6,8,9,17,0,0,0,8,17,21
18802,Martin Shaw,2013,2016,Old Dominion,Total,47,102,7,32,7,25,0,7,7,10,0,3,3,5,2,2,8,22,21
18803,Derek Shoecraft,2009,2009,Tennessee State,OVC,15,57,8,21,7,14,1,7,4,8,6,5,11,2,3,0,4,9,21
18804,Dwayne Sims,2011,2011,North Carolina Central,Ind,24,104,7,22,2,6,5,16,2,3,3,10,13,0,4,2,1,8,21
18805,Randall Smith,2015,2015,Jacksonville State,OVC,15,86,5,17,3,10,2,7,9,10,1,6,7,6,2,1,11,14,21
18806,Atiba Taylor,2019,2019,Youngstown State,Horizon,12,61,5,14,5,12,0,2,11,16,0,7,7,8,1,0,12,6,21
18807,Jonathan Thomas,2012,2012,Maryland,ACC,18,95,7,20,3,7,4,13,3,7,1,1,2,4,2,1,10,10,21
18808,Daniel Trepanier,2008,2009,Columbia,Ivy,25,75,7,26,3,7,4,19,3,6,2,7,9,2,3,0,9,11,21
18809,Bryant Wallace,2008,2008,Coastal Carolina,Big South,13,78,10,17,10,17,0,0,1,6,5,10,15,3,1,4,4,11,21
18810,Mike Washington,2013,2016,Princeton,Ivy,46,113,10,32,9,18,1,14,0,3,2,18,20,9,2,0,10,8,21
18811,Ben Whitlatch,2011,2014,William & Mary,CAA,26,56,7,20,1,5,6,15,1,2,1,0,1,0,2,0,1,0,21
18812,Chasen Wiilliamson,2014,2014,Central Arkansas,Southland,18,106,6,24,5,15,1,9,8,13,7,4,11,6,5,0,4,9,21
18813,Alan Wisniewski,2012,2015,Penn State,Big Ten,48,151,7,11,7,11,0,0,7,15,13,20,33,2,0,7,5,34,21
18814,Kyle Witek,2008,2008,High Point,Big South,12,42,8,14,3,4,5,10,0,3,0,2,2,6,0,0,3,1,21
18815,Mandrell Worthy,2017,2017,Montana State,Big Sky,16,150,7,27,6,18,1,9,6,11,13,9,22,9,7,4,10,16,21
18816,Joe Aase,2014,2014,Davidson,Southern,24,152,8,24,5,13,3,11,1,2,3,20,23,4,3,3,4,31,20
18817,Evan Anderson,2012,2014,Wisconsin,Big Ten,40,109,9,19,8,13,1,6,1,5,4,8,12,6,1,3,6,29,20
18818,Kirk Archibeque,2008,2008,Northern Colorado,Big Sky,4,71,9,18,9,18,0,0,2,5,7,12,19,2,0,1,3,10,20
18819,David Arnold,2010,2011,Northern Colorado,Big Sky,31,176,5,23,2,12,3,11,7,10,1,15,16,21,4,1,26,29,20
18820,Kelly Assibesi,2012,2013,Liberty,Big South,36,170,5,18,2,8,3,10,7,10,0,5,5,20,4,0,13,17,20
18821,Thomas Blake,2014,2017,North Dakota,Big Sky,32,90,7,27,5,12,2,15,4,8,5,17,22,8,4,0,8,8,20
18822,Bjorn Bohley,2008,2008,Savannah State,Ind,21,165,8,18,8,18,0,0,4,9,4,16,20,6,7,5,10,28,20
18823,Jerrell Boswell,2010,2010,Maine,AEC,11,40,6,22,3,3,3,19,5,5,1,4,5,6,4,0,1,4,20
18824,Matt Boswell,2008,2008,High Point,Big South,19,84,9,18,7,14,2,4,0,1,4,18,22,3,2,1,2,12,20
18825,Daniel Brady,2009,2010,Missouri-Kansas City,Summit,34,227,9,19,9,19,0,0,2,6,18,25,43,10,5,2,14,45,20
18826,Reece Brooks,2019,2019,Albany (NY),AEC,15,92,6,31,3,7,3,24,5,6,3,5,8,5,0,0,10,9,20
18827,Kahmell Broughton,2010,2010,Houston,CUSA,19,141,8,12,8,12,0,0,4,6,13,11,24,2,5,2,3,29,20
18828,Jared Carter,2008,2009,Kentucky,SEC,22,79,7,16,7,16,0,0,6,8,3,13,16,5,1,8,9,15,20
18829,Jess Chadwell,2011,2011,Toledo,MAC,21,134,6,16,5,9,1,7,7,12,7,14,21,9,5,0,11,10,20
18830,Conrad Chambers,2015,2015,Morgan State,MEAC,14,65,6,22,3,13,3,9,5,8,3,4,7,9,0,0,10,10,20
18831,Kennedy Chukwuocha,2014,2014,Massachusetts-Lowell,AEC,14,171,7,19,7,18,0,1,6,11,9,14,23,3,4,3,15,39,20
18832,Grayson Clark,2014,2015,Georgia Southern,Total,17,52,7,18,3,10,4,8,2,4,5,10,15,1,1,0,3,6,20
18833,Eric Coblentz,2009,2009,Akron,MAC,13,61,7,18,3,5,4,13,2,5,3,5,8,5,2,0,1,8,20
18834,Rai Colston,2008,2008,Cal State Northridge,Big West,24,179,8,24,7,17,1,7,3,6,1,14,15,20,6,0,27,14,20
18835,Garrett Constance,2010,2010,Wagner,NEC,18,98,6,23,3,7,3,16,5,7,8,2,10,1,0,0,3,14,20
18836,Marko Coudreau,2019,2019,North Dakota,Summit,18,118,6,27,3,14,3,13,5,7,5,11,16,5,3,0,10,17,20
18837,Anthony Crump,2019,2019,Middle Tennessee,CUSA,9,155,8,25,8,23,0,2,4,10,0,22,22,11,2,0,19,23,20
18838,Des Curry,2016,2018,Jacksonville State,OVC,26,86,7,22,7,17,0,5,6,9,2,1,3,6,2,0,3,5,20
18839,Brandon Davis,2018,2018,UC-Santa Barbara,Big West,28,189,7,19,5,13,2,6,4,9,1,16,17,22,7,0,15,22,20
18840,Jamaal Day,2009,2009,South Carolina State,MEAC,9,87,7,19,6,18,1,1,5,7,7,8,15,9,4,0,7,7,20
18841,Sam de Haas,2011,2011,St. Bonaventure,A-10,22,129,8,31,4,7,4,24,0,2,4,5,9,10,0,1,7,18,20
18842,Justin Dueck,2013,2015,UC-Davis,Big West,28,272,8,16,8,16,0,0,4,12,23,17,40,4,3,7,10,54,20
18843,William Eddie,2009,2009,Central Michigan,MAC,25,207,9,28,8,27,1,1,1,2,2,10,12,8,4,0,24,33,20
18844,Mohamed Esseghir,2008,2008,South Florida,Big East,25,177,7,14,7,14,0,0,6,9,14,23,37,9,2,13,10,32,20
18845,Buford Foote,2009,2010,Morgan State,MEAC,37,119,7,17,7,17,0,0,6,12,11,14,25,0,2,6,7,23,20
18846,Deng Gak,2019,2019,Miami (FL),ACC,8,117,8,24,8,23,0,1,4,10,16,17,33,5,1,9,3,15,20
18847,Connor Garner,2017,2017,Utah State,MWC,6,44,7,13,1,1,6,12,0,0,2,8,10,4,2,0,4,4,20
18848,John Gilliam,2012,2012,UC-Riverside,Big West,16,102,7,26,6,13,1,13,5,8,1,10,11,2,3,0,6,0,20
18849,Stephen Gossard,2012,2014,Wright State,Horizon,21,48,8,9,8,9,0,0,4,6,4,1,5,0,1,1,1,6,20
18850,Mason Green,2018,2018,Mercer,Southern,16,58,8,11,8,11,0,0,4,7,7,4,11,1,2,3,5,9,20
18851,Trey Guidry,2013,2013,San Diego,WCC,14,67,6,17,5,12,1,5,7,14,4,4,8,1,2,2,4,8,20
18852,Kenan Guzonjic,2016,2016,Colorado,Pac-12,13,53,7,19,5,15,2,4,4,7,6,8,14,1,0,1,6,9,20
18853,Quincy Hall,2008,2009,Grambling,SWAC,16,71,7,24,1,5,6,19,0,0,4,3,7,2,1,0,5,6,20
18854,Will Hamilton,2009,2009,Eastern Illinois,OVC,17,71,7,23,4,14,3,9,3,4,0,5,5,6,2,1,2,9,20
18855,Brandon Harris,2009,2009,Centenary (LA),Summit,20,,9,19,9,19,0,0,2,5,,,18,2,1,8,14,,20
18856,Bruce Haynes,2012,2013,South Carolina Upstate,A-Sun,12,44,6,15,1,1,5,14,3,4,0,2,2,3,2,0,1,1,20
18857,Parker Hazen,2018,2018,Valparaiso,MVC,21,175,6,20,6,14,0,6,8,14,8,17,25,4,1,1,19,22,20
18858,John Hegarty,2009,2009,Portland,WCC,7,54,7,17,7,17,0,0,6,11,3,4,7,1,0,3,4,11,20
18859,Adam Howard,2008,2008,Western Kentucky,Sun Belt,16,37,4,13,2,5,2,8,10,14,0,1,1,2,1,0,5,1,20
18860,Rob Huntington,2009,2009,High Point,Big South,17,80,9,11,9,11,0,0,2,4,6,10,16,1,1,1,10,13,20
18861,Tomas Janusauskas,2008,2008,Austin Peay,OVC,23,71,6,13,6,13,0,0,8,14,4,13,17,1,1,5,3,4,20
18862,Brandon Jones,2008,2008,Alabama State,SWAC,17,79,8,20,8,19,0,1,4,6,6,10,16,0,2,1,4,18,20
18863,Deshawn Jones,2017,2017,Jacksonville State,OVC,17,110,7,20,7,16,0,4,6,10,1,7,8,8,2,1,14,3,20
18864,Brandon Jordan,2016,2017,Savannah State,MEAC,18,144,7,13,7,13,0,0,6,11,9,18,27,2,1,5,7,24,20
18865,Alassane Kah,2017,2017,Old Dominion,CUSA,13,42,9,14,8,11,1,3,1,4,4,10,14,1,1,3,1,13,20
18866,Austin Katstra,2018,2019,Virginia,ACC,21,48,8,17,5,6,3,11,1,2,1,10,11,3,1,1,2,5,20
18867,Cal Kennedy,2015,2016,Loyola (IL),MVC,21,44,9,16,7,10,2,6,0,0,6,7,13,0,0,1,2,5,20
18868,Eric Kindler,2011,2014,Total,Total,25,84,6,29,3,9,3,20,5,9,3,5,8,7,3,0,7,3,20
18869,Trey Knight III,2017,2018,Indiana State,MVC,27,196,6,20,4,13,2,7,6,11,3,15,18,11,9,2,10,31,20
18870,Seydou Kone,2008,2008,Florida Atlantic,Sun Belt,10,62,8,20,8,20,0,0,4,7,5,8,13,0,1,0,8,9,20
18871,Logan Lancon,2009,2010,Texas Christian,MWC,31,152,7,32,5,14,2,18,4,6,7,18,25,4,4,0,4,23,20
18872,Coby Leavitt,2008,2008,Cal Poly,Big West,16,94,9,20,9,16,0,4,2,8,4,19,23,4,5,6,11,11,20
18873,Majur Majak,2019,2019,Saint Peter's,MAAC,22,136,8,14,8,14,0,0,4,6,7,19,26,1,3,13,11,28,20
18874,Terrel Martin-Garcia,2017,2017,Albany (NY),AEC,12,40,8,13,7,11,1,2,3,4,2,8,10,0,1,0,5,6,20
18875,Trayvond Massenburg,2017,2017,Chattanooga,Southern,17,81,9,17,9,17,0,0,2,7,8,15,23,1,4,4,4,15,20
18876,David Maynard,2018,2018,Colgate,Patriot,7,44,7,9,3,5,4,4,2,2,2,4,6,0,2,0,2,3,20
18877,Pierson McAtee,2017,2019,Kansas State,Big 12,39,76,6,14,2,5,4,9,4,8,4,16,20,1,0,1,3,3,20
18878,Will McConnell,2012,2013,Dartmouth,Ivy,21,38,7,10,2,2,5,8,1,2,3,2,5,0,0,1,1,3,20
18879,Chance McGrady,2008,2009,Memphis,CUSA,30,85,6,10,6,10,0,0,8,15,7,11,18,8,1,0,6,7,20
18880,Luke Mergerson,2012,2012,Texas State,Southland,9,73,5,14,5,14,0,0,10,14,6,14,20,2,2,1,1,7,20
18881,Dominique Miller,2013,2013,Alabama State,SWAC,11,75,9,21,9,16,0,5,2,12,4,8,12,1,0,0,4,6,20
18882,Milos Milosevic,2010,2010,Valparaiso,Horizon,17,96,8,17,8,16,0,1,4,6,5,12,17,5,1,1,9,21,20
18883,Lawrence Mosley,2019,2019,Middle Tennessee,CUSA,22,114,9,13,8,9,1,4,1,2,5,25,30,6,2,3,5,15,20
18884,Skyler Nash,2018,2019,Vermont,AEC,11,94,7,25,1,6,6,19,0,0,2,7,9,4,1,0,6,6,20
18885,Rawane Ndiaye,2014,2014,Tennessee,SEC,22,71,8,18,8,18,0,0,4,8,15,6,21,0,0,2,8,11,20
18886,Devin Newsome,2015,2016,Omaha,Summit,39,234,7,32,3,17,4,15,2,6,6,16,22,21,6,0,13,17,20
18887,Chris Orozco,2013,2013,New Hampshire,AEC,20,232,2,27,1,18,1,9,15,21,10,26,36,11,5,0,16,26,20
18888,Jalen Packer,2012,2012,Western Illinois,Summit,19,138,6,12,6,10,0,2,8,9,1,11,12,23,6,0,14,10,20
18889,Kobe Paras,2017,2017,Creighton,Big East,15,70,8,22,6,12,2,10,2,7,4,11,15,3,2,1,4,11,20
18890,Cory Parker,2010,2012,Drake,MVC,42,148,7,14,6,10,1,4,5,11,4,10,14,4,4,1,3,19,20
18891,Michael Phillip,2015,2015,Florida International,CUSA,33,194,7,13,7,13,0,0,6,15,13,19,32,6,0,12,3,50,20
18892,DeMarcus Phillips,2011,2011,Iowa State,Big 12,8,77,8,23,8,17,0,6,4,7,9,10,19,4,2,0,4,5,20
18893,Jacob Ranger,2010,2010,UC-Davis,Big West,15,102,8,19,8,16,0,3,4,11,4,7,11,1,2,2,9,17,20
18894,Dillon Reppart,2017,2018,East Tennessee State,Southern,16,45,5,13,1,5,4,8,6,11,6,3,9,4,2,0,2,6,20
18895,Chase Robinson,2009,2010,Duquesne,A-10,22,97,7,25,3,11,4,14,2,2,1,8,9,4,2,0,5,13,20
18896,Patrick Rooks,2015,2015,Clemson,ACC,13,52,6,22,0,3,6,19,2,5,0,3,3,6,3,0,0,6,20
18897,Bassel Sabliba Jr.,2019,2019,Fairleigh Dickinson,NEC,20,101,8,23,4,13,4,10,0,0,3,6,9,6,3,0,7,16,20
18898,Michael Saxton,2015,2016,Florida State,ACC,14,34,8,17,4,7,4,10,0,0,4,7,11,0,1,0,1,2,20
18899,Junior Searcy,2016,2016,Northern Arizona,Big Sky,6,55,7,12,6,10,1,2,5,6,4,6,10,1,0,1,2,5,20
18900,Brian Smith,2018,2019,Portland,WCC,12,51,7,20,4,11,3,9,3,7,0,3,3,7,0,0,5,6,20
18901,Jerret Smith,2008,2008,Michigan,Big Ten,5,66,6,10,2,4,4,6,4,4,0,10,10,6,2,1,6,9,20
18902,Wquinton Smith,2008,2011,Wisconsin,Big Ten,44,160,8,24,7,19,1,5,3,9,9,5,14,13,6,0,8,16,20
18903,Jayson Snearl,2015,2015,Florida A&M,MEAC,25,196,9,24,9,24,0,0,2,2,10,23,33,1,3,1,8,33,20
18904,Jalen Stephens-Holmes,2018,2018,Chicago State,WAC,8,84,9,19,9,18,0,1,2,5,12,12,24,3,2,5,6,16,20
18905,Kyle Swanier,2009,2010,Jackson State,SWAC,22,61,4,18,0,4,4,14,8,12,2,3,5,0,1,1,5,1,20
18906,Morgan Tilford,2013,2013,Cal State Northridge,Big West,15,122,8,18,8,18,0,0,4,9,7,20,27,2,6,2,6,13,20
18907,Abel Tillman,2011,2011,Southern Illinois-Edwardsville,Ind,7,95,10,26,10,26,0,0,0,5,8,14,22,3,3,10,8,27,20
18908,Luke Tolliver,2019,2019,Western Michigan,MAC,11,42,3,11,0,1,3,10,11,11,0,3,3,1,2,1,2,3,20
18909,Mike Vandello,2008,2008,Illinois State,MVC,12,86,5,18,4,15,1,3,9,12,10,8,18,8,0,1,5,14,20
18910,Floris Versteeg,2014,2014,Cal State Fullerton,Big West,15,106,6,21,2,4,4,17,4,6,3,13,16,0,1,0,5,7,20
18911,Calvin Walker,2011,2011,Texas-Rio Grande Valley,GWC,20,93,9,17,9,17,0,0,2,3,3,18,21,3,0,3,5,15,20
18912,Jermaine Washington,2008,2008,Central Connecticut State,NEC,13,48,4,8,2,4,2,4,10,10,0,4,4,3,1,0,3,1,20
18913,James West IV,2018,2019,Mount St. Mary's,NEC,21,107,4,23,0,6,4,17,8,11,1,11,12,7,4,1,8,7,20
18914,Donald Williams,2011,2011,Mississippi,SEC,9,34,8,15,4,7,4,8,0,0,4,1,5,0,1,0,4,3,20
18915,Tanner Williams,2013,2013,Loyola (IL),Horizon,3,32,9,14,9,14,0,0,2,4,4,3,7,4,2,0,2,4,20
18916,Austin Witherill,2015,2018,Arizona State,Pac-12,47,88,5,19,0,2,5,17,5,6,2,8,10,1,0,0,1,1,20
18917,Adam Wolf,2016,2019,Missouri,SEC,25,62,8,18,4,8,4,10,0,0,4,7,11,0,3,2,0,6,20
18918,Yusef Yakubu,2017,2017,Prairie View,SWAC,19,189,9,14,9,13,0,1,2,7,16,24,40,2,4,4,11,43,20
18919,Aitor Zubizarreta,2014,2015,Portland,WCC,32,169,7,21,6,10,1,11,5,7,4,12,16,19,11,0,20,29,20
18920,A.J. Atkinson,2009,2012,Davidson,Southern,44,91,7,16,5,8,2,8,3,5,4,12,16,2,0,0,3,11,19
18921,Aaron Austin,2009,2009,Radford,Big South,12,101,5,16,5,12,0,4,9,14,3,10,13,13,6,1,13,14,19
18922,De Andre' Austin,2018,2019,Bowling Green State,MAC,18,49,5,10,4,9,1,1,8,9,1,7,8,4,4,0,3,4,19
18923,Rem Bakamus,2013,2017,Gonzaga,WCC,49,97,4,17,1,2,3,15,8,13,2,14,16,6,6,0,5,12,19
18924,Deon Baker,2018,2018,Saint Francis (PA),NEC,12,51,9,19,9,19,0,0,1,1,5,6,11,2,2,0,5,4,19
18925,Colt Barnhill,2012,2012,Air Force,MWC,17,89,6,23,5,18,1,5,6,12,6,15,21,5,6,3,3,10,19
18926,Staats Battle,2012,2015,North Carolina State,ACC,24,39,7,25,2,2,5,23,0,3,3,8,11,2,0,0,1,5,19
18927,Dominique Behonh-Tolly,2012,2013,North Carolina A&T,MEAC,19,75,6,12,6,12,0,0,7,13,9,9,18,2,1,2,4,5,19
18928,Randall Black,2013,2013,South Carolina State,MEAC,7,110,6,31,3,15,3,16,4,8,3,12,15,3,0,0,10,12,19
18929,Adam Brakeville,2010,2012,Air Force,MWC,41,138,7,14,7,14,0,0,5,7,8,15,23,4,3,2,6,37,19
18930,Peter Bunn,2008,2008,Oakland,Summit,18,53,7,20,5,12,2,8,3,8,0,2,2,1,7,0,6,10,19
18931,Cortell Busby,2014,2014,IUPUI,Summit,16,94,5,18,5,15,0,3,9,11,1,7,8,8,2,0,9,7,19
18932,M.J. Cage,2018,2018,Oregon,Pac-12,11,71,8,13,7,12,1,1,2,4,9,15,24,2,0,1,3,7,19
18933,Tobias Cameron,2019,2019,Abilene Christian,Southland,24,86,7,17,4,6,3,11,2,3,7,11,18,5,2,0,8,7,19
18934,Jake Campbell,2013,2015,Presbyterian,Big South,42,229,7,17,7,17,0,0,5,9,4,21,25,4,2,0,9,29,19
18935,Grant Carter,2008,2008,Army,Patriot,19,97,6,28,0,1,6,27,1,2,2,8,10,8,0,1,4,9,19
18936,Jared Collins,2008,2008,Georgia Southern,Southern,11,53,7,16,3,8,4,8,1,1,5,7,12,2,1,1,7,8,19
18937,Akiem Daschner,2019,2019,Texas State,Sun Belt,16,143,6,23,3,13,3,10,4,11,8,23,31,8,6,1,9,10,19
18938,Nick DeSchepper,2010,2011,IUPUI,Summit,27,135,3,21,1,6,2,15,11,16,3,6,9,18,7,2,13,12,19
18939,Marial Dhal,2011,2012,Canisius,MAAC,36,155,9,12,9,12,0,0,1,3,7,17,24,2,0,15,16,20,19
18940,Logan Doyle,2015,2016,South Dakota State,Summit,14,44,5,13,5,12,0,1,9,12,4,16,20,2,1,2,2,4,19
18941,Daniel Edwards,2011,2015,Princeton,Ivy,33,62,7,16,5,12,2,4,3,8,8,9,17,1,2,0,9,7,19
18942,Takiula Fahrensohn,2019,2019,Portland,WCC,15,81,5,21,2,5,3,16,6,9,1,9,10,4,4,0,4,7,19
18943,Niksha Federico,2014,2016,San Diego State,MWC,16,30,7,18,2,3,5,15,0,0,1,4,5,2,1,1,0,3,19
18944,J.T. Flowers,2014,2014,Yale,Ivy,10,63,7,18,4,11,3,7,2,8,3,7,10,1,1,1,1,2,19
18945,Greg Foster Jr,2019,2019,Gonzaga,WCC,28,129,7,25,5,11,2,14,3,8,1,10,11,12,4,1,9,11,19
18946,Mike Gabriel,2011,2011,Quinnipiac,NEC,7,58,7,16,7,16,0,0,5,10,6,6,12,1,1,0,2,12,19
18947,DeAndre Gholston,2019,2019,Kent State,MAC,15,62,7,17,7,13,0,4,5,7,7,5,12,2,4,1,7,11,19
18948,Tanner Gibson,2012,2012,Albany (NY),AEC,24,122,6,14,5,9,1,5,6,9,0,7,7,8,5,1,2,10,19
18949,Brenden Glapion,2015,2016,University of California,Pac-12,18,36,4,13,4,11,0,2,11,15,1,1,2,2,0,0,2,5,19
18950,Nick Goff,2010,2013,Total,Total,29,46,5,16,2,5,3,11,6,7,3,5,8,6,1,0,4,3,19
18951,Erik Harris,2008,2009,Siena,MAAC,28,98,8,17,8,17,0,0,3,6,15,12,27,0,3,6,8,11,19
18952,Justin Hemsley,2019,2019,Hawaii,Big West,15,33,4,9,1,5,3,4,8,11,2,5,7,0,3,0,0,8,19
18953,Jarrad Henry,2008,2008,Pepperdine,WCC,7,65,6,13,6,13,0,0,7,14,5,4,9,0,4,6,6,10,19
18954,Jaylen Henry,2011,2012,Eastern Washington,Big Sky,28,160,8,24,8,22,0,2,3,6,20,24,44,2,2,2,6,19,19
18955,Sam Hershberger,2013,2016,Elon,Total,22,49,4,11,3,4,1,7,10,11,2,6,8,6,1,0,1,9,19
18956,Rasool Hinson,2017,2017,Coppin State,MEAC,13,88,7,23,6,19,1,4,4,8,7,6,13,4,6,0,9,11,19
18957,Jaxon Holden,2015,2015,Stephen F. Austin,Southland,17,67,4,14,0,5,4,9,7,7,0,3,3,1,1,0,4,12,19
18958,Joe Hughes,2008,2011,Xavier,A-10,40,99,7,16,5,8,2,8,3,6,7,11,18,7,4,2,6,11,19
18959,Travis Ingram,2018,2018,Towson,CAA,13,105,8,20,6,14,2,6,1,2,11,11,22,9,2,0,4,7,19
18960,Otas Iyekekpolor,2015,2016,Central Arkansas,Southland,24,149,5,16,3,11,2,5,7,12,5,11,16,3,1,8,11,28,19
18961,Donovan Jones,2009,2009,North Carolina-Asheville,Big South,9,103,7,20,4,12,3,8,2,10,6,11,17,12,5,2,13,15,19
18962,Jalen King,2018,2019,Eastern Michigan,MAC,39,209,8,14,8,14,0,0,3,8,13,24,37,6,9,13,10,45,19
18963,Kristian Lafayette,2019,2019,Louisiana,Sun Belt,11,42,8,12,5,7,3,5,0,0,2,11,13,2,0,0,3,5,19
18964,Gene Langan,2015,2016,Furman,Southern,17,45,7,13,7,12,0,1,5,6,7,9,16,0,0,0,3,4,19
18965,Phillip Lockhart,2008,2008,Jackson State,SWAC,19,118,5,23,4,16,1,7,8,14,2,14,16,8,3,0,17,8,19
18966,Kaleb Mallory,2014,2017,Ball State,MAC,26,142,7,24,6,16,1,8,4,10,1,5,6,18,6,1,9,9,19
18967,Dezmond McDaniel,2017,2017,Oral Roberts,Summit,17,109,7,23,3,15,4,8,1,2,0,12,12,10,3,0,3,5,19
18968,Jarrod McDaniel,2009,2009,Stephen F. Austin,Southland,15,138,5,12,4,8,1,4,8,20,1,11,12,23,7,1,9,14,19
18969,Geremy McKay,2015,2017,Total,Total,11,51,6,9,6,9,0,0,7,13,10,5,15,0,1,1,2,8,19
18970,Collin McManus,2016,2018,Pennsylvania,Ivy,29,60,8,13,8,13,0,0,3,4,6,8,14,2,0,3,2,4,19
18971,Imani Miller,2016,2017,Hampton,MEAC,42,282,5,17,4,16,1,1,8,16,8,18,26,28,11,0,20,32,19
18972,Jon Miller,2009,2010,Texas-Arlington,Southland,11,77,6,19,5,10,1,9,6,8,5,5,10,1,4,0,6,13,19
18973,Andrija Milovanovic,2014,2016,McNeese State,Southland,22,79,5,19,0,5,5,14,4,4,6,8,14,3,0,0,2,6,19
18974,Taylor Morrow,2008,2008,Evansville,MVC,17,126,9,23,9,21,0,2,1,2,1,8,9,10,4,0,7,5,19
18975,Karl Moton,2010,2014,Alabama-Birmingham,CUSA,29,49,7,12,3,4,4,8,1,2,1,5,6,3,1,0,1,6,19
18976,Fabio Nass,2008,2008,Miami (FL),ACC,9,57,7,10,7,9,0,1,5,7,5,10,15,4,3,4,5,6,19
18977,Derrius Nelson,2012,2012,Arkansas-Pine Bluff,SWAC,16,98,6,16,2,3,4,13,3,4,2,3,5,6,1,0,7,7,19
18978,Josh Noble,2010,2010,Weber State,Big Sky,21,100,7,22,5,14,2,8,3,5,2,10,12,12,2,0,7,1,19
18979,Levi Noel,2011,2011,Eastern Illinois,OVC,18,148,5,23,3,17,2,6,7,10,6,8,14,3,3,0,10,16,19
18980,Emmenle Preston,2009,2009,Mississippi Valley State,SWAC,15,175,7,26,7,26,0,0,5,18,11,11,22,1,4,1,16,40,19
18981,Peter Prowitt,2008,2008,Stanford,Pac-10,15,95,7,15,7,15,0,0,5,15,7,8,15,6,0,2,6,17,19
18982,Jacob Redding,2018,2019,Louisville,ACC,13,25,6,8,1,1,5,7,2,2,1,2,3,0,0,0,0,1,19
18983,Anthony Robinson,2008,2008,McNeese State,Southland,13,43,7,16,5,11,2,5,3,5,2,7,9,1,4,0,4,6,19
18984,Austin Seferian-Jenkins,2012,2012,Washington,Pac-12,17,122,8,21,8,21,0,0,3,8,13,23,36,1,3,2,1,38,19
18985,Tyler Self,2013,2017,Kansas,Big 12,45,95,7,26,4,11,3,15,2,4,2,6,8,12,1,0,20,10,19
18986,Josh Seligson,2011,2013,North Carolina-Asheville,Big South,25,70,7,18,7,14,0,4,5,8,2,8,10,3,7,5,9,16,19
18987,Matt Simpkins,2009,2009,Memphis,CUSA,14,81,8,17,8,17,0,0,3,12,7,14,21,0,5,6,6,28,19
18988,Jalen Slawson,2019,2019,Furman,Southern,26,155,8,22,6,10,2,12,1,4,8,30,38,6,13,13,8,31,19
18989,Darius Smith,2010,2010,Connecticut,Big East,19,85,5,12,4,10,1,2,8,15,6,5,11,6,4,1,9,13,19
18990,JaQuan Smith,2016,2016,Stephen F. Austin,Southland,17,45,8,20,8,20,0,0,3,8,6,10,16,1,2,3,3,7,19
18991,Jermaine Smith,2009,2009,Cal State Northridge,Big West,16,128,6,19,5,17,1,2,6,12,8,23,31,6,2,11,9,23,19
18992,Trevor Spoja,2017,2018,Montana,Big Sky,26,76,6,24,2,5,4,19,3,6,1,2,3,4,0,1,4,11,19
18993,Daivon Stephens,2019,2019,Eastern Michigan,MAC,15,87,8,17,7,10,1,7,2,6,3,9,12,5,4,3,7,5,19
18994,Maurice Taylor,2014,2014,North Carolina A&T,MEAC,26,194,4,22,4,16,0,6,11,23,20,30,50,13,7,6,23,38,19
18995,Anthony Thomas,2008,2008,Howard,MEAC,25,218,7,36,7,23,0,13,5,9,12,15,27,10,3,5,26,20,19
18996,Rashard Todd,2016,2016,Cal State Fullerton,Big West,6,43,7,15,4,6,3,9,2,3,3,5,8,1,3,1,2,4,19
18997,Garrett Ton,2009,2012,San Jose State,WAC,48,153,6,15,6,15,0,0,7,8,9,22,31,5,5,1,4,26,19
18998,Nathan Townsen Jr.,2018,2018,Chicago State,WAC,12,76,5,15,4,12,1,3,8,10,1,3,4,10,4,0,12,9,19
18999,David Trimble,2013,2014,Seattle,WAC,28,123,7,20,7,19,0,1,5,12,8,8,16,17,4,0,10,14,19
19000,Blake Vedder,2011,2015,Total,Total,29,71,7,19,5,13,2,6,3,4,3,8,11,0,1,2,3,9,19
19001,Zac Walker,2008,2009,Tennessee Tech,OVC,26,78,7,17,2,4,5,13,0,1,1,3,4,10,6,0,7,7,19
19002,Howard Washington,2018,2019,Syracuse,ACC,21,120,5,18,3,5,2,13,7,10,0,19,19,11,6,1,7,5,19
19003,Shawn Willett,2016,2016,Alcorn State,SWAC,18,104,6,31,5,19,1,12,6,12,10,4,14,7,4,0,10,18,19
19004,Aaron Williams,2015,2016,Western Carolina,Southern,11,25,5,6,3,3,2,3,7,7,1,3,4,0,0,1,3,0,19
19005,Shawn Wilson,2018,2019,Eastern Illinois,OVC,29,132,8,19,7,15,1,4,2,7,4,8,12,18,4,0,13,16,19
19006,Zack Winston,2008,2008,Jacksonville State,OVC,12,111,8,23,8,23,0,0,3,9,8,11,19,5,4,5,7,23,19
19007,Tai Wynyard,2017,2018,Kentucky,SEC,23,97,8,13,8,13,0,0,3,5,11,16,27,1,4,4,5,19,19
19008,Dustin Adams,2013,2014,Northwestern State,Southland,23,65,6,15,6,15,0,0,6,8,9,6,15,1,0,2,3,7,18
19009,Michael Anderson,2008,2009,Missouri,Big 12,37,191,6,27,2,9,4,18,2,3,3,15,18,19,8,0,10,14,18
19010,Dato Aphkhazava,2019,2019,Southern Utah,Big Sky,19,114,5,20,4,13,1,7,7,8,1,3,4,9,4,0,10,16,18
19011,J.R. Archer,2008,2011,Appalachian State,Southern,31,71,5,17,2,5,3,12,5,6,3,7,10,2,0,0,5,9,18
19012,Derrick Banks,2011,2012,Morgan State,MEAC,16,84,5,18,0,4,5,14,3,4,4,5,9,2,2,0,9,8,18
19013,Omar Beauperthuy,2015,2015,Alcorn State,SWAC,22,182,7,21,7,19,0,2,4,6,10,18,28,5,0,2,11,26,18
19014,Jahmal Bivins,2008,2008,Maryland-Eastern Shore,MEAC,19,128,7,16,7,16,0,0,4,8,14,22,36,2,2,9,7,12,18
19015,Travis Blackstock,2009,2010,Idaho,WAC,17,57,8,21,7,17,1,4,1,4,3,6,9,2,1,1,1,4,18
19016,Richard Branning,2009,2012,Pepperdine,WCC,14,37,6,17,0,2,6,15,0,0,1,3,4,0,0,0,2,1,18
19017,Torey Burston,2014,2017,Virginia Commonwealth,A-10,60,173,4,30,3,23,1,7,9,17,5,15,20,16,8,0,6,15,18
19018,Matt Cajuste,2009,2010,Seton Hall,Big East,26,65,8,13,7,12,1,1,1,4,5,13,18,1,2,2,4,21,18
19019,Novian Cherry,2016,2016,Savannah State,MEAC,12,95,7,20,7,19,0,1,4,8,6,5,11,1,2,1,10,9,18
19020,Bill Clark,2012,2014,Loyola (IL),Total,39,136,7,30,5,17,2,13,2,4,8,13,21,13,3,0,12,15,18
19021,Brad Cohen,2008,2009,La Salle,A-10,8,17,7,15,3,6,4,9,0,0,0,1,1,1,0,0,1,0,18
19022,Ben Congiusta,2009,2009,Tennessee-Martin,OVC,9,32,6,10,5,8,1,2,5,6,2,4,6,2,2,1,4,2,18
19023,Ted Connolly,2009,2012,Navy,Patriot,55,232,7,30,6,17,1,13,3,4,3,16,19,21,14,0,17,32,18
19024,Patrick Crouch,2011,2012,North Carolina,ACC,35,58,7,19,5,10,2,9,2,4,0,7,7,6,1,0,12,8,18
19025,Chris Daniels,2013,2013,Georgia Southern,Southern,26,151,8,24,8,24,0,0,2,6,11,26,37,6,4,2,16,13,18
19026,Kevin Doi,2018,2019,Drexel,CAA,11,38,5,11,0,1,5,10,3,5,0,3,3,4,1,0,5,5,18
19027,Balsa Dragovic,2016,2019,Harvard,Ivy,14,58,6,14,4,8,2,6,4,4,5,13,18,1,0,2,5,8,18
19028,Dan Ficke,2008,2009,Loyola (MD),MAAC,51,341,3,12,3,12,0,0,12,17,25,25,50,8,3,4,16,48,18
19029,Josh Forney,2014,2016,Loyola (MD),Patriot,38,115,7,9,7,9,0,0,4,16,6,8,14,0,5,2,10,21,18
19030,Trevor Franklin,2013,2013,Missouri-Kansas City,Summit,11,86,5,18,5,12,0,6,8,11,1,3,4,1,0,1,4,2,18
19031,Giovanni Fraser,2017,2017,IUPUI,Summit,15,82,6,14,6,14,0,0,6,14,4,11,15,0,0,4,6,19,18
19032,Mark French,2017,2019,Texas A&M,SEC,24,107,6,18,3,11,3,7,3,4,0,7,7,9,3,0,5,7,18
19033,Josh Fuller,2014,2014,Weber State,Big Sky,11,51,6,9,4,5,2,4,4,5,4,11,15,0,1,1,4,7,18
19034,Samson George,2018,2019,Pittsburgh,ACC,18,74,8,14,8,14,0,0,2,7,8,12,20,1,0,1,0,13,18
19035,Cory Goodman,2011,2013,Lehigh,Patriot,32,70,7,15,4,6,3,9,1,2,1,4,5,9,2,0,5,3,18
19036,Therrell Gosier II,2019,2019,Alabama State,SWAC,7,68,7,13,5,7,2,6,2,3,5,10,15,2,3,4,11,8,18
19037,"Dwayne ""DJ"" Gutridge",2011,2011,Texas-Rio Grande Valley,GWC,8,64,7,14,6,9,1,5,3,6,4,3,7,6,2,0,6,5,18
19038,James Harris,2009,2009,Austin Peay,OVC,16,74,6,24,3,10,3,14,3,4,0,3,3,2,5,0,6,8,18
19039,Herb Harrison,2012,2012,Alabama-Birmingham,CUSA,14,81,9,14,9,14,0,0,0,0,1,10,11,3,2,2,7,11,18
19040,Kevin Hempy,2017,2018,Pepperdine,WCC,29,226,7,17,7,11,0,6,4,11,11,25,36,9,4,0,3,23,18
19041,Charles Henderson Jr,2019,2019,Tennessee-Martin,OVC,9,83,6,19,3,11,3,8,3,6,5,5,10,5,2,0,4,4,18
19042,Jay Henderson,2016,2017,Louisville,ACC,27,58,6,23,4,11,2,12,4,4,0,5,5,5,5,0,2,8,18
19043,Elijah Holifield,2016,2019,Total,Total,25,68,7,23,4,8,3,15,1,4,1,8,9,5,4,0,3,8,18
19044,Gregory Holloway,2019,2019,Mississippi Valley State,SWAC,15,65,5,16,4,12,1,4,7,9,6,10,16,0,0,1,4,6,18
19045,Andrew Houts,2014,2014,Chattanooga,Southern,10,35,6,13,5,8,1,5,5,6,4,5,9,5,2,0,5,5,18
19046,Tony Jacob,2014,2015,Alabama State,SWAC,12,36,7,10,7,10,0,0,4,13,3,6,9,3,1,4,8,9,18
19047,Jamaal James,2013,2013,Southeastern Louisiana,Southland,26,187,5,13,5,13,0,0,8,12,11,13,24,3,2,3,10,49,18
19048,Xzaivier James,2011,2014,Northern Colorado,Big Sky,26,109,6,11,4,4,2,7,4,9,3,9,12,9,4,0,9,12,18
19049,Sam Japhet-Mathias,2017,2019,Total,Total,24,114,8,15,8,15,0,0,2,2,12,11,23,1,0,4,10,30,18
19050,Garrett Jones,2012,2013,New Hampshire,AEC,14,98,6,19,1,4,5,15,1,2,1,1,2,6,1,0,6,9,18
19051,Tyquon Jordan,2017,2018,Houston Baptist,Southland,10,33,5,11,3,6,2,5,6,14,5,4,9,1,1,1,4,7,18
19052,Kurt Joseph,2010,2012,Long Island University,NEC,31,69,8,17,7,10,1,7,1,2,1,5,6,6,3,0,13,3,18
19053,Cody Kale,2011,2011,Cal State Bakersfield,Ind,13,92,6,11,3,7,3,4,3,6,2,8,10,4,1,0,4,7,18
19054,Ryan Kardok,2009,2010,South Florida,Big East,29,167,6,19,2,7,4,12,2,4,5,13,18,8,6,1,7,20,18
19055,John Kast,2008,2010,Oakland,Summit,23,72,7,15,6,10,1,5,3,6,2,4,6,5,0,1,13,4,18
19056,Martavis Kee,2008,2011,Total,Total,15,149,8,29,6,15,2,14,0,2,3,8,11,11,9,1,11,11,18
19057,Brandon Kenyon,2019,2019,IUPUI,Horizon,7,42,6,16,6,12,0,4,6,9,2,6,8,1,2,2,1,6,18
19058,Michael Klebon,2016,2019,Saint Francis (PA),NEC,28,76,5,18,1,4,4,14,4,4,2,14,16,1,1,1,4,7,18
19059,Jaxon Knotek,2019,2019,North Dakota State,Summit,11,80,6,24,2,8,4,16,2,3,1,8,9,4,0,2,5,7,18
19060,Kelby Kramer,2019,2019,Montana,Big Sky,21,126,8,13,8,13,0,0,2,7,7,12,19,4,2,7,7,19,18
19061,Tom Levin,2008,2008,Loyola (IL),Horizon,27,234,6,37,3,14,3,23,3,6,12,25,37,4,11,6,7,23,18
19062,Dani Lopez,2010,2010,Sacramento State,Big Sky,12,78,8,20,8,20,0,0,2,4,9,10,19,0,1,1,10,15,18
19063,Divonte Lumpkin,2018,2019,Texas Southern,SWAC,25,132,8,19,7,17,1,2,1,7,2,15,17,5,7,0,6,13,18
19064,Charlie Lytle,2011,2011,Florida Gulf Coast,A-Sun,21,142,5,28,5,20,0,8,8,10,11,18,29,12,2,5,15,19,18
19065,Nick Macarchuk,2018,2018,American,Patriot,18,212,8,12,7,11,1,1,1,4,12,11,23,13,8,2,10,37,18
19066,Donyell Marshall Jr.,2017,2019,Central Connecticut State,NEC,27,68,5,12,5,10,0,2,8,12,4,12,16,1,1,2,4,5,18
19067,Acoydan McCarthy,2018,2018,Austin Peay,OVC,23,107,7,21,6,17,1,4,3,9,1,11,12,5,2,1,6,8,18
19068,Kyle McClanahan,2009,2011,Florida,SEC,33,117,5,11,4,7,1,4,7,12,1,10,11,4,4,1,7,7,18
19069,Blake McDonald,2011,2014,Texas A&M,Total,46,193,5,18,3,12,2,6,6,8,2,7,9,19,3,0,12,24,18
19070,Montrell McDonald,2009,2009,Arkansas,SEC,4,77,7,16,7,16,0,0,4,11,5,16,21,2,2,2,8,7,18
19071,Jamel McGuire,2010,2010,Cal State Fullerton,Big West,16,118,6,19,6,17,0,2,6,10,1,13,14,15,5,0,17,17,18
19072,Reese Mona,2018,2019,Maryland,Big Ten,22,74,5,7,5,6,0,1,8,12,4,4,8,4,3,0,4,8,18
19073,Evan Moorman,2016,2017,Little Rock,Sun Belt,8,31,6,15,0,0,6,15,0,0,0,2,2,2,1,0,0,1,18
19074,Bawa Muniru,2010,2012,Total,Total,34,119,6,22,6,22,0,0,6,12,11,9,20,0,2,7,5,20,18
19075,Cameron Nettles,2009,2009,Mississippi Valley State,SWAC,17,55,5,18,5,17,0,1,8,16,6,2,8,3,3,0,8,16,18
19076,Jake Newman,2014,2015,Lafayette,Patriot,29,126,6,13,4,8,2,5,4,10,2,10,12,9,0,0,7,12,18
19077,"Charles O'Bannon, Jr.",2018,2019,Southern California,Pac-12,15,82,5,24,4,16,1,8,7,7,1,9,10,2,4,0,2,10,18
19078,Oscar Okeke,2019,2019,Fairleigh Dickinson,NEC,29,101,8,15,8,13,0,2,2,7,5,9,14,0,3,5,10,29,18
19079,Alex Olsen,2013,2014,Creighton,Total,30,60,6,9,6,8,0,1,6,11,1,7,8,2,2,0,1,3,18
19080,Craig Owens Jr.,2019,2019,Long Island University,NEC,6,35,4,14,1,6,3,8,7,8,3,3,6,5,3,0,3,6,18
19081,Matt Panaggio,2015,2015,Mercer,Southern,29,149,6,18,4,13,2,5,4,7,7,16,23,9,4,0,13,13,18
19082,Kyle Perkins,2012,2012,Utah,Pac-12,19,129,8,16,6,10,2,6,0,1,3,7,10,3,4,0,6,3,18
19083,Frankie Policelli,2019,2019,Dayton,A-10,20,96,7,21,3,8,4,13,0,3,2,8,10,9,2,1,5,15,18
19084,Alex Prahl,2015,2018,Milwaukee,Horizon,46,145,5,12,5,12,0,0,8,14,4,20,24,2,0,1,6,26,18
19085,Dee Proby,2009,2009,West Virginia,Big East,18,100,7,29,7,20,0,9,4,8,6,14,20,8,5,3,7,16,18
19086,Rico Quinton,2019,2019,East Carolina,AAC,7,56,6,18,4,10,2,8,4,7,4,11,15,0,4,6,5,7,18
19087,Damion Rashford,2014,2014,Loyola (MD),Patriot,22,115,7,33,5,23,2,10,2,8,5,11,16,2,2,2,8,14,18
19088,Myles Rasnick,2019,2019,East Tennessee State,Southern,8,30,6,16,2,8,4,8,2,2,0,1,1,0,0,0,1,8,18
19089,Chris Rice,2012,2014,Binghamton,AEC,46,172,4,26,1,8,3,18,7,11,2,4,6,7,0,0,13,14,18
19090,Mike Robinson,2016,2018,Miami (FL),ACC,25,46,6,18,1,4,5,14,1,2,1,1,2,1,1,0,1,6,18
19091,Rob Robinson,2012,2012,Illinois-Chicago,Horizon,11,80,6,19,3,8,3,11,3,4,6,5,11,0,2,0,6,14,18
19092,Darnell Rogers,2018,2018,Florida Gulf Coast,A-Sun,20,127,6,24,2,8,4,16,2,4,2,3,5,8,5,0,12,9,18
19093,"Linwood Ross,",2014,2014,IUPUI,Summit,13,39,6,19,5,14,1,5,5,8,0,6,6,0,0,1,1,1,18
19094,Landon Russell,2015,2017,Yale,Ivy,9,54,7,19,5,7,2,12,2,2,2,3,5,5,0,0,2,3,18
19095,Cole Salomon,2008,2009,Nebraska,Big 12,36,143,6,19,4,12,2,7,4,6,5,13,18,6,1,5,10,20,18
19096,Kevin Schafer,2008,2010,Monmouth,NEC,22,138,4,23,2,8,2,15,8,11,4,21,25,7,1,0,12,14,18
19097,Jake Showalter,2015,2015,North Dakota State,Summit,13,38,6,12,2,2,4,10,2,2,1,5,6,0,0,0,2,2,18
19098,Evan Smith,2010,2012,Southern California,Total,11,167,7,26,3,7,4,19,0,0,2,7,9,6,4,0,13,14,18
19099,Kenneth Smith,2013,2013,Jackson State,SWAC,16,49,5,17,3,4,2,13,6,9,1,9,10,2,4,0,3,6,18
19100,Trey Smith,2019,2019,San Jose State,MWC,18,126,6,17,2,6,4,11,2,6,1,8,9,9,2,0,5,5,18
19101,Leon Sneed,2019,2019,Prairie View,SWAC,15,130,6,14,6,14,0,0,6,10,3,6,9,16,9,0,8,22,18
19102,Dalton Soffer,2016,2017,Seton Hall,Big East,24,55,6,21,0,0,6,21,0,0,0,5,5,1,2,0,1,4,18
19103,Michael Sohikish,2018,2019,San Diego State,MWC,23,65,6,18,5,9,1,9,5,8,0,4,4,7,4,0,3,7,18
19104,Taylor Stormberg,2011,2013,Creighton,MVC,53,130,6,18,2,4,4,14,2,2,0,10,10,12,4,0,7,9,18
19105,Brendan Sullivan,2009,2010,Boston University,AEC,27,214,6,26,1,12,5,14,1,2,7,21,28,3,4,3,8,25,18
19106,Peter Swiatek,2009,2009,Harvard,Ivy,12,49,6,11,6,11,0,0,6,7,7,5,12,0,0,3,3,11,18
19107,Bakari Taylor,2010,2012,Hampton,MEAC,22,85,9,17,9,16,0,1,0,0,5,6,11,1,2,2,2,12,18
19108,Zac Taylor,2009,2009,Toledo,MAC,9,60,8,10,8,10,0,0,2,2,2,5,7,0,1,3,7,8,18
19109,James Tchana,2008,2008,Fresno State,WAC,16,49,9,12,9,12,0,0,0,0,6,3,9,0,0,0,5,11,18
19110,Chris Teahan,2018,2019,Kansas,Big 12,22,44,6,16,2,3,4,13,2,2,2,6,8,2,0,0,5,4,18
19111,Chad Thompson,2009,2009,Campbell,A-Sun,6,48,7,20,5,12,2,8,2,2,1,4,5,3,1,1,3,7,18
19112,Mark Tikhonenko,2019,2019,North Texas,CUSA,8,67,7,20,3,5,4,15,0,1,9,5,14,5,0,0,0,10,18
19113,Jean Yves Toupane,2013,2014,St. Bonaventure,A-10,13,42,6,17,3,4,3,13,3,6,1,4,5,1,2,0,1,2,18
19114,Garrison Wade,2019,2019,Dartmouth,Ivy,12,45,6,10,4,5,2,5,4,5,1,5,6,1,2,0,5,3,18
19115,Kirk Walters,2008,2008,Arizona,Pac-10,22,155,8,18,8,18,0,0,2,12,7,21,28,0,3,11,7,21,18
19116,Joshu'a Warren,2016,2016,Maryland-Eastern Shore,MEAC,10,93,7,17,7,17,0,0,4,8,11,5,16,0,4,4,12,19,18
19117,Stacey Waters,2009,2009,Ohio,MAC,14,43,6,21,2,7,4,14,2,3,0,4,4,1,0,0,4,3,18
19118,Marcus White,2014,2015,Illinois-Chicago,Horizon,26,157,5,26,2,9,3,17,5,9,1,7,8,15,7,0,5,5,18
19119,Jason Whitens,2018,2018,Western Michigan,MAC,16,95,6,14,3,9,3,5,3,5,7,8,15,4,3,3,4,13,18
19120,Tommy Williams,2015,2015,East Tennessee State,Southern,14,93,6,23,6,23,0,0,6,13,14,16,30,0,2,3,7,17,18
19121,Mohamed Abuarisha,2017,2018,Jacksonville State,OVC,20,68,7,24,4,12,3,12,0,1,2,8,10,4,1,0,9,4,17
19122,Deji Adekunle,2015,2015,Northwestern State,Southland,17,120,7,16,7,16,0,0,3,9,8,21,29,1,1,2,11,21,17
19123,Armend Ademi,2008,2008,Purdue-Fort Wayne,Summit,23,112,4,13,4,13,0,0,9,10,7,24,31,1,0,2,6,15,17
19124,Marvin Adu,2011,2012,Prairie View,SWAC,29,133,7,11,7,11,0,0,3,10,5,15,20,1,5,2,8,35,17
19125,Tyler Akers,2014,2015,Longwood,Big South,30,49,4,11,2,2,2,9,7,10,2,5,7,2,0,0,4,4,17
19126,Marlon Alcindor,2016,2016,St. Francis (NY),NEC,8,30,5,14,1,5,4,9,3,4,0,2,2,0,0,0,1,3,17
19127,Galen Alexander,2018,2018,Louisiana State,SEC,9,55,6,16,4,5,2,11,3,4,5,14,19,1,1,0,2,5,17
19128,Tyrone Appleton,2009,2009,Kansas,Big 12,21,47,7,13,7,13,0,0,3,6,2,5,7,7,1,1,9,9,17
19129,Jordan Arroyo,2019,2019,New Mexico,MWC,12,70,7,9,7,9,0,0,3,9,7,6,13,0,2,3,2,8,17
19130,Larry Awosanya,2010,2011,Campbell,A-Sun,30,121,8,25,8,24,0,1,1,5,15,14,29,1,2,2,8,14,17
19131,Khalil Bedart-Ghani,2015,2016,San Diego,WCC,22,91,7,25,7,20,0,5,3,8,8,14,22,3,7,3,8,9,17
19132,Benoit Bekono,2008,2008,UC-Riverside,Big West,10,111,5,14,5,14,0,0,7,13,10,19,29,4,6,0,9,10,17
19133,Luke Bolster,2018,2019,Columbia,Ivy,6,51,6,19,3,6,3,13,2,2,0,4,4,6,2,0,4,7,17
19134,Kevin Branch,2008,2008,Southern Mississippi,CUSA,5,28,7,13,6,11,1,2,2,7,0,1,1,1,4,0,3,1,17
19135,Bryce Brigham,2008,2008,Navy,Patriot,14,104,5,22,2,5,3,17,4,4,4,3,7,3,1,1,10,12,17
19136,Justin Brock,2008,2008,Eastern Illinois,OVC,3,,8,21,8,20,0,1,1,1,,,20,3,2,3,3,,17
19137,Freddy Brown III,2019,2019,Montana,Big Sky,15,33,5,13,1,5,4,8,3,4,3,2,5,1,0,0,2,3,17
19138,Ronald Brown,2008,2008,Fairleigh Dickinson,NEC,11,86,6,17,6,15,0,2,5,8,4,10,14,4,5,1,14,4,17
19139,Josh Burnett,2016,2017,Kennesaw State,A-Sun,19,120,7,30,5,21,2,9,1,3,4,17,21,7,6,1,10,12,17
19140,Tamir Bynum,2019,2019,Texas-San Antonio,CUSA,9,81,6,25,6,21,0,4,5,6,0,3,3,2,2,0,8,4,17
19141,John Cain Carney,2012,2015,Boston College,ACC,47,240,8,22,7,18,1,4,0,3,13,31,44,5,6,2,8,28,17
19142,Kyle Cannon,2009,2009,Oklahoma,Big 12,9,61,6,21,4,12,2,9,3,4,5,11,16,2,1,0,2,9,17
19143,JC Cavin,2018,2018,Charleston Southern,Big South,9,70,6,14,4,7,2,7,3,5,0,0,0,4,2,0,3,11,17
19144,Kelsey Chine,2010,2012,Loyola Marymount,WCC,18,55,6,17,2,7,4,10,1,5,4,2,6,2,2,1,3,5,17
19145,Kasper Christensen,2018,2018,Florida International,CUSA,10,56,5,17,0,1,5,16,2,3,0,5,5,1,3,3,1,8,17
19146,Thomas Clement,2019,2019,Nicholls State,Southland,14,37,4,10,1,1,3,9,6,6,2,6,8,5,1,0,3,3,17
19147,Chase Cobb,2018,2019,Abilene Christian,Southland,23,66,6,17,3,4,3,13,2,4,2,4,6,4,3,0,7,7,17
19148,Marvin Coleman,2019,2019,Nevada-Las Vegas,MWC,11,46,5,10,4,8,1,2,6,6,1,2,3,5,3,0,2,9,17
19149,Kenny Demouchet,2013,2013,Jackson State,SWAC,22,114,8,32,8,26,0,6,1,2,10,16,26,2,4,1,10,14,17
19150,Horace Dixon,2010,2010,Southern,SWAC,5,99,8,21,8,21,0,0,1,1,4,8,12,0,3,1,8,12,17
19151,Michael Dobbins,2019,2019,Texas Southern,SWAC,19,67,5,10,5,10,0,0,7,11,6,8,14,1,2,2,5,7,17
19152,A.J. Edwards,2014,2016,Yale,Ivy,23,81,5,18,2,2,3,16,4,6,3,5,8,6,1,0,4,5,17
19153,Devin Epps,2015,2018,South Alabama,Sun Belt,32,67,4,9,1,4,3,5,6,10,1,3,4,4,3,0,6,11,17
19154,Tragen Fahl,2018,2019,Virginia Military Institute,Southern,21,68,7,17,6,13,1,4,2,3,1,9,10,0,3,4,2,5,17
19155,Ross Ferrarini,2011,2012,Creighton,MVC,24,45,6,18,1,3,5,15,0,0,1,5,6,1,2,0,3,3,17
19156,Kevin Fleming,2008,2008,San Jose State,WAC,20,78,5,24,4,20,1,4,6,14,4,10,14,2,2,1,7,13,17
19157,Philip Flory,2018,2019,Total,Total,29,103,3,17,0,6,3,11,8,8,0,11,11,6,0,1,6,9,17
19158,Sajon Ford,2016,2017,Northeastern,CAA,20,107,8,19,8,19,0,0,1,7,8,13,21,2,6,2,9,14,17
19159,Tim Frye,2008,2010,Pittsburgh,Big East,24,35,6,16,1,4,5,12,0,0,1,3,4,3,1,0,6,1,17
19160,Brandon Glanz,2012,2012,Idaho State,Big Sky,7,38,5,10,5,10,0,0,7,11,2,1,3,1,0,0,2,4,17
19161,Tre Green,2015,2015,Albany (NY),AEC,12,54,5,16,3,11,2,5,5,7,0,6,6,2,3,0,6,4,17
19162,Ari Greenberg,2008,2008,Yale,Ivy,17,78,4,12,3,6,1,6,8,13,2,5,7,12,6,0,5,4,17
19163,Corey Haith,2013,2017,Total,Total,30,65,5,15,0,0,5,15,2,4,0,6,6,5,4,0,6,11,17
19164,Darrious Hamilton,2013,2013,Boise State,MWC,16,73,5,12,5,12,0,0,7,12,7,12,19,1,3,1,8,13,17
19165,Tyler Hatch,2008,2008,Oklahoma State,Big 12,22,148,6,13,1,1,5,12,0,0,11,10,21,5,4,1,7,19,17
19166,Steve Holdren,2008,2008,Illinois,Big Ten,14,97,5,19,2,4,3,15,4,7,1,10,11,7,2,0,2,11,17
19167,Lionell Holmes,2010,2010,Stephen F. Austin,Southland,8,21,5,10,1,3,4,7,3,4,0,2,2,0,0,1,2,0,17
19168,Quintarius Hutchinson,2011,2012,Total,SWAC,15,101,7,18,7,12,0,6,3,12,10,12,22,3,2,4,12,23,17
19169,Emeka Ikezu,2014,2015,Samford,Southern,29,115,7,12,7,12,0,0,3,10,9,13,22,1,2,3,9,42,17
19170,Pat Ingram,2013,2013,Iowa,Big Ten,20,116,6,14,6,12,0,2,5,12,2,10,12,9,3,0,9,10,17
19171,Mark Jackson,2012,2013,Total,Total,13,98,7,22,4,13,3,9,0,0,1,12,13,4,3,1,10,7,17
19172,Michael Jenkins,2010,2010,Mercer,A-Sun,5,42,6,19,6,19,0,0,5,7,6,7,13,0,0,0,2,4,17
19173,Ja'Kwan Jones,2017,2017,Quinnipiac,MAAC,16,104,5,17,5,16,0,1,7,14,11,18,29,1,3,2,5,13,17
19174,Marlon Jones,2017,2017,New Mexico State,WAC,3,57,7,14,7,13,0,1,3,6,5,4,9,1,0,1,4,11,17
19175,Nick Jones,2019,2019,Houston Baptist,Southland,6,15,6,10,5,9,1,1,4,5,3,4,7,1,1,1,1,2,17
19176,Kieffer Jordan,2014,2015,Army,Patriot,26,152,6,19,5,13,1,6,4,9,8,20,28,7,1,3,7,31,17
19177,Derrell Joubert,2015,2016,McNeese State,Southland,12,30,6,13,1,2,5,11,0,0,0,5,5,0,1,0,2,4,17
19178,Jakoby Kemp,2017,2019,Total,Total,7,34,6,7,6,6,0,1,5,8,5,3,8,1,1,1,4,5,17
19179,John Kitoko,2019,2019,Charlotte,CUSA,19,170,7,35,5,10,2,25,1,2,3,15,18,4,3,1,7,9,17
19180,Danijel Krleski,2008,2008,Maryland-Eastern Shore,MEAC,14,44,7,11,4,4,3,7,0,2,1,2,3,2,0,0,3,2,17
19181,Eddie Lima,2008,2008,Cal State Fullerton,Big West,11,57,7,13,7,13,0,0,3,5,5,7,12,2,3,0,5,5,17
19182,Jeremiah Livingston,2018,2018,Saint Peter's,MAAC,19,168,6,30,4,19,2,11,3,5,7,7,14,12,9,1,12,12,17
19183,Samer Madarani,2009,2012,Delaware,CAA,29,30,6,17,3,5,3,12,2,6,0,0,0,3,1,0,3,4,17
19184,Dolan Mahoney,2016,2019,Florida Gulf Coast,A-Sun,33,79,7,17,4,6,3,11,0,0,2,5,7,3,3,0,3,10,17
19185,Jeff Martin,2014,2015,Murray State,OVC,18,36,5,18,2,9,3,9,4,6,0,4,4,2,1,0,3,2,17
19186,Todd Martin,2011,2011,South Alabama,Sun Belt,21,134,5,21,1,3,4,18,3,5,1,6,7,10,3,1,7,17,17
19187,Kyle McLeroy,2014,2015,Sam Houston State,Southland,25,64,4,12,1,2,3,10,6,7,1,4,5,11,1,0,7,3,17
19188,Joel Mensah,2019,2019,San Diego State,MWC,15,81,5,28,5,28,0,0,7,11,4,11,15,0,1,2,0,12,17
19189,Souf Mensah,2018,2018,Rutgers,Big Ten,27,180,6,22,6,22,0,0,5,19,7,15,22,13,4,1,17,27,17
19190,Pierre Niles,2008,2008,Memphis,CUSA,26,98,6,15,6,15,0,0,5,18,10,11,21,2,2,0,4,24,17
19191,Kinley Ogbonnaya-Branch,2012,2012,Arkansas State,Sun Belt,15,95,6,21,1,4,5,17,0,1,4,9,13,1,1,0,9,10,17
19192,Keith Olson,2010,2010,Nevada,WAC,16,91,8,17,8,17,0,0,1,4,4,13,17,3,1,0,2,24,17
19193,Mike Peltz,2013,2014,Nebraska,Big Ten,25,267,4,18,2,15,2,3,7,14,10,28,38,18,2,0,16,39,17
19194,Chris Peys,2008,2008,Long Beach State,Big West,24,161,5,33,4,11,1,22,6,13,1,6,7,5,5,1,10,8,17
19195,Tom Planek,2015,2018,Providence,Big East,41,78,6,15,6,15,0,0,5,13,10,7,17,1,5,1,8,11,17
19196,Mark Plousis,2015,2018,Hartford,AEC,38,81,2,7,2,7,0,0,13,23,3,7,10,1,2,1,4,11,17
19197,Nate Pollard,2015,2016,Rice,CUSA,28,155,6,15,6,15,0,0,5,11,9,20,29,3,2,6,17,37,17
19198,Brandon Powell,2019,2019,Alabama A&M,SWAC,22,155,6,17,6,14,0,3,5,10,7,9,16,3,10,0,6,18,17
19199,Thaddeus Rideau,2014,2014,Alabama-Birmingham,CUSA,10,66,6,21,1,4,5,17,0,0,1,9,10,2,3,1,2,7,17
19200,Beau Rydalch,2017,2019,Utah,Pac-12,24,81,5,19,3,7,2,12,5,8,9,16,25,3,1,3,6,8,17
19201,Abdul Sarki,2018,2018,Charleston Southern,Big South,6,45,6,14,6,14,0,0,5,6,13,3,16,0,1,0,3,7,17
19202,Stephen Sauls,2008,2008,Washington State,Pac-10,8,50,6,11,3,5,3,6,2,2,0,6,6,4,2,0,4,6,17
19203,Luke Schultz,2018,2018,Montana State,Big Sky,10,49,5,8,5,8,0,0,7,14,9,7,16,0,2,0,5,11,17
19204,Ryan Schultz,2013,2014,Kansas State,Big 12,28,61,5,23,3,9,2,14,5,8,3,8,11,5,5,0,6,10,17
19205,Kendal Shell,2012,2015,Minnesota,Big Ten,41,86,7,21,5,14,2,7,1,2,3,6,9,10,3,0,6,7,17
19206,Matheus Silveira,2019,2019,Austin Peay,OVC,7,64,8,15,8,15,0,0,1,5,7,8,15,3,3,3,3,11,17
19207,Jason Smiley,2008,2008,Tennessee Tech,OVC,13,76,5,19,2,8,3,11,4,8,3,2,5,4,4,0,5,8,17
19208,Bryce Smith,2009,2011,Total,Total,16,44,5,15,0,1,5,14,2,2,0,3,3,1,2,0,0,6,17
19209,Demetrious Smith,2011,2013,Arkansas-Pine Bluff,SWAC,42,192,5,9,3,6,2,3,5,6,7,8,15,5,2,0,15,16,17
19210,Andre' Southern,2008,2008,Grambling,SWAC,14,89,5,23,4,17,1,6,6,10,2,5,7,5,2,0,11,6,17
19211,Kahliel Spear,2019,2019,Bucknell,Patriot,14,33,7,16,5,11,2,5,1,4,3,7,10,0,0,4,1,6,17
19212,Milos Stajcic,2019,2019,Campbell,Big South,13,64,6,15,3,7,3,8,2,6,3,3,6,2,2,0,6,16,17
19213,Sidiki Straub,2009,2009,Mercer,A-Sun,25,140,6,14,6,14,0,0,5,11,7,23,30,4,6,2,7,31,17
19214,Kevin Sumner,2008,2008,Hampton,MEAC,14,52,7,19,4,7,3,12,0,0,5,4,9,0,1,1,4,6,17
19215,Carlos Taylor,2014,2014,Massachusetts-Lowell,AEC,9,47,6,22,1,6,5,16,0,0,3,4,7,0,0,0,4,1,17
19216,Jesse Tesmer,2015,2015,Chicago State,WAC,19,161,6,22,6,22,0,0,5,6,5,9,14,0,3,1,7,20,17
19217,Cartrell Thompson,2019,2019,Cal State Bakersfield,WAC,18,95,7,8,7,8,0,0,3,8,6,8,14,1,1,3,7,22,17
19218,Charlie Tooley,2017,2018,Nevada,MWC,32,57,5,16,0,1,5,15,2,2,4,2,6,0,3,0,4,14,17
19219,Jerret Towns,2011,2011,Tennessee State,OVC,6,49,5,14,2,3,3,11,4,5,1,12,13,5,0,1,4,3,17
19220,Grant Townsend,2017,2018,North Carolina-Asheville,Big South,15,61,7,17,7,16,0,1,3,16,8,8,16,1,0,4,6,10,17
19221,Jonathan Tull,2010,2010,Central Connecticut State,NEC,19,101,2,15,2,13,0,2,13,21,0,4,4,4,3,1,11,8,17
19222,Kevin Vosilla,2008,2009,Rider,MAAC,21,73,6,12,6,12,0,0,5,6,4,4,8,2,5,2,3,8,17
19223,Kentrell Washington,2013,2013,Hofstra,CAA,7,116,6,20,6,16,0,4,5,8,5,6,11,5,0,1,7,8,17
19224,Justin Werner,2009,2009,Kansas State,Big 12,16,86,5,25,1,4,4,21,3,6,2,6,8,6,3,1,4,7,17
19225,Reed Westbrook,2014,2014,Stephen F. Austin,Southland,16,44,4,17,2,5,2,12,7,8,2,4,6,3,2,0,2,5,17
19226,Josh Williams,2018,2018,South Dakota,Summit,12,42,7,11,4,5,3,6,0,0,0,2,2,2,0,0,2,1,17
19227,Reggie Williams,2011,2011,Morehead State,OVC,21,108,7,21,4,9,3,12,0,2,3,8,11,6,7,0,17,16,17
19228,Kibret Woldemichael,2014,2015,San Diego State,MWC,10,32,5,7,0,0,5,7,2,4,1,2,3,4,1,0,5,0,17
19229,Eli York,2012,2012,Tennessee-Martin,OVC,11,65,6,18,6,18,0,0,5,6,2,7,9,2,0,1,4,4,17
19230,Roderick Adams,2008,2008,Sacramento State,Big Sky,4,76,6,16,4,14,2,2,2,8,2,7,9,9,5,0,12,6,16
19231,Shareif Adamu,2013,2013,Auburn,SEC,6,74,5,14,4,10,1,4,5,8,6,6,12,3,3,5,10,11,16
19232,Lamar Adkins,2008,2008,Norfolk State,MEAC,8,43,5,18,4,8,1,10,5,6,2,7,9,1,0,0,8,6,16
19233,Eddie Alcantara,2013,2013,Western Kentucky,Sun Belt,11,64,5,16,5,9,0,7,6,8,7,6,13,0,2,1,9,9,16
19234,Austin Alecxih,2010,2012,Total,Total,16,59,5,25,3,10,2,15,4,5,4,4,8,3,2,0,4,5,16
19235,Tim Andree,2008,2010,Notre Dame,Big East,24,44,7,12,7,12,0,0,2,2,5,5,10,2,2,1,3,5,16
19236,McWisdom Badejo,2013,2013,Florida A&M,MEAC,14,80,8,18,8,18,0,0,0,0,8,10,18,1,1,3,0,15,16
19237,Jeremy Banks,2008,2008,Norfolk State,MEAC,13,78,6,15,4,8,2,7,2,3,3,5,8,6,3,1,7,6,16
19238,Jack Beach,2016,2019,Gonzaga,WCC,45,108,5,23,1,7,4,16,2,4,3,8,11,5,4,0,0,7,16
19239,Maxx Bleecher,2016,2017,Florida Gulf Coast,A-Sun,18,37,7,11,5,7,2,4,0,0,2,12,14,3,2,0,4,4,16
19240,Trae Brenner,2013,2013,Campbell,Big South,9,64,8,17,8,17,0,0,0,0,5,7,12,2,1,0,3,9,16
19241,Blake Brinkmeyer,2019,2019,Indiana State,MVC,5,31,5,11,5,11,0,0,6,8,4,6,10,0,1,2,1,4,16
19242,Tray Britt,2008,2010,New Mexico State,WAC,24,65,4,11,3,10,1,1,7,17,3,7,10,3,3,1,8,10,16
19243,Aaron Brown,2012,2015,Mount St. Mary's,NEC,35,68,7,22,5,7,2,15,0,3,4,11,15,2,2,1,4,7,16
19244,Derek Brown,2010,2011,Wichita State,MVC,27,69,5,15,1,3,4,12,2,2,1,10,11,3,2,0,3,10,16
19245,Lawrence Brown,2008,2010,Fairleigh Dickinson,NEC,39,170,7,23,7,23,0,0,2,14,12,13,25,1,0,4,9,28,16
19246,Al Burge,2016,2016,Longwood,Big South,14,32,7,13,7,11,0,2,2,2,5,3,8,1,2,1,2,5,16
19247,Zach Bush,2014,2017,Wichita State,MVC,65,155,5,26,3,13,2,13,4,11,3,19,22,13,8,0,8,14,16
19248,Marc Campbell,2008,2010,North Carolina,ACC,51,105,5,19,2,7,3,12,3,4,1,8,9,20,8,0,20,5,16
19249,Jared Casey,2008,2008,San Francisco,WCC,9,119,6,21,6,21,0,0,4,7,7,13,20,2,1,6,7,17,16
19250,Tarik Clement,2017,2018,South Carolina State,MEAC,18,59,5,15,5,13,0,2,6,8,1,5,6,3,1,0,3,5,16
19251,Drew Crabtree,2014,2017,Ohio,MAC,37,58,5,16,1,3,4,13,2,2,2,8,10,3,1,0,4,7,16
19252,Isiah Cross,2008,2008,Alabama A&M,SWAC,14,132,6,25,4,12,2,13,2,2,3,8,11,5,6,0,5,8,16
19253,Sooren Derboghosian,2013,2015,Total,Total,12,60,7,10,7,10,0,0,2,3,12,3,15,1,0,1,5,6,16
19254,Moustapha Diagne,2018,2019,Western Kentucky,CUSA,33,215,7,37,6,23,1,14,1,3,13,36,49,3,3,2,17,29,16
19255,Cassin Diggs,2008,2008,Pittsburgh,Big East,9,61,8,15,8,15,0,0,0,2,14,4,18,1,0,2,5,15,16
19256,Drew Dotson,2008,2008,New Orleans,Sun Belt,11,23,6,11,3,6,3,5,1,2,2,2,4,2,0,0,3,2,16
19257,Ben Drake,2019,2019,Presbyterian,Big South,14,59,6,18,5,14,1,4,3,5,5,11,16,0,0,2,1,11,16
19258,Kidus Ephrem,2012,2012,Portland State,Big Sky,7,73,7,13,6,8,1,5,1,1,2,16,18,4,0,2,1,6,16
19259,Dakotah Euton,2011,2011,Akron,MAC,14,67,4,20,0,7,4,13,4,6,4,8,12,1,0,1,0,7,16
19260,Haize Fornstrom,2019,2019,Wyoming,MWC,12,54,5,10,2,3,3,7,3,3,1,7,8,2,1,0,1,10,16
19261,T.J. Franklin,2009,2012,Oklahoma,Big 12,56,104,4,22,3,14,1,8,7,21,3,12,15,15,2,0,18,12,16
19262,Beas Hamga,2009,2012,Total,Total,31,139,7,13,7,13,0,0,2,4,5,18,23,3,1,4,5,7,16
19263,Mike Hardiman,2008,2010,North Carolina-Greensboro,Southern,25,73,6,19,3,9,3,10,1,8,3,4,7,2,1,0,4,4,16
19264,Danny Harris,2017,2019,Bethune-Cookman,MEAC,11,33,6,12,6,8,0,4,4,7,2,3,5,2,1,0,8,7,16
19265,Mehkel Harvey,2019,2019,William & Mary,CAA,19,104,6,11,6,11,0,0,4,10,7,17,24,6,4,11,6,11,16
19266,Fred Haywood,2018,2018,McNeese State,Southland,13,28,7,13,7,12,0,1,2,5,5,4,9,0,4,0,0,3,16
19267,Troy Henderson,2016,2016,Mount St. Mary's,NEC,19,121,5,19,1,3,4,16,2,3,3,4,7,0,0,3,4,14,16
19268,Joe Hill,2010,2011,Chicago State,GWC,16,40,5,11,1,4,4,7,2,2,1,5,6,1,0,0,3,4,16
19269,Charles Holt,2010,2013,Memphis,CUSA,26,57,4,15,1,6,3,9,5,8,2,6,8,2,0,0,5,4,16
19270,Andrew Hurd,2013,2014,Central Connecticut State,NEC,28,116,5,19,2,3,3,16,3,4,4,9,13,6,4,0,7,9,16
19271,Larry Johnson,2015,2016,Arkansas-Pine Bluff,SWAC,45,157,7,21,5,14,2,7,0,3,5,6,11,6,4,0,19,24,16
19272,Michael Johnson,2019,2019,Chicago State,WAC,24,151,5,22,4,16,1,6,5,9,2,12,14,9,10,0,10,17,16
19273,Julian Jones,2009,2009,Western Illinois,Summit,25,187,7,23,7,23,0,0,2,5,7,13,20,1,7,5,8,19,16
19274,Khalid King,2013,2013,North Carolina A&T,MEAC,13,48,5,21,2,8,3,13,3,5,0,2,2,2,2,0,3,5,16
19275,Isaac Lang,2013,2014,Central Florida,Total,20,49,6,14,2,3,4,11,0,1,2,2,4,0,0,0,3,2,16
19276,Zach Light,2019,2019,Colgate,Patriot,15,43,6,12,5,7,1,5,3,4,3,9,12,3,1,0,5,6,16
19277,Nick Loew,2015,2018,San Francisco,WCC,16,88,6,14,6,14,0,0,4,7,10,9,19,3,2,1,3,15,16
19278,Larry Loughery,2009,2011,Pennsylvania,Ivy,11,78,5,14,5,14,0,0,6,15,6,9,15,2,3,2,6,18,16
19279,James Love,2018,2019,Kansas State,Big 12,32,118,7,14,7,14,0,0,2,5,4,9,13,0,1,5,3,33,16
19280,Tommy Luce,2017,2019,Purdue,Big Ten,36,79,4,19,3,16,1,3,7,15,2,1,3,13,3,0,14,10,16
19281,Shane Mahoney,2009,2009,Lamar,Southland,16,137,5,14,4,11,1,3,5,10,3,12,15,14,5,0,13,19,16
19282,Gary Martin,2011,2012,Fairfield,MAAC,29,66,6,22,4,11,2,11,2,4,2,3,5,5,3,0,2,5,16
19283,Tyeshon Martin,2019,2019,Indiana State,MVC,15,78,5,13,2,5,3,8,3,8,0,6,6,3,2,0,1,4,16
19284,Kyle Massie,2016,2018,Texas-San Antonio,CUSA,24,61,5,19,3,6,2,13,4,7,3,3,6,6,0,0,1,5,16
19285,Donald Moore,2014,2014,Eastern Illinois,OVC,12,75,4,17,2,10,2,7,6,9,1,3,4,2,1,0,6,9,16
19286,Tyre Moore,2015,2016,Mercer,Southern,32,54,3,11,1,2,2,9,8,10,6,7,13,0,1,0,2,11,16
19287,Brock Moorman,2009,2011,North Carolina A&T,MEAC,20,91,6,11,5,10,1,1,3,4,7,4,11,0,1,0,6,5,16
19288,Alex Mudronja,2019,2019,Saint Mary's (CA),WCC,19,77,6,15,5,8,1,7,3,8,1,7,8,6,4,1,11,8,16
19289,Taariq Muhammad,2013,2013,Morehead State,OVC,18,208,7,25,7,18,0,7,2,6,4,19,23,32,15,1,29,19,16
19290,Kevin Mulquin,2011,2011,Dartmouth,Ivy,17,59,8,17,8,17,0,0,0,1,5,5,10,1,1,5,3,6,16
19291,Danny Newsome,2013,2016,Texas,Big 12,14,40,6,14,3,8,3,6,1,4,3,7,10,0,0,0,3,7,16
19292,Josh Nirenberg,2010,2011,Appalachian State,Southern,15,64,7,18,7,18,0,0,2,5,6,17,23,2,1,2,7,13,16
19293,Nicholaus Osbourne,2012,2012,Texas-Arlington,Southland,12,32,6,14,2,3,4,11,0,0,1,2,3,0,4,0,3,1,16
19294,Trevin Parks,2010,2010,Charlotte,A-10,10,26,6,11,6,10,0,1,4,7,0,3,3,4,0,0,5,1,16
19295,Tyler Pate,2014,2014,Florida Atlantic,CUSA,16,75,5,19,2,4,3,15,3,5,3,8,11,4,2,0,4,10,16
19296,Cartree Pettis,2016,2016,Jacksonville,A-Sun,25,206,5,11,4,10,1,1,5,10,1,17,18,28,7,7,13,25,16
19297,Mark Pollack,2015,2018,Army,Patriot,16,57,6,26,2,7,4,19,0,0,0,9,9,1,0,2,5,8,16
19298,Ruell Pringle,2008,2008,Campbell,A-Sun,2,39,6,16,3,6,3,10,1,3,1,5,6,1,0,0,2,2,16
19299,Marco Ramos,2009,2009,Weber State,Big Sky,15,32,6,8,6,8,0,0,4,6,2,4,6,1,0,0,0,3,16
19300,Lonell Reeves,2011,2011,Louisiana-Monroe,Sun Belt,15,254,6,20,3,11,3,9,1,4,2,9,11,22,5,1,18,13,16
19301,Matt Roberts,2009,2009,Citadel,Southern,20,86,7,16,7,16,0,0,2,4,8,6,14,2,0,0,6,14,16
19302,Brian Rohleder,2012,2016,Kansas State,Big 12,66,173,7,20,7,15,0,5,2,10,11,11,22,11,8,3,7,37,16
19303,Billy Rosenberg,2013,2013,Texas Southern,SWAC,11,40,5,7,5,7,0,0,6,8,6,4,10,1,0,2,1,9,16
19304,Marcelo Ruediger,2014,2014,Monmouth,MAAC,24,112,5,16,5,16,0,0,6,12,16,12,28,1,2,3,6,17,16
19305,Connor Rufo,2018,2019,Delaware,CAA,21,43,5,9,3,6,2,3,4,6,3,5,8,3,0,0,1,4,16
19306,Patrick Ryan,2014,2017,Elon,Total,12,32,6,14,5,6,1,8,3,4,2,7,9,2,0,1,5,2,16
19307,Will Sanger,2009,2012,Tulsa,CUSA,42,43,5,12,3,5,2,7,4,7,2,3,5,2,1,1,4,2,16
19308,Quentin Shropshire,2016,2018,Long Beach State,Big West,39,135,6,22,6,22,0,0,4,8,13,16,29,4,3,5,4,32,16
19309,Jordan Smart,2010,2012,Vanderbilt,SEC,32,90,6,16,2,3,4,13,0,0,1,16,17,8,2,1,1,5,16
19310,Jordan Smith,2012,2016,Wisconsin,Big Ten,39,76,6,25,4,12,2,13,2,3,4,6,10,1,0,1,1,5,16
19311,Phillip Smith,2019,2019,Florida International,CUSA,7,42,6,15,4,6,2,9,2,5,3,2,5,1,3,0,1,5,16
19312,Sherrod Smith,2008,2010,Boston University,AEC,46,184,3,17,3,15,0,2,10,21,6,22,28,7,5,1,2,14,16
19313,Bienvenu Songondo,2008,2008,Wyoming,MWC,11,57,6,9,6,9,0,0,4,5,4,7,11,2,1,1,2,12,16
19314,Ace Stallings,2018,2019,Mount St. Mary's,NEC,16,77,7,14,7,13,0,1,2,7,8,9,17,2,1,6,2,13,16
19315,Hefeng Sun,2014,2015,Norfolk State,MEAC,24,79,6,12,6,12,0,0,4,4,1,5,6,3,1,2,3,9,16
19316,Clint Thomas,2014,2014,Idaho State,Big Sky,11,48,6,11,3,5,3,6,1,2,0,3,3,2,0,0,1,5,16
19317,Elias Valtonen,2019,2019,Arizona State,Pac-12,20,77,5,9,1,1,4,8,2,2,1,7,8,2,3,4,6,7,16
19318,Daymon Warren,2011,2011,George Washington,A-10,24,176,8,24,8,24,0,0,0,4,14,34,48,5,5,5,10,18,16
19319,Nick Weaver,2008,2008,Cleveland State,Horizon,15,51,5,15,1,3,4,12,2,2,1,3,4,0,3,0,0,4,16
19320,Bernard Webb,2012,2012,Cal State Fullerton,Big West,9,33,8,11,8,11,0,0,0,1,4,1,5,0,0,1,5,7,16
19321,Justin Wesolowski,2009,2009,Northern Colorado,Big Sky,7,65,6,15,5,11,1,4,3,5,0,4,4,0,1,1,4,8,16
19322,Jack Westerfield,2016,2019,Dayton,A-10,22,75,5,18,1,5,4,13,2,4,1,3,4,1,2,0,1,3,16
19323,Keenan Wetzel,2012,2015,Michigan State,Big Ten,47,71,6,22,3,8,3,14,1,2,4,6,10,1,0,1,3,7,16
19324,Max Wiepking,2011,2013,Arizona,Total,20,36,5,8,1,1,4,7,2,5,0,8,8,0,0,0,1,2,16
19325,Travon Wilcher,2009,2012,Total,Total,25,138,7,19,7,18,0,1,2,3,8,18,26,2,4,9,11,25,16
19326,Tom Wilson,2017,2017,Southern Methodist,AAC,10,61,5,15,0,1,5,14,1,4,1,9,10,5,1,0,6,3,16
19327,Zach Winter,2016,2017,Kansas State,Big 12,28,50,6,18,2,7,4,11,0,0,2,4,6,3,3,0,4,2,16
19328,Rashad Wright,2010,2010,College of Charleston,Southern,26,172,5,11,5,11,0,0,6,13,10,22,32,2,5,22,7,35,16
19329,Austin Adams,2013,2014,Northwestern State,Southland,18,35,5,16,3,6,2,10,3,6,1,8,9,1,1,2,5,3,15
19330,Hampus Ahlin,2018,2018,Tennessee State,OVC,10,71,5,19,2,7,3,12,2,2,1,7,8,1,2,0,7,5,15
19331,Abdul Alatishe,2019,2019,Nicholls State,Southland,13,102,6,16,6,16,0,0,3,7,7,15,22,3,3,2,5,20,15
19332,Kevin Anderson,2010,2010,Cleveland State,Horizon,11,26,4,5,4,5,0,0,7,10,4,2,6,1,3,1,3,3,15
19333,Josh Armstrong,2011,2012,Jackson State,SWAC,21,199,5,22,5,21,0,1,5,6,6,24,30,5,5,2,9,11,15
19334,Austin Ash,2019,2019,Iowa,Big Ten,9,39,5,18,0,2,5,16,0,1,0,5,5,4,3,0,0,1,15
19335,Tavin Askew,2016,2016,Incarnate Word,Southland,12,67,7,16,7,16,0,0,1,4,5,7,12,0,2,1,1,15,15
19336,Brandon Baker,2008,2008,Jackson State,SWAC,25,137,6,20,6,20,0,0,3,8,6,8,14,5,0,8,6,20,15
19337,Ryan Barbre,2010,2010,Southern Methodist,CUSA,6,35,5,15,0,2,5,13,0,0,1,4,5,2,0,0,3,0,15
19338,Corey Barnes,2015,2015,Alcorn State,SWAC,7,41,5,16,1,3,4,13,1,4,0,2,2,0,1,0,5,8,15
19339,Levi Barnes,2011,2013,Samford,Southern,24,104,6,20,3,7,3,13,0,0,1,12,13,2,5,16,4,9,15
19340,Justice Bartley,2016,2018,Virginia,ACC,28,61,6,16,4,9,2,7,1,4,3,11,14,2,0,1,11,7,15
19341,Brennan Bechard,2008,2009,Kansas,Big 12,23,37,5,15,3,6,2,9,3,6,1,3,4,4,0,0,0,5,15
19342,T.J. Benson,2008,2009,Weber State,Big Sky,31,107,6,19,3,7,3,12,0,0,1,5,6,8,3,0,7,9,15
19343,Ricky Bieszki,2008,2009,Oakland,Summit,13,51,4,10,3,6,1,4,6,6,1,0,1,2,4,0,3,6,15
19344,Ryder Bowline,2014,2017,Elon,Total,14,34,6,12,3,3,3,9,0,4,2,4,6,3,1,0,4,7,15
19345,Brett Brady,2014,2016,Colorado,Pac-12,20,43,5,11,1,2,4,9,1,2,1,5,6,2,2,0,3,4,15
19346,Jean Francois Bro Grebe,2008,2008,Marshall,CUSA,20,83,7,14,7,14,0,0,1,5,3,14,17,2,0,14,7,14,15
19347,Chase Brogna,2013,2014,Ball State,MAC,17,140,5,26,1,4,4,22,1,2,3,1,4,7,2,0,3,16,15
19348,David Brown,2012,2015,UCLA,Pac-12,36,76,6,23,5,15,1,8,2,2,3,4,7,5,6,0,11,4,15
19349,Brandon Byars,2008,2008,Southern,SWAC,16,135,6,22,4,12,2,10,1,3,7,14,21,7,2,1,10,15,15
19350,Lucas Campbell,2016,2019,Tennessee,SEC,16,32,4,13,1,6,3,7,4,6,0,5,5,3,1,0,2,2,15
19351,Grayson Carter,2019,2019,Georgetown,Big East,14,66,5,18,2,9,3,9,2,6,5,9,14,2,2,2,7,15,15
19352,Cam Chambers,2011,2012,North Carolina-Wilmington,CAA,16,26,3,7,2,5,1,2,8,11,1,2,3,1,1,0,4,2,15
19353,Zeke Chapman,2012,2012,Ball State,MAC,11,83,5,22,2,2,3,20,2,2,1,4,5,1,3,0,4,1,15
19354,Can Civi,2008,2009,Davidson,Southern,28,86,6,21,3,6,3,15,0,0,2,4,6,8,2,0,11,5,15
19355,Christian Collins,2012,2013,Towson,CAA,18,24,4,5,1,1,3,4,4,6,0,2,2,4,2,0,1,0,15
19356,Matt Conway,2011,2011,Maryland-Baltimore County,AEC,16,58,6,19,3,8,3,11,0,0,1,7,8,0,2,1,2,5,15
19357,Deyon Cook,2012,2012,Towson,CAA,22,81,5,16,1,1,4,15,1,1,3,2,5,1,1,0,5,8,15
19358,Rousean Cromwell,2008,2008,Southern California,Pac-10,21,166,4,8,4,8,0,0,7,17,10,11,21,1,5,3,11,25,15
19359,Matt Darnell,2010,2010,NJIT,GWC,13,87,5,19,3,13,2,6,3,7,7,6,13,1,4,3,7,9,15
19360,Avery Davis,2019,2019,Winthrop,Big South,4,19,6,12,5,8,1,4,2,2,1,5,6,4,0,0,1,4,15
19361,Jay Jay Davis,2016,2018,Lehigh,Patriot,24,52,4,16,3,7,1,9,6,6,1,3,4,6,2,1,5,6,15
19362,Justin Dobbs,2013,2013,Grambling,SWAC,3,39,6,17,3,10,3,7,0,0,1,1,2,0,3,0,7,3,15
19363,Jeff Drew,2014,2014,Central Arkansas,Southland,8,105,7,21,6,20,1,1,0,0,7,15,22,2,4,4,11,25,15
19364,Dillon Dunford,2012,2012,Western Carolina,Southern,7,28,6,12,5,8,1,4,2,4,0,0,0,1,5,0,1,1,15
19365,C.J. Erickson,2009,2009,Evansville,MVC,14,51,6,13,6,12,0,1,3,7,2,5,7,2,1,1,4,7,15
19366,Dominic Ezeani,2017,2018,Longwood,Big South,39,143,6,14,6,12,0,2,3,9,3,12,15,8,6,0,4,15,15
19367,Matt Fraschilla,2014,2017,Harvard,Ivy,24,94,5,11,2,7,3,4,2,5,0,7,7,5,3,0,11,15,15
19368,Evan Garrison,2016,2016,Portland State,Big Sky,18,119,6,17,5,12,1,5,2,2,0,4,4,8,2,0,4,16,15
19369,Adam Glenville,2014,2016,Oral Roberts,Total,9,30,4,12,2,6,2,6,5,6,2,6,8,3,0,0,2,0,15
19370,Zach Graves,2008,2008,Montana,Big Sky,10,47,5,13,4,12,1,1,4,8,1,1,2,3,3,0,4,2,15
19371,Trevon Gross Jr.,2017,2019,Total,Total,39,124,6,28,3,12,3,16,0,5,8,13,21,7,6,0,8,15,15
19372,Jimmy Harding,2008,2011,Illinois-Chicago,Horizon,26,75,5,25,3,17,2,8,3,8,3,3,6,3,4,0,6,9,15
19373,Jeff Harris,2009,2012,Holy Cross,Patriot,19,54,4,12,2,4,2,8,5,5,2,5,7,9,4,0,9,4,15
19374,Deacon Heath,2019,2019,North Carolina-Asheville,Big South,16,101,5,12,3,6,2,6,3,5,2,2,4,4,1,0,3,6,15
19375,Greg Holley,2009,2010,Tennessee State,OVC,14,70,5,25,0,9,5,16,0,1,0,6,6,3,5,0,7,1,15
19376,Frank Holloway,2013,2013,Longwood,Big South,2,41,6,16,5,14,1,2,2,5,6,6,12,1,1,2,7,3,15
19377,Austin Hood,2010,2010,Illinois-Chicago,Horizon,6,41,5,13,3,7,2,6,3,5,0,3,3,0,1,0,2,5,15
19378,Jason Houle,2017,2018,Army,Patriot,11,55,5,22,0,3,5,19,0,0,1,3,4,1,1,0,3,4,15
19379,Logan Hovey,2015,2015,Florida Gulf Coast,A-Sun,14,92,6,14,6,13,0,1,3,9,8,16,24,3,2,1,3,11,15
19380,John Hubler,2015,2016,IUPUI,Summit,21,87,4,19,0,4,4,15,3,5,0,3,3,0,1,2,7,8,15
19381,Marcus Jackson,2010,2011,Arizona State,Pac-10,16,105,5,13,5,9,0,4,5,7,2,5,7,11,4,0,8,4,15
19382,Shaun James,2008,2008,Canisius,MAAC,10,85,5,14,5,14,0,0,5,13,8,11,19,0,2,2,10,8,15
19383,Tijan Jobe,2009,2010,Indiana,Big Ten,44,211,7,16,7,16,0,0,1,4,6,25,31,0,0,6,13,40,15
19384,Monty Johal,2019,2019,Tennessee State,OVC,4,29,5,12,2,4,3,8,2,4,3,5,8,2,1,0,3,5,15
19385,Devin Johnson,2008,2008,Fairfield,MAAC,21,133,6,21,5,18,1,3,2,6,7,7,14,10,6,1,13,12,15
19386,Ashton Khan,2011,2011,Canisius,MAAC,15,58,5,12,5,11,0,1,5,8,3,4,7,8,4,0,6,7,15
19387,Connor Klementowicz,2017,2019,Hofstra,CAA,17,48,6,11,3,6,3,5,0,4,7,2,9,4,0,0,3,1,15
19388,Ty Lazenby,2018,2019,Oklahoma,Big 12,27,131,6,20,4,11,2,9,1,2,4,12,16,4,5,1,8,19,15
19389,Chris Leppanen,2013,2013,Siena,MAAC,15,95,7,12,6,11,1,1,0,2,1,6,7,12,2,1,10,3,15
19390,Keshawn Liggins,2017,2017,Idaho State,Big Sky,15,94,6,12,6,11,0,1,3,8,11,10,21,3,4,0,1,11,15
19391,David Liss,2008,2008,University of California,Pac-10,17,101,5,10,2,2,3,8,2,2,1,3,4,17,0,1,6,5,15
19392,Miki Ljuboja,2015,2017,Brown,Ivy,17,48,5,10,4,5,1,5,4,4,2,6,8,1,3,1,7,4,15
19393,Chad Lutkenhaus,2011,2011,Florida Gulf Coast,A-Sun,23,134,6,19,4,6,2,13,1,2,1,12,13,5,4,0,7,11,15
19394,Chaz Mack,2019,2019,Cornell,Ivy,13,44,4,11,2,6,2,5,5,5,0,12,12,0,0,0,4,2,15
19395,Will Macoy,2017,2019,Auburn,SEC,25,48,4,16,2,5,2,11,5,9,1,4,5,1,3,2,1,2,15
19396,Georges Massoda,2011,2012,High Point,Big South,23,161,6,15,6,15,0,0,3,6,15,19,34,2,6,5,13,34,15
19397,Tayler Mattos,2019,2019,Bowling Green State,MAC,18,67,5,12,5,10,0,2,5,8,7,15,22,2,0,2,3,19,15
19398,Anderson McCoy,2018,2019,Alabama-Birmingham,CUSA,23,135,4,11,1,2,3,9,4,4,1,9,10,5,0,0,7,19,15
19399,Brian McDonald,2008,2010,Northeastern,CAA,28,83,6,14,3,4,3,10,0,0,3,9,12,3,2,0,1,7,15
19400,Lonnie McElwain,2015,2015,Grambling,SWAC,18,186,6,19,6,17,0,2,3,4,8,13,21,1,2,5,13,47,15
19401,Nate Mitchell,2010,2011,Southern Illinois,MVC,44,311,6,19,6,19,0,0,3,8,13,36,49,3,4,2,13,54,15
19402,Chall Montgomery,2012,2012,Navy,Patriot,11,58,3,13,2,4,1,9,8,11,0,7,7,1,2,1,7,10,15
19403,Hashim Moore,2014,2015,Princeton,Ivy,11,28,6,9,6,9,0,0,3,5,2,6,8,1,0,0,4,6,15
19404,Tevin Moore,2014,2014,Mississippi State,SEC,13,52,5,15,3,7,2,8,3,8,1,5,6,0,0,0,3,2,15
19405,Brady Moses,2017,2018,Stetson,A-Sun,11,23,5,8,2,2,3,6,2,2,1,5,6,0,0,0,1,2,15
19406,Omar Mostafa,2017,2018,William & Mary,CAA,14,27,5,10,2,4,3,6,2,4,0,1,1,3,3,0,2,1,15
19407,Brandon Neel,2016,2016,Wright State,Horizon,5,58,6,19,6,15,0,4,3,4,4,3,7,1,4,3,2,4,15
19408,Lucas Newton,2008,2010,Duquesne,A-10,22,87,4,10,1,2,3,8,4,6,0,2,2,7,2,0,9,9,15
19409,Denarius Odell,2014,2014,Alcorn State,SWAC,5,34,6,14,5,12,1,2,2,7,0,4,4,4,3,0,3,6,15
19410,Mogboluwaga Oginni,2013,2015,Creighton,Total,30,62,6,14,6,14,0,0,3,7,7,7,14,1,0,0,3,11,15
19411,Gaber Ozegovic,2019,2019,Cal State Fullerton,Big West,12,65,5,13,1,2,4,11,1,2,2,7,9,1,2,0,6,3,15
19412,Dean Pele,2008,2008,Stephen F. Austin,Southland,16,59,6,19,3,3,3,16,0,0,6,13,19,3,1,0,4,6,15
19413,Connor Perkey,2013,2017,Davidson,Total,27,46,4,5,3,4,1,1,6,6,2,6,8,0,1,0,1,6,15
19414,Ian Pinckney,2010,2010,Kent State,MAC,16,59,5,14,5,11,0,3,5,9,1,12,13,3,1,1,1,5,15
19415,Jamar Pope,2015,2015,Alabama State,SWAC,10,57,5,10,3,5,2,5,3,4,1,6,7,2,4,0,2,4,15
19416,Burleigh Porte,2009,2010,Milwaukee,Horizon,21,108,6,12,6,12,0,0,3,9,11,31,42,3,2,18,4,14,15
19417,A.J. Ratliff,2008,2008,Indiana,Big Ten,9,102,5,27,1,3,4,24,1,2,1,11,12,7,2,2,3,21,15
19418,Bennie Rhodes,2008,2008,Southern Methodist,CUSA,6,44,5,19,4,11,1,8,4,5,3,5,8,2,0,2,3,7,15
19419,Daniel Robinson,2014,2015,Iona,MAAC,12,78,7,14,7,14,0,0,1,3,5,8,13,0,1,7,2,16,15
19420,Richard Romeo,2013,2016,West Virginia,Big 12,28,55,5,12,4,9,1,3,4,4,2,6,8,3,0,0,4,10,15
19421,Kendall Salley,2011,2011,Howard,MEAC,10,89,3,10,3,10,0,0,9,14,1,5,6,4,1,0,8,12,15
19422,Karim Sameh Azab,2018,2018,Memphis,AAC,15,84,7,21,7,21,0,0,1,3,1,10,11,5,1,2,4,9,15
19423,Rico Seagears,2010,2010,Texas-Rio Grande Valley,GWC,25,164,6,26,5,15,1,11,2,5,8,7,15,4,5,0,11,23,15
19424,Derek Semenas,2011,2011,Green Bay,Horizon,13,65,6,18,5,16,1,2,2,5,4,7,11,5,3,1,5,11,15
19425,Reggie Shanks,2008,2008,Nicholls State,Southland,18,115,7,24,6,19,1,5,0,0,5,15,20,2,3,0,13,17,15
19426,Dominique Shaw,2016,2016,Prairie View,SWAC,8,59,4,16,4,13,0,3,7,13,4,5,9,2,4,0,1,8,15
19427,Djordjije Sljivancanin,2017,2017,Nevada-Las Vegas,MWC,10,47,6,11,3,7,3,4,0,0,1,4,5,1,0,1,1,2,15
19428,Ryan Spadaford,2013,2013,Navy,Patriot,12,50,4,19,2,7,2,12,5,8,7,6,13,1,4,0,2,9,15
19429,Dan Stockdale,2011,2013,North Dakota,Total,21,45,6,13,6,10,0,3,3,6,9,5,14,0,0,0,1,5,15
19430,Devan Straub,2019,2019,Evansville,MVC,12,52,5,15,2,3,3,12,2,2,0,1,1,4,2,0,1,3,15
19431,Ford Stuen,2013,2016,Oklahoma State,Big 12,27,53,6,13,4,6,2,7,1,1,1,6,7,5,1,0,3,1,15
19432,Tevin Swann,2010,2010,Mercer,A-Sun,23,72,4,9,4,9,0,0,7,10,0,11,11,8,5,0,5,11,15
19433,Jacob Talbert,2014,2017,Campbell,Big South,19,52,6,20,6,10,0,10,3,4,3,9,12,6,3,0,6,12,15
19434,Tom Taylor,2008,2009,Idaho State,Big Sky,27,146,7,18,7,18,0,0,1,5,5,18,23,1,1,8,6,21,15
19435,Javaka Thompson,2016,2017,Illinois State,MVC,25,54,6,15,5,8,1,7,2,4,1,8,9,1,0,1,2,6,15
19436,Quincy Tillinghast,2015,2017,Delaware State,MEAC,12,56,5,16,2,5,3,11,2,3,2,4,6,6,2,0,8,4,15
19437,Hippolyte Tsafack,2011,2013,Memphis,CUSA,17,56,5,9,5,9,0,0,5,8,2,4,6,0,0,1,3,11,15
19438,Jordan Turner,2010,2013,Pacific,Big West,48,182,6,24,4,17,2,7,1,3,14,26,40,12,6,2,7,16,15
19439,Travis Valmon,2017,2019,Maryland,Big Ten,19,37,5,10,3,6,2,4,3,5,3,5,8,1,2,1,6,5,15
19440,Jeff Van Dyke,2014,2014,Pepperdine,WCC,18,116,5,21,0,1,5,20,0,0,2,5,7,4,4,0,6,20,15
19441,Luke Walker,2016,2017,Louisiana Tech,CUSA,25,54,6,18,6,18,0,0,3,7,1,9,10,1,2,0,4,8,15
19442,Reynold Walters,2008,2008,Central Michigan,MAC,27,241,5,12,5,12,0,0,5,11,7,16,23,10,10,0,14,42,15
19443,Jerron Washington,2015,2015,Little Rock,Sun Belt,22,126,5,23,5,21,0,2,5,10,1,16,17,3,4,1,7,12,15
19444,Judd Welfringer,2012,2012,Drake,MVC,13,134,5,19,2,3,3,16,2,4,5,16,21,9,6,1,6,18,15
19445,Clark Wilkinson,2017,2017,Idaho State,Big Sky,16,65,4,9,4,9,0,0,7,9,3,7,10,1,0,0,1,16,15
19446,Jerelle Wilson,2008,2010,San Jose State,WAC,22,68,6,11,5,8,1,3,2,5,4,12,16,2,1,0,5,14,15
19447,Jack Wooten,2008,2009,North Carolina,ACC,37,70,6,18,4,8,2,10,1,4,2,9,11,5,0,1,2,3,15
19448,Jamion Wright,2018,2019,Sacramento State,Big Sky,22,78,5,15,0,2,5,13,0,1,1,4,5,1,2,0,7,13,15
19449,Denzel Yard,2010,2010,Siena,MAAC,8,43,5,12,3,7,2,5,3,4,1,7,8,2,3,0,8,4,15
19450,Clay Young,2016,2018,Kansas,Big 12,32,111,5,12,5,9,0,3,5,11,1,10,11,9,2,1,4,12,15
19451,Cale Zuiker,2012,2012,Youngstown State,Horizon,14,45,5,13,0,2,5,11,0,0,0,2,2,0,2,2,2,3,15
19452,Thomas Abercrombie,2008,2008,Washington State,Pac-10,12,87,5,19,3,8,2,11,2,5,5,13,18,6,2,3,4,10,14
19453,Alex Anglin,2008,2011,Butler,Horizon,43,121,5,13,3,9,2,4,2,3,6,12,18,6,0,3,4,12,14
19454,Lucas Antunez,2017,2017,Toledo,MAC,17,89,2,12,1,6,1,6,9,10,1,4,5,10,1,0,8,16,14
19455,Jon Atkins,2009,2009,Air Force,MWC,12,67,4,13,1,6,3,7,3,9,2,13,15,5,2,0,5,3,14
19456,C.J. Baird,2018,2019,Michigan,Big Ten,18,31,5,13,1,3,4,10,0,0,1,2,3,1,0,1,2,0,14
19457,Jake Baughman,2017,2019,Loyola (IL),MVC,26,54,4,7,3,5,1,2,5,10,1,4,5,2,1,0,2,3,14
19458,Mike Bedulskis,2014,2014,North Carolina-Asheville,Big South,6,18,4,7,4,7,0,0,6,9,3,5,8,0,1,0,1,2,14
19459,Hichem Benayad-Cherif,2012,2012,Purdue-Fort Wayne,Summit,6,17,3,8,2,7,1,1,7,12,6,2,8,0,0,0,2,3,14
19460,Sean Billerman,2012,2015,Army,Patriot,15,36,4,12,2,3,2,9,4,7,0,3,3,3,0,0,0,1,14
19461,Jerome Blockmon,2009,2009,Sacramento State,Big Sky,21,97,5,12,5,9,0,3,4,6,0,2,2,3,2,0,8,9,14
19462,Wayne Bradford,2013,2013,Weber State,Big Sky,13,55,5,12,5,9,0,3,4,7,2,5,7,7,0,0,6,5,14
19463,Bryson Brewer,2008,2010,Southern Mississippi,CUSA,30,129,5,13,4,8,1,5,3,3,5,10,15,8,0,0,11,15,14
19464,Chris Brickley,2010,2010,Louisville,Big East,8,31,6,8,4,6,2,2,0,2,1,2,3,3,1,0,1,0,14
19465,Carter Brooks,2019,2019,North Dakota,Summit,12,95,5,14,3,7,2,7,2,2,3,16,19,2,2,2,2,12,14
19466,Jacob Brown,2018,2018,Youngstown State,Horizon,10,54,5,14,4,5,1,9,3,4,2,8,10,2,3,1,2,7,14
19467,Myk Brown,2008,2008,Virginia Commonwealth,CAA,15,43,5,20,2,11,3,9,1,5,4,6,10,2,1,0,2,5,14
19468,Shandon Brown,2019,2019,George Washington,A-10,29,225,3,25,0,8,3,17,5,10,1,19,20,16,7,0,18,24,14
19469,Amaru Bryant,2019,2019,Savannah State,MEAC,7,44,6,18,4,10,2,8,0,0,3,3,6,3,2,0,5,3,14
19470,Bryan Burrell,2010,2011,Gardner-Webb,Big South,33,123,5,12,5,12,0,0,4,10,6,10,16,11,5,0,14,18,14
19471,Alex Carr,2012,2012,Louisiana Tech,WAC,16,101,5,26,1,6,4,20,0,0,3,5,8,1,3,3,2,13,14
19472,Ed Carter III,2017,2017,Detroit Mercy,Horizon,20,104,4,30,2,13,2,17,4,5,3,11,14,14,4,0,8,12,14
19473,Mashawn Chamberlain,2013,2013,Chicago State,GWC,24,250,6,20,5,15,1,5,1,2,5,16,21,9,9,0,11,28,14
19474,Zach Chu,2012,2015,Richmond,A-10,8,15,4,6,0,0,4,6,2,2,1,1,2,2,0,0,2,2,14
19475,George Cotal,2008,2008,Youngstown State,Horizon,28,206,4,26,3,17,1,9,5,14,3,23,26,13,5,4,14,37,14
19476,Justin Cotten,2018,2019,Howard,MEAC,25,74,5,24,3,9,2,15,2,2,1,10,11,14,4,0,6,4,14
19477,Drew Davis,2017,2018,Mississippi State,SEC,14,29,5,17,2,9,3,8,1,2,1,2,3,4,1,0,4,1,14
19478,Hank Davis,2014,2017,La Salle,A-10,19,29,4,9,4,7,0,2,6,8,1,0,1,3,1,0,3,7,14
19479,David Dejulius,2019,2019,Michigan,Big Ten,25,95,6,30,5,15,1,15,1,6,1,11,12,5,5,0,5,11,14
19480,Nick Detlev,2016,2017,Tennessee-Martin,OVC,13,30,6,9,6,9,0,0,2,4,1,5,6,0,0,5,3,4,14
19481,Jose Diaz,2011,2012,South Alabama,Sun Belt,20,69,5,15,4,10,1,5,3,4,2,4,6,5,1,0,7,4,14
19482,Cem Dinc,2008,2008,Harvard,Ivy,10,81,6,20,6,15,0,5,2,7,4,7,11,3,1,3,6,13,14
19483,Anthony Dixon,2010,2010,San Jose State,WAC,21,70,6,14,6,13,0,1,2,8,2,9,11,1,0,0,3,7,14
19484,Lewis Djonkam,2018,2018,Virginia Commonwealth,A-10,20,69,4,11,4,11,0,0,6,12,5,3,8,2,2,3,4,17,14
19485,Greg Donlon,2013,2017,Virginia Tech,ACC,27,37,5,10,5,10,0,0,4,6,1,7,8,0,0,1,1,3,14
19486,Michael Donovan,2015,2015,Virginia Military Institute,Southern,12,57,4,12,0,1,4,11,2,2,4,7,11,2,0,0,2,8,14
19487,Francis Edosomwan,2012,2015,East Carolina,Total,29,61,5,10,5,9,0,1,4,10,10,11,21,3,4,0,4,7,14
19488,BJ Edwards,2015,2015,Jacksonville,A-Sun,27,342,5,40,5,38,0,2,4,10,5,18,23,32,9,4,18,30,14
19489,David Fine,2009,2009,Binghamton,AEC,16,63,6,12,5,9,1,3,1,4,0,1,1,3,4,0,10,4,14
19490,Wesley Fritz,2011,2012,Sam Houston State,Southland,18,54,4,6,4,4,0,2,6,8,4,4,8,4,0,0,3,1,14
19491,Kamil Gawrzydek,2011,2011,Idaho State,Big Sky,23,115,4,9,4,9,0,0,6,13,9,7,16,2,2,4,8,18,14
19492,Beau Gerber,2008,2010,Oklahoma,Big 12,37,74,6,12,6,12,0,0,2,3,6,10,16,2,1,0,8,9,14
19493,Grant Gibb,2017,2018,Eastern Washington,Big Sky,21,45,4,12,3,8,1,4,5,9,2,8,10,2,1,2,2,4,14
19494,Tavis Gibson,2015,2015,Alcorn State,SWAC,24,127,4,30,0,2,4,28,2,3,0,5,5,6,7,0,9,6,14
19495,Adam Giles,2017,2019,Wright State,Horizon,28,67,5,14,4,12,1,2,3,8,4,3,7,3,3,0,3,4,14
19496,Michael Glasker,2011,2011,North Carolina Central,Ind,22,143,3,9,2,6,1,3,7,12,1,3,4,29,5,0,18,8,14
19497,Khiry Gordon,2010,2011,Fordham,A-10,11,105,7,18,7,18,0,0,0,1,11,13,24,4,7,8,9,15,14
19498,Dominic Green,2008,2008,George Washington,A-10,20,99,6,17,4,11,2,6,0,1,4,12,16,5,1,0,7,11,14
19499,Mark Hall,2015,2015,Illinois State,MVC,9,57,6,15,6,10,0,5,2,2,1,4,5,8,0,0,4,4,14
19500,Chris Halvorsen,2010,2013,Total,Total,25,71,5,8,5,8,0,0,4,11,4,12,16,9,2,0,5,10,14
19501,Austin Harriott,2017,2017,Loyola (MD),Patriot,16,96,5,13,5,11,0,2,4,7,7,9,16,0,3,0,4,21,14
19502,T.K. Hayes,2014,2017,Furman,Southern,29,61,4,17,3,7,1,10,5,8,1,6,7,3,1,0,6,2,14
19503,Lauren Heard,2008,2008,Long Beach State,Big West,11,67,5,18,2,9,3,9,1,2,0,1,1,1,1,0,4,2,14
19504,Willie Herenton,2019,2019,Miami (FL),ACC,15,30,4,11,0,1,4,10,2,2,1,1,2,0,0,0,0,2,14
19505,Ryan Herrion,2009,2012,New Hampshire,AEC,36,113,4,25,0,2,4,23,2,6,3,4,7,8,3,0,5,8,14
19506,Lloyd Hickinson,2011,2011,Southern,SWAC,8,65,4,19,1,10,3,9,3,4,3,6,9,2,1,2,3,10,14
19507,Adam Highberger,2009,2010,Penn State,Big Ten,13,65,5,18,1,3,4,15,0,1,0,3,3,2,1,0,4,6,14
19508,Will Holifield,2014,2014,Southeast Missouri State,OVC,9,38,5,11,1,2,4,9,0,0,0,2,2,1,1,0,1,5,14
19509,Radin Hughes,2015,2015,South Carolina State,MEAC,15,83,5,17,5,16,0,1,4,9,4,5,9,7,2,0,11,10,14
19510,Cortez Irby,2010,2010,Kennesaw State,A-Sun,18,98,5,34,3,6,2,28,2,2,8,11,19,7,5,0,3,8,14
19511,Jamil Jackson,2018,2018,Southern Utah,Big Sky,5,71,6,14,6,11,0,3,2,2,1,1,2,5,2,1,3,9,14
19512,Charles Jim-George,2008,2008,UC-Riverside,Big West,13,81,4,20,1,7,3,13,3,5,6,9,15,2,1,0,2,4,14
19513,Jalen Johnson,2019,2019,Murray State,OVC,19,56,5,22,3,7,2,15,2,6,1,8,9,7,1,0,2,7,14
19514,Kevin Johnson,2008,2008,Milwaukee,Horizon,9,69,5,17,2,10,3,7,1,7,6,7,13,2,1,0,4,12,14
19515,Nick Jorgensen,2014,2014,Air Force,MWC,11,127,5,15,3,8,2,7,2,6,7,15,22,5,2,1,2,15,14
19516,Matt Kleinmann,2008,2009,Kansas,Big 12,37,79,6,12,6,12,0,0,2,6,10,14,24,2,0,3,3,11,14
19517,Mac Lake,2012,2014,Presbyterian,Big South,21,95,5,15,3,7,2,8,2,2,5,10,15,10,1,0,3,9,14
19518,Trey Lang,2008,2011,Massachusetts,A-10,21,66,4,7,4,7,0,0,6,9,4,11,15,1,0,3,1,9,14
19519,Probese Leo,2009,2012,Bucknell,Patriot,41,114,6,14,6,14,0,0,2,7,9,17,26,1,3,8,8,24,14
19520,Cameron Loepker,2013,2013,IUPUI,Summit,14,59,6,11,6,10,0,1,2,4,2,10,12,3,0,0,8,21,14
19521,Callum Long,2014,2014,Air Force,MWC,7,76,4,10,2,3,2,7,4,5,1,7,8,6,1,1,11,11,14
19522,Nick Mabbutt,2012,2012,South Dakota,Summit,8,86,5,17,1,3,4,14,0,4,3,14,17,7,3,3,8,14,14
19523,Ege Mala,2014,2014,UC-Irvine,Big West,13,45,5,13,4,10,1,3,3,4,4,2,6,3,0,2,2,6,14
19524,Vincent Martin,2010,2010,Arkansas-Pine Bluff,SWAC,10,61,5,20,3,10,2,10,2,5,6,6,12,4,2,1,4,7,14
19525,David Mason,2014,2014,Oral Roberts,Southland,10,58,6,13,5,10,1,3,1,2,3,5,8,14,2,0,7,5,14
19526,Trevor Mason,2011,2012,Missouri-Kansas City,Summit,15,53,4,11,2,9,2,2,4,7,1,3,4,3,3,0,5,9,14
19527,John McCarty,2015,2018,Central Michigan,MAC,20,43,6,14,4,6,2,8,0,0,4,6,10,2,2,0,1,4,14
19528,Kyle McCloskey,2019,2019,Penn State,Big Ten,11,82,5,12,3,6,2,6,2,6,7,4,11,3,1,2,2,4,14
19529,John Middleton,2016,2016,Utah State,MWC,8,49,4,13,3,9,1,4,5,8,1,3,4,0,2,0,1,5,14
19530,Justice Montgomery,2014,2015,American,Patriot,32,160,4,22,3,15,1,7,5,16,3,5,8,16,4,0,16,26,14
19531,Wade Moody,2013,2014,North Carolina,ACC,25,43,5,13,1,5,4,8,0,0,1,0,1,8,1,0,5,5,14
19532,Zach Naylor,2019,2019,Mississippi,SEC,19,88,5,12,3,5,2,7,2,2,7,10,17,5,2,1,6,11,14
19533,Jacob Neubert,2011,2013,Baylor,Big 12,32,59,6,20,6,18,0,2,2,4,7,9,16,2,2,2,5,6,14
19534,Domen Omladic,2018,2018,Tennessee Tech,OVC,12,46,7,13,7,11,0,2,0,0,3,7,10,1,1,0,4,14,14
19535,Trevor Osborn,2014,2017,Purdue-Fort Wayne,Summit,26,53,3,17,2,6,1,11,7,9,2,5,7,5,3,0,4,3,14
19536,Nathan Payne,2018,2019,Charleston Southern,Big South,16,51,5,16,5,16,0,0,4,11,10,6,16,0,0,1,1,7,14
19537,Cordell Pope,2008,2008,Central Florida,CUSA,7,47,5,19,2,5,3,14,1,3,1,3,4,4,3,1,2,3,14
19538,Patrick Ramsey,2013,2014,Marist,MAAC,14,31,5,10,1,2,4,8,0,1,1,3,4,0,1,0,0,3,14
19539,Joseph Reed,2008,2008,Mississippi Valley State,SWAC,11,67,6,12,6,12,0,0,2,6,5,6,11,2,1,1,3,19,14
19540,Cal Reichwein,2017,2019,Lafayette,Patriot,21,44,6,19,5,8,1,11,1,2,0,2,2,9,2,0,4,0,14
19541,Michael Ritchie,2018,2019,Miami (OH),MAC,17,30,4,14,1,4,3,10,3,5,6,5,11,2,2,0,2,2,14
19542,Alex Roberts,2010,2010,Chicago State,GWC,22,64,5,15,3,6,2,9,2,6,3,2,5,1,2,1,4,5,14
19543,Julian Roche,2018,2018,Santa Clara,WCC,6,32,6,8,6,8,0,0,2,2,4,1,5,0,1,1,2,4,14
19544,Jack Ryan,2012,2014,Stanford,Pac-12,18,46,5,7,4,5,1,2,3,4,2,8,10,2,4,0,2,5,14
19545,Andy Saharan,2011,2011,UC-Riverside,Big West,14,100,5,23,1,7,4,16,0,1,0,5,5,1,0,0,2,2,14
19546,Atakan Sahinkaya,2019,2019,Troy,Sun Belt,10,37,5,11,3,8,2,3,2,4,2,4,6,2,4,1,2,9,14
19547,Anias Saunders,2018,2019,Radford,Big South,18,30,4,9,0,2,4,7,2,2,1,2,3,1,0,0,2,1,14
19548,Darian Scott,2019,2019,Missouri State,MVC,22,150,6,21,6,21,0,0,2,6,12,11,23,4,3,6,8,25,14
19549,Darius Scott,2014,2015,Alabama State,SWAC,21,61,6,15,5,11,1,4,1,1,1,4,5,4,0,2,3,9,14
19550,Jayvian Scranton,2012,2012,Prairie View,SWAC,12,39,5,20,4,14,1,6,3,7,5,3,8,1,5,0,3,4,14
19551,John Scully,2019,2019,Army,Patriot,3,32,5,16,1,1,4,15,0,0,0,2,2,3,3,0,0,5,14
19552,Sharife Sergeant,2014,2014,Stephen F. Austin,Southland,20,66,4,12,4,12,0,0,6,13,3,5,8,1,1,2,4,12,14
19553,Will Sinclair,2012,2013,Utah Valley,GWC,37,192,4,14,4,14,0,0,6,13,12,27,39,4,1,9,8,26,14
19554,Aaron Smith,2010,2013,Elon,Southern,16,31,5,19,3,7,2,12,2,2,1,2,3,0,2,0,1,0,14
19555,Andrew Sorrells,2016,2019,Texas Tech,Big 12,34,92,4,21,2,7,2,14,4,5,1,7,8,6,4,0,4,9,14
19556,Jonas Stalyga,2013,2013,Akron,MAC,5,7,5,10,2,4,3,6,1,5,1,1,2,0,0,0,0,0,14
19557,Austin Stone,2018,2018,Portland,WCC,9,48,5,13,4,11,1,2,3,4,3,12,15,2,1,1,0,5,14
19558,Chris Tang,2015,2015,UC-Riverside,Big West,10,39,6,11,4,7,2,4,0,2,2,6,8,3,0,0,1,4,14
19559,Blake Thompson,2008,2009,Georgia Southern,Southern,16,55,4,16,1,7,3,9,3,4,2,6,8,2,2,0,4,1,14
19560,Brandon Thompson,2015,2015,Citadel,Southern,10,36,5,10,1,3,4,7,0,0,0,1,1,2,0,0,1,4,14
19561,Myles Thornton,2017,2018,Incarnate Word,Southland,34,70,4,9,2,2,2,7,4,5,0,10,10,0,2,1,1,9,14
19562,Shawn Tobey,2008,2008,New Hampshire,AEC,12,81,5,10,4,8,1,2,3,4,6,8,14,1,1,2,2,12,14
19563,Jason Tolliver,2008,2009,Arkansas-Pine Bluff,SWAC,11,49,6,16,6,13,0,3,2,5,1,5,6,2,2,0,3,4,14
19564,Tyson Tufono,2012,2012,Alcorn State,SWAC,20,81,5,16,1,3,4,13,0,0,0,3,3,4,0,0,6,8,14
19565,Dave Vanerjagt,2008,2008,Montana,Big Sky,13,74,7,11,7,10,0,1,0,2,6,11,17,2,2,5,4,9,14
19566,Riley Welch,2018,2018,UC-Irvine,Big West,27,143,4,13,2,5,2,8,4,5,2,12,14,15,2,0,7,22,14
19567,McCall Wollman,2009,2010,Southern,SWAC,20,135,6,38,6,25,0,13,2,2,5,8,13,3,5,1,12,12,14
19568,Surry Wood,2008,2008,North Carolina,ACC,17,34,6,11,6,11,0,0,2,6,3,5,8,1,0,0,3,3,14
19569,Zach Yoshor,2015,2018,Harvard,Ivy,22,54,5,11,1,5,4,6,0,2,2,7,9,1,0,0,2,3,14
19570,Zack Zaragoza,2009,2009,Northern Arizona,Big Sky,7,43,5,18,1,3,4,15,0,0,0,7,7,5,2,0,2,7,14
19571,Shane Acoveno,2018,2019,Lehigh,Patriot,15,47,6,8,5,7,1,1,0,0,4,3,7,0,0,1,4,8,13
19572,Tunde Agboola,2008,2010,Boston University,AEC,21,68,6,12,5,10,1,2,0,1,3,4,7,1,3,0,2,9,13
19573,Pietro Agostini,2019,2019,Kennesaw State,A-Sun,13,51,4,13,3,9,1,4,4,6,2,6,8,0,4,0,1,9,13
19574,Regan Andersen,2009,2009,Cal State Fullerton,Big West,10,38,4,10,4,9,0,1,5,5,2,10,12,1,1,1,2,5,13
19575,Calvin Anderson,2018,2019,Louisiana-Monroe,Sun Belt,9,62,4,18,2,7,2,11,3,4,1,15,16,3,0,0,5,3,13
19576,K.C. Anuna,2009,2011,Middle Tennessee,Sun Belt,13,18,5,9,4,6,1,3,2,2,2,1,3,0,0,0,1,1,13
19577,Nick Arenz,2013,2013,Green Bay,Horizon,16,96,4,10,4,7,0,3,5,6,3,8,11,2,1,3,3,20,13
19578,Kwe Askew,2017,2017,Long Island University,NEC,15,84,5,12,5,12,0,0,3,5,5,12,17,2,1,6,2,11,13
19579,Cornell Barnett,2013,2013,Louisiana,Sun Belt,23,103,5,16,5,16,0,0,3,9,5,12,17,1,3,3,8,22,13
19580,Joseph Battle,2017,2017,Tulsa,AAC,13,51,5,15,4,12,1,3,2,2,3,6,9,0,0,0,3,7,13
19581,Tyler Behrendt,2019,2019,Milwaukee,Horizon,11,43,4,9,3,6,1,3,4,4,1,3,4,5,1,0,2,6,13
19582,Admir Besovic,2018,2018,Montana,Big Sky,18,31,6,9,6,9,0,0,1,1,2,3,5,1,0,1,2,10,13
19583,Cole Blackstock,2016,2019,Auburn,SEC,32,55,1,3,1,3,0,0,11,13,2,9,11,1,0,3,0,17,13
19584,Ashwell Boyd,2014,2014,Delaware State,MEAC,9,32,5,10,5,10,0,0,3,5,3,2,5,1,2,0,2,11,13
19585,Doug Browman,2010,2013,Virginia,ACC,35,159,4,10,1,1,3,9,2,6,2,20,22,18,4,0,13,21,13
19586,Gabe Brown,2015,2016,American,Patriot,15,62,5,16,5,16,0,0,3,5,6,2,8,5,0,6,8,7,13
19587,Jarrett Brown,2008,2008,West Virginia,Big East,13,46,4,9,1,3,3,6,2,2,2,6,8,0,2,0,3,2,13
19588,Richard Brown,2014,2017,Army,Patriot,40,155,5,21,4,9,1,12,2,4,13,15,28,9,4,1,11,12,13
19589,Armon Brummett,2019,2019,Bradley,MVC,24,139,5,29,5,13,0,16,3,8,2,14,16,7,11,2,12,16,13
19590,Greg Cage,2008,2010,Alabama,SEC,16,49,5,15,4,8,1,7,2,5,4,0,4,1,1,0,4,3,13
19591,Nathan Campbell,2008,2008,Liberty,Big South,15,42,6,8,6,8,0,0,1,2,2,7,9,1,0,0,2,2,13
19592,Ryan Carmello,2018,2019,Marist,MAAC,21,36,5,7,5,6,0,1,3,10,2,1,3,2,1,0,4,1,13
19593,Marcus Carter,2008,2008,Portland,WCC,15,107,6,23,5,17,1,6,0,1,6,9,15,8,2,1,9,3,13
19594,Ian Clark ,2013,2013,Cal State Northridge,Big West,14,48,4,9,2,3,2,6,3,5,0,5,5,5,4,0,7,7,13
19595,Kaleb Clyburn,2011,2011,Delaware,CAA,17,104,4,13,4,5,0,8,5,6,3,7,10,7,3,0,4,20,13
19596,Tom Cotter,2015,2018,Oakland,Horizon,23,111,5,15,5,15,0,0,3,5,7,19,26,2,0,0,5,14,13
19597,Matthue Cotton,2019,2019,Yale,Ivy,16,89,5,25,3,9,2,16,1,2,5,11,16,4,2,1,4,9,13
19598,Stephen Cox,2008,2010,Arkansas,SEC,51,169,2,10,2,10,0,0,9,14,7,18,25,10,11,1,4,18,13
19599,Jordan Davidson,2008,2010,Duke,ACC,34,75,3,10,2,6,1,4,6,12,3,2,5,6,2,0,5,8,13
19600,Brandon Davis,2008,2011,Total,Total,23,81,5,18,3,8,2,10,1,4,5,5,10,6,3,0,9,5,13
19601,Justin Diecker,2015,2015,Kennesaw State,A-Sun,12,78,5,13,5,13,0,0,3,6,1,6,7,1,1,3,7,26,13
19602,Ellis Dozier,2017,2018,Ohio,MAC,23,68,6,21,6,17,0,4,1,5,3,3,6,0,0,1,5,10,13
19603,Edmunds Dukulis,2014,2014,Boise State,MWC,9,47,6,12,6,12,0,0,1,6,4,12,16,1,0,1,2,7,13
19604,Will Dunn,2014,2014,Purdue-Fort Wayne,Summit,15,51,5,10,5,8,0,2,3,10,0,2,2,0,0,0,2,3,13
19605,Austin Eastman,2014,2016,Utah,Pac-12,33,78,2,13,0,3,2,10,7,10,3,10,13,5,3,2,5,6,13
19606,Blake Edwards,2016,2017,South Carolina Upstate,A-Sun,11,19,4,8,0,0,4,8,1,2,0,3,3,1,1,0,2,1,13
19607,Ifeanyi Eke,2011,2013,Louisiana-Monroe,Sun Belt,14,79,6,12,6,12,0,0,1,5,5,11,16,1,2,2,3,13,13
19608,Alex Eppensteiner,2010,2013,Cincinnati,Big East,28,50,4,13,3,9,1,4,4,8,0,3,3,7,3,0,3,5,13
19609,Ikem Eriobuna,2016,2016,Missouri-Kansas City,WAC,8,44,3,11,1,4,2,7,5,6,2,5,7,1,0,0,2,3,13
19610,Dan Fahey,2010,2013,Wisconsin,Big Ten,27,51,4,8,4,7,0,1,5,6,3,11,14,2,1,1,3,1,13
19611,Kamau Faines,2015,2017,Davidson,A-10,18,23,4,8,3,6,1,2,4,8,0,0,0,0,0,0,1,1,13
19612,Zach Flener,2018,2019,Lipscomb,A-Sun,21,54,4,10,2,5,2,5,3,3,0,7,7,4,0,0,6,6,13
19613,Brad Gilson,2013,2013,Columbia,Ivy,7,35,4,12,1,1,3,11,2,2,0,4,4,1,0,0,1,4,13
19614,Kevin Gray,2011,2011,Morehead State,OVC,17,61,5,19,4,6,1,13,2,2,3,1,4,7,4,0,1,7,13
19615,Grant Greabel,2019,2019,Sacramento State,Big Sky,9,44,5,12,3,3,2,9,1,3,1,9,10,3,1,0,0,2,13
19616,Connor Griffin,2014,2015,Gonzaga,WCC,29,88,4,9,4,9,0,0,5,10,3,12,15,2,5,2,3,18,13
19617,Alex Grimsley,2009,2010,Kent State,MAC,31,103,4,10,3,9,1,1,4,10,11,6,17,3,4,0,11,13,13
19618,Elijah Hardy,2019,2019,Washington,Pac-12,11,18,5,10,2,4,3,6,0,0,0,0,0,0,1,0,2,2,13
19619,Jordan Herrera,2012,2012,North Carolina A&T,MEAC,5,64,3,20,3,10,0,10,7,10,2,8,10,1,1,0,3,10,13
19620,James Herring,2011,2011,Dartmouth,Ivy,17,52,5,17,2,9,3,8,0,0,0,2,2,1,1,0,3,3,13
19621,Michael Higgins,2008,2008,Mississippi Valley State,SWAC,12,38,6,10,5,5,1,5,0,0,3,10,13,1,3,0,2,4,13
19622,Rick Higgins,2008,2008,Cal Poly,Big West,21,100,4,27,2,6,2,21,3,4,2,6,8,2,1,0,7,14,13
19623,Ronald Horne,2008,2008,North Texas,Sun Belt,8,30,5,12,2,8,3,4,0,1,0,5,5,0,1,0,0,4,13
19624,Michael Hubert,2009,2011,Tennessee,SEC,14,21,4,9,0,0,4,9,1,2,2,2,4,2,1,0,3,0,13
19625,Chad Hudson,2017,2018,IUPUI,Total,18,50,3,10,2,4,1,6,6,11,0,4,4,4,1,0,5,10,13
19626,Daniel Huenermann,2018,2019,Indiana State,MVC,17,44,5,10,5,9,0,1,3,5,1,5,6,0,0,0,2,9,13
19627,Julien Johnson,2014,2016,North Carolina A&T,MEAC,16,48,3,13,2,7,1,6,6,7,7,3,10,0,1,0,3,7,13
19628,Tariq Johnson,2019,2019,Wyoming,MWC,10,71,3,13,1,6,2,7,5,8,2,3,5,0,0,0,4,8,13
19629,Deante Jones,2009,2009,Texas Southern,SWAC,13,80,4,7,4,7,0,0,5,9,5,12,17,2,3,4,4,12,13
19630,Gerald Jones,2011,2011,Southern Illinois-Edwardsville,Ind,3,45,2,8,2,8,0,0,9,16,0,6,6,5,3,1,6,4,13
19631,John Joyce,2018,2018,Chicago State,WAC,5,44,5,17,2,4,3,13,0,0,2,2,4,1,2,0,2,5,13
19632,Grant Kersey,2019,2019,Virginia,ACC,10,17,3,3,1,1,2,2,5,5,1,1,2,1,2,0,2,0,13
19633,Schyler King,2008,2008,Penn State,Big Ten,13,77,5,19,2,4,3,15,0,3,3,11,14,2,3,1,0,3,13
19634,Tyler Lange,2011,2012,Northern Iowa,MVC,25,70,4,12,4,9,0,3,5,9,8,9,17,2,2,0,4,8,13
19635,Bryce Leavitt,2013,2013,Washington State,Pac-12,20,113,2,8,2,7,0,1,9,10,1,6,7,12,4,1,7,9,13
19636,Andrew Leone,2014,2017,Fairfield,MAAC,27,39,1,10,0,1,1,9,10,12,1,5,6,4,0,0,2,2,13
19637,Luke Litwiller,2018,2018,Illinois State,MVC,10,49,5,8,2,2,3,6,0,0,1,3,4,0,2,0,1,8,13
19638,Josh Lockett,2011,2011,Southeastern Louisiana,Southland,9,57,6,13,6,13,0,0,1,2,4,12,16,2,3,4,3,12,13
19639,John Love,2013,2013,Prairie View,SWAC,6,24,3,14,1,4,2,10,5,6,1,1,2,1,1,0,2,2,13
19640,Matt Maloney,2016,2019,Manhattan,MAAC,24,86,4,15,1,2,3,13,2,4,1,5,6,0,2,1,4,18,13
19641,Austin Mankin,2014,2016,Oklahoma,Big 12,34,105,4,16,2,10,2,6,3,4,3,11,14,5,1,0,2,8,13
19642,Marshawn Martin,2009,2009,Coastal Carolina,Big South,12,41,5,15,2,5,3,10,0,2,2,5,7,2,2,0,6,8,13
19643,Josh Mballa,2019,2019,Texas Tech,Big 12,17,57,4,9,4,7,0,2,5,14,2,3,5,2,2,2,4,6,13
19644,Khalid McCaskill,2013,2015,Total,Total,9,42,6,15,5,10,1,5,0,1,2,7,9,1,1,1,3,6,13
19645,Ryan McClurg,2015,2018,Texas,Big 12,15,38,4,7,4,7,0,0,5,9,5,2,7,1,0,0,4,6,13
19646,Ivory McGilvery,2008,2009,Prairie View,SWAC,23,81,5,25,4,13,1,12,2,3,6,7,13,2,1,1,8,5,13
19647,Mason McMurray,2019,2019,Ohio,MAC,9,52,5,14,4,5,1,9,2,2,3,6,9,3,1,1,4,9,13
19648,John Moody,2010,2013,Elon,Southern,20,47,5,8,4,7,1,1,2,4,3,10,13,2,3,1,5,9,13
19649,Alan Mozee,2008,2008,Long Island University,NEC,13,44,4,8,0,1,4,7,1,2,1,1,2,4,2,0,4,4,13
19650,Samba Ndiaye,2018,2019,College of Charleston,CAA,23,85,4,13,4,13,0,0,5,8,12,15,27,0,1,6,8,24,13
19651,DeAndre Nealy,2011,2011,Kent State,MAC,13,85,5,13,5,13,0,0,3,6,11,9,20,2,1,0,4,10,13
19652,Kazadi Nyanguila,2011,2011,New Hampshire,AEC,10,80,5,12,5,12,0,0,3,4,1,11,12,2,0,0,4,11,13
19653,Obim Okeke,2018,2019,Baylor,Big 12,16,53,5,19,2,3,3,16,0,0,2,3,5,3,3,0,5,8,13
19654,Charles Oliver,2012,2012,Rider,MAAC,13,85,4,17,2,8,2,9,3,7,2,5,7,1,3,0,3,5,13
19655,Melvyn Oliver,2010,2010,Seton Hall,Big East,7,40,5,11,5,11,0,0,3,7,3,10,13,3,1,3,3,12,13
19656,Chris Page,2013,2013,Albany (NY),AEC,9,37,5,17,3,6,2,11,1,2,1,0,1,2,2,1,1,4,13
19657,Jonas Page,2014,2015,Florida International,CUSA,9,30,4,10,1,2,3,8,2,2,0,4,4,0,1,1,1,3,13
19658,Kwai Pearson,2012,2012,Cal State Bakersfield,Ind,18,58,5,10,4,9,1,1,2,4,1,3,4,3,5,0,6,4,13
19659,Nick Pendergast,2012,2015,Temple,Total,30,52,6,14,5,8,1,6,0,2,3,8,11,1,0,2,3,10,13
19660,Christian Popoola,2018,2018,Utah,Pac-12,17,99,4,17,4,12,0,5,5,6,0,13,13,2,2,0,8,13,13
19661,Blake Provost,2013,2014,Texas-Rio Grande Valley,Total,25,146,4,19,2,6,2,13,3,4,0,11,11,6,7,0,9,12,13
19662,Eric Puls,2009,2010,Michigan,Big Ten,13,26,5,9,2,4,3,5,0,0,2,1,3,0,0,2,1,4,13
19663,Justin Rake,2010,2011,Louisiana Tech,WAC,14,49,5,14,2,5,3,9,0,0,2,8,10,1,1,0,3,3,13
19664,C.J. Reid,2009,2009,Saint Peter's,MAAC,14,113,5,17,4,12,1,5,2,8,4,8,12,4,3,4,12,18,13
19665,Renardo Rhone,2009,2009,Oral Roberts,Summit,6,13,6,9,6,8,0,1,1,1,4,0,4,1,0,0,1,0,13
19666,Zack Riggins,2010,2010,North Florida,A-Sun,6,77,6,12,6,11,0,1,1,4,3,6,9,1,1,1,7,7,13
19667,Lorenzo Riley,2009,2009,North Dakota State,Summit,12,45,4,12,4,11,0,1,5,7,5,8,13,0,0,5,4,8,13
19668,Nick Rivers,2010,2012,Pittsburgh,Big East,24,41,4,19,1,9,3,10,2,4,0,4,4,6,1,0,5,2,13
19669,Khalid Robinson,2011,2014,Fordham,A-10,40,162,3,13,3,11,0,2,7,12,7,11,18,2,0,1,15,24,13
19670,Robbie Robinson,2010,2010,Cal State Fullerton,Big West,7,45,6,16,5,8,1,8,0,0,6,2,8,6,1,0,4,9,13
19671,Desmond Ross,2014,2014,Long Beach State,Big West,15,69,5,17,4,10,1,7,2,3,4,6,10,2,0,1,3,7,13
19672,Torres Roundtree,2009,2009,Southern Illinois,MVC,11,130,3,12,3,12,0,0,7,14,6,13,19,9,2,0,13,22,13
19673,Bas Rozendaal,2008,2008,Robert Morris,NEC,10,40,6,8,6,8,0,0,1,4,2,4,6,2,0,3,4,11,13
19674,Ibrahima Sankare,2018,2018,Grand Canyon,WAC,9,34,4,8,4,8,0,0,5,7,2,6,8,1,5,1,3,4,13
19675,Daniel Schreier,2019,2019,Manhattan,MAAC,17,99,5,9,2,2,3,7,0,0,3,8,11,3,0,2,6,9,13
19676,Ed Seay,2015,2015,Texas State,Sun Belt,9,45,6,13,6,11,0,2,1,2,1,6,7,2,0,3,4,5,13
19677,Steven Silva,2008,2009,Texas-Rio Grande Valley,Ind,12,18,4,14,1,5,3,9,2,4,3,1,4,2,0,0,1,4,13
19678,Dustin Sitzmann,2008,2009,Creighton,MVC,24,58,5,17,4,12,1,5,2,5,1,6,7,3,1,0,6,5,13
19679,Maverick Smith,2018,2019,Tennessee Tech,OVC,18,46,4,9,1,4,3,5,2,2,3,4,7,1,3,0,1,3,13
19680,Peyton Smith,2018,2019,Texas A&M-Corpus Christi,Southland,23,119,4,16,2,6,2,10,3,6,2,9,11,10,3,0,6,12,13
19681,Reggie Sonnier,2011,2011,Little Rock,Sun Belt,5,36,6,19,5,12,1,7,0,0,3,5,8,5,3,0,2,6,13
19682,Aaron Spivey,2017,2019,Wake Forest,ACC,24,36,4,11,3,5,1,6,4,7,1,4,5,3,2,0,1,2,13
19683,Adam Sweeney,2013,2015,Gardner-Webb,Big South,19,62,5,23,4,13,1,10,2,2,2,3,5,4,1,0,3,3,13
19684,Joseph Tecklenburg,2009,2012,Wofford,Southern,35,68,6,17,6,13,0,4,1,3,3,7,10,4,3,1,8,7,13
19685,Therone Tillett,2014,2014,San Diego,WCC,5,8,5,6,2,2,3,4,0,0,0,0,0,0,0,0,0,1,13
19686,Tyler Tucker,2008,2008,Pepperdine,WCC,20,99,5,18,5,13,0,5,3,4,4,6,10,7,4,0,8,14,13
19687,Terrence Turner,2010,2012,Total,Total,10,58,5,12,5,12,0,0,3,6,4,3,7,3,2,0,8,7,13
19688,Aaron Tyser,2013,2014,Wyoming,MWC,14,18,5,7,2,3,3,4,0,0,0,9,9,1,0,0,2,0,13
19689,Okey Ukah,2014,2016,Iowa,Big Ten,27,71,6,13,6,13,0,0,1,4,5,10,15,1,4,2,3,8,13
19690,Alex Veit,2008,2008,Hawaii,WAC,17,71,5,14,4,12,1,2,2,3,2,13,15,4,0,1,3,8,13
19691,Rob Vozenilek,2012,2015,Virginia,ACC,30,68,5,15,3,10,2,5,1,3,1,5,6,5,1,1,4,3,13
19692,Jared Walker,2015,2015,Wichita State,MVC,11,37,4,8,1,3,3,5,2,2,1,5,6,3,0,0,2,5,13
19693,Youry White,2019,2019,Louisiana-Monroe,Sun Belt,13,98,6,15,6,15,0,0,1,3,4,16,20,3,2,0,7,18,13
19694,Robert Wilder,2008,2010,South Carolina,SEC,48,225,4,12,2,5,2,7,3,7,2,5,7,11,6,0,14,34,13
19695,Josh Williams,2016,2016,Rider,MAAC,9,41,5,15,5,12,0,3,3,7,1,9,10,1,1,2,5,5,13
19696,Cedric Wright,2018,2018,Morehead State,OVC,4,36,6,9,6,9,0,0,1,3,4,4,8,0,1,0,4,13,13
19697,Marcus Wynne,2008,2008,Texas Southern,SWAC,10,72,3,9,0,1,3,8,4,6,1,2,3,5,2,0,5,2,13
19698,Tyler Adams,2012,2015,Georgetown,Big East,5,24,5,10,5,10,0,0,2,2,4,5,9,1,0,3,2,7,12
19699,Niwayo Adjei,2013,2013,Coppin State,MEAC,10,38,2,14,2,10,0,4,8,10,0,1,1,2,0,0,6,7,12
19700,Vicktor Arnick,2014,2014,Texas Southern,SWAC,16,70,5,13,3,7,2,6,0,2,6,6,12,1,1,1,5,7,12
19701,Norris Arnold,2008,2008,Alabama A&M,SWAC,17,109,3,12,3,12,0,0,6,9,6,14,20,3,5,5,8,17,12
19702,Aaron Asp,2011,2012,Houston Baptist,GWC,26,83,1,20,1,12,0,8,10,14,4,7,11,3,1,0,8,15,12
19703,Deon Baker,2017,2017,Saint Francis (PA),NEC,8,19,5,9,5,9,0,0,2,2,0,3,3,1,2,0,1,0,12
19704,Matt Banas,2013,2016,Bucknell,Patriot,22,68,5,12,5,11,0,1,2,5,8,3,11,2,2,0,2,11,12
19705,Nicholas Barnes,2016,2016,Alabama State,SWAC,8,57,4,13,0,2,4,11,0,2,2,0,2,0,1,0,3,6,12
19706,Kory Barnett,2009,2012,Indiana,Big Ten,49,99,4,19,2,5,2,14,2,8,2,9,11,3,2,1,4,5,12
19707,Brayden Bell,2008,2008,Utah State,WAC,7,44,5,18,5,16,0,2,2,3,2,9,11,0,0,1,1,6,12
19708,Marley Biyendolo,2015,2015,Pepperdine,WCC,21,102,5,14,4,11,1,3,1,4,1,5,6,9,5,1,12,13,12
19709,Tre Bowman,2011,2011,Penn State,Big Ten,16,64,4,13,3,10,1,3,3,8,1,5,6,1,1,1,5,8,12
19710,Aaron Brandt,2008,2008,Creighton,MVC,9,43,5,13,4,11,1,2,1,2,4,3,7,4,0,0,4,4,12
19711,Wes Brewer,2013,2016,Elon,Total,14,33,6,9,6,9,0,0,0,2,1,11,12,1,0,0,8,7,12
19712,Sheldon Brogdon,2011,2011,Youngstown State,Horizon,4,45,4,17,1,4,3,13,1,2,2,3,5,2,2,0,2,1,12
19713,Chris Brown,2011,2011,Oregon State,Pac-10,15,38,5,16,5,16,0,0,2,7,4,7,11,0,0,0,4,8,12
19714,Chase Buford,2008,2010,Kansas,Big 12,35,59,4,16,4,9,0,7,4,7,7,9,16,2,3,1,4,10,12
19715,Elliott Bullock,2009,2010,Stanford,Pac-10,37,290,4,26,4,22,0,4,4,9,20,23,43,11,11,0,14,48,12
19716,Morris Cain,2008,2009,Wisconsin,Big Ten,18,31,5,7,5,7,0,0,2,2,0,6,6,1,0,0,2,2,12
19717,Jordan Campbell,2019,2019,Oregon State,Pac-12,6,21,5,8,4,5,1,3,1,2,1,2,3,2,1,0,2,1,12
19718,Marshall Carrell,2008,2011,Texas A&M,Big 12,24,41,4,12,4,11,0,1,4,5,3,0,3,2,0,2,2,2,12
19719,Tim Carroll,2008,2010,Akron,MAC,33,117,6,17,6,12,0,5,0,2,4,13,17,4,3,2,8,7,12
19720,Aaron Cheatum,2015,2015,Washington State,Pac-12,16,92,4,14,4,13,0,1,4,15,7,11,18,3,4,2,4,13,12
19721,Matt Chism,2018,2019,Georgia State,Sun Belt,21,31,5,8,4,7,1,1,1,4,1,4,5,2,2,0,2,1,12
19722,Shawn Christian Jr.,2018,2018,Cleveland State,Horizon,11,45,4,18,0,3,4,15,0,0,1,2,3,1,1,0,0,4,12
19723,Matthew Cioce,2017,2018,Stetson,A-Sun,11,21,4,9,2,2,2,7,2,5,1,1,2,1,1,0,3,0,12
19724,Spencer Clayton,2013,2013,UC-Davis,Big West,12,76,4,11,4,11,0,0,4,5,6,10,16,1,1,0,7,10,12
19725,Jordan Coblin,2018,2018,Purdue-Fort Wayne,Summit,7,25,4,7,3,5,1,2,3,3,0,2,2,2,1,0,2,6,12
19726,Thomas Cooper,2011,2011,North Carolina A&T,MEAC,9,37,3,14,2,8,1,6,5,9,3,3,6,0,0,0,4,1,12
19727,Rafael Crescencio,2010,2010,San Diego,WCC,21,109,4,21,4,21,0,0,4,5,10,7,17,3,3,3,14,22,12
19728,Nick Cunningham,2016,2016,Siena,MAAC,10,15,1,2,1,2,0,0,10,12,1,0,1,2,1,0,2,2,12
19729,Bennett Davis,2016,2016,Mississippi Valley State,SWAC,10,43,6,7,6,7,0,0,0,2,5,4,9,0,0,0,5,9,12
19730,Myles Davis,2015,2015,Central Florida,AAC,18,73,5,10,3,4,2,6,0,1,0,6,6,4,4,3,4,16,12
19731,Kobe Dickson,2019,2019,Cornell,Ivy,12,48,6,12,6,11,0,1,0,2,4,11,15,2,0,0,1,10,12
19732,Dino Dogan,2008,2008,Citadel,Southern,24,85,4,8,4,8,0,0,4,8,6,18,24,1,0,5,5,8,12
19733,Johannes Dolven,2017,2017,Drake,MVC,9,27,6,14,6,14,0,0,0,2,3,3,6,1,0,0,3,6,12
19734,Gabriel Dos Santos,2013,2015,Total,Total,8,36,5,11,4,10,1,1,1,4,2,2,4,3,0,0,5,4,12
19735,Brooks Doyle,2013,2015,Georgia Tech,ACC,19,72,4,15,2,5,2,10,2,4,0,7,7,3,0,0,3,11,12
19736,Trevor Dunbar,2015,2015,Washington State,Pac-12,16,157,5,22,3,16,2,6,0,2,1,6,7,24,4,0,17,12,12
19737,Drew Eisinger,2009,2009,Idaho,WAC,20,81,4,13,3,6,1,7,3,4,0,9,9,7,2,1,2,7,12
19738,Ali Farhat,2014,2014,Eastern Michigan,MAC,12,29,5,17,4,10,1,7,1,2,2,4,6,2,3,1,0,3,12
19739,Mohamed Farih,2012,2015,Saint Peter's,MAAC,11,18,4,6,4,6,0,0,4,6,1,1,2,0,0,0,6,4,12
19740,Reed Farley,2018,2018,Harvard,Ivy,10,101,4,24,0,4,4,20,0,0,8,5,13,4,4,0,4,11,12
19741,Andrew Fava,2018,2019,Florida,SEC,12,20,5,10,4,5,1,5,1,2,0,2,2,2,0,0,3,2,12
19742,Ben Felix,2009,2011,Northeastern,CAA,28,113,5,23,5,23,0,0,2,4,5,4,9,0,0,1,3,14,12
19743,Colin Ferguson,2013,2013,Southeast Missouri State,OVC,13,63,6,13,6,13,0,0,0,0,1,4,5,0,2,0,2,20,12
19744,Sam Frayer,2015,2018,Ohio,MAC,36,52,5,20,4,11,1,9,1,4,6,17,23,1,0,1,4,3,12
19745,Kelvin Gaines,2014,2014,North Texas,CUSA,19,142,6,15,6,15,0,0,0,4,10,19,29,1,4,9,9,44,12
19746,Andre Gowins,2011,2012,South Alabama,Sun Belt,13,46,4,13,4,13,0,0,4,5,4,2,6,0,3,0,4,6,12
19747,Bryson Graham,2008,2009,Texas A&M,Big 12,18,35,3,11,1,2,2,9,4,6,1,1,2,1,0,0,7,7,12
19748,Nick Greely,2018,2018,Campbell,Big South,3,15,4,6,4,6,0,0,4,5,2,0,2,2,1,0,1,3,12
19749,Jay Green,2018,2018,Nevada-Las Vegas,MWC,15,62,5,14,4,9,1,5,1,2,3,1,4,3,1,0,5,12,12
19750,John Green,2010,2011,Ball State,MAC,15,132,5,18,3,9,2,9,0,0,1,9,10,8,5,1,10,14,12
19751,Michael Harper,2013,2014,Hawaii,Big West,21,70,4,11,1,4,3,7,1,2,2,5,7,1,4,1,5,12,12
19752,Javonni Harrell,2018,2018,Florida A&M,MEAC,13,99,5,17,5,16,0,1,2,6,10,11,21,6,5,1,3,14,12
19753,William Harrison,2011,2011,Quinnipiac,NEC,20,76,4,19,3,14,1,5,3,4,7,16,23,4,0,0,5,15,12
19754,Chris Heine,2012,2014,Northern Arizona,Big Sky,29,56,4,12,3,4,1,8,3,4,1,3,4,3,4,0,8,2,12
19755,Rodney Herenton,2017,2019,Stanford,Pac-12,17,26,5,12,5,10,0,2,2,4,0,2,2,0,1,0,2,0,12
19756,Brent Hibbitts,2017,2018,Michigan,Big Ten,16,37,4,7,2,4,2,3,2,2,4,3,7,3,0,1,3,4,12
19757,Paul Hiepler,2018,2019,Abilene Christian,Southland,19,34,4,9,2,3,2,6,2,3,2,4,6,1,2,0,2,4,12
19758,Breyon Jackson,2019,2019,Long Beach State,Big West,8,63,2,9,2,9,0,0,8,12,6,8,14,1,1,1,6,11,12
19759,Jake Johnson,2015,2016,Pepperdine,WCC,22,101,4,7,4,7,0,0,4,11,3,9,12,3,0,3,3,30,12
19760,Kenjuan Johnson-Alls,2019,2019,Canisius,MAAC,7,95,3,13,1,6,2,7,4,8,2,15,17,0,3,4,7,14,12
19761,Lucas Jones,2009,2009,Southern Utah,Summit,11,53,6,11,6,11,0,0,0,0,4,8,12,1,3,0,5,13,12
19762,Janeau Joubert,2017,2017,Central Michigan,MAC,12,31,3,12,3,9,0,3,6,8,2,3,5,2,2,0,0,2,12
19763,Matt Karn,2010,2011,Nebraska,Big 12,18,53,4,11,0,0,4,11,0,0,0,2,2,3,1,0,3,3,12
19764,Ryan Keenan,2010,2012,Wake Forest,ACC,28,54,4,12,0,4,4,8,0,0,3,8,11,4,0,0,3,4,12
19765,Erkam Kiris,2017,2017,Texas-Arlington,Sun Belt,17,49,6,7,6,7,0,0,0,2,4,12,16,2,0,2,1,11,12
19766,Tyler Kleckner,2008,2008,Radford,Big South,11,35,6,8,6,8,0,0,0,0,2,8,10,0,0,2,1,7,12
19767,Mark Krebs,2008,2010,Kentucky,SEC,33,72,4,22,0,2,4,20,0,2,0,7,7,3,1,2,3,3,12
19768,Jake Kreuser,2011,2011,Lafayette,Patriot,19,111,5,18,5,18,0,0,2,5,5,12,17,1,4,5,10,21,12
19769,Garen Lafser,2008,2011,Liberty,Big South,18,39,4,13,4,5,0,8,4,4,1,5,6,2,0,0,1,7,12
19770,Chandler Levingston Simon,2014,2017,Total,Total,27,75,6,14,6,14,0,0,0,0,6,11,17,3,3,0,1,21,12
19771,Aaron Liberman,2014,2015,Total,Total,23,54,6,8,6,8,0,0,0,2,4,6,10,2,1,3,2,10,12
19772,Glorind Lisha,2016,2017,Loyola (IL),MVC,18,42,3,13,2,6,1,7,5,9,2,1,3,0,3,0,3,3,12
19773,Papa Lo,2008,2011,Total,Total,37,174,6,13,6,13,0,0,0,3,14,13,27,3,2,34,12,27,12
19774,Ben Loewen,2010,2011,Washington State,Pac-10,17,67,5,15,3,10,2,5,0,0,1,1,2,2,1,0,1,6,12
19775,Taylor Luczak,2009,2012,Mississippi State,SEC,39,51,4,11,3,7,1,4,3,4,1,7,8,0,1,0,7,7,12
19776,Luke Major,2019,2019,Oklahoma State,Big 12,13,44,5,8,3,3,2,5,0,4,1,3,4,3,0,1,1,1,12
19777,James Manor,2013,2014,North Carolina,ACC,20,30,5,17,3,9,2,8,0,0,2,3,5,1,1,1,0,2,12
19778,Derrick Martin,2012,2013,Duquesne,A-10,23,112,5,13,5,12,0,1,2,3,7,18,25,6,5,14,9,25,12
19779,Marcus Martin,2008,2008,Centenary (LA),Summit,3,,5,12,5,10,0,2,2,2,,,13,1,1,1,5,,12
19780,Jamie Mauch,2013,2013,North Dakota State,Summit,9,33,3,16,0,3,3,13,3,4,0,10,10,1,1,0,2,4,12
19781,Christian McCoggle,2014,2016,Texas Southern,SWAC,22,128,3,13,3,13,0,0,6,14,17,19,36,2,1,5,3,18,12
19782,Curtis McRoy,2015,2017,Delaware,CAA,44,249,4,20,0,2,4,18,0,0,0,21,21,13,8,0,7,28,12
19783,Demarcus Mitchell,2019,2019,Tennessee State,OVC,3,16,4,7,4,7,0,0,4,6,5,3,8,0,0,2,1,5,12
19784,Jelani Mofford,2016,2017,North Carolina-Greensboro,Southern,10,25,5,9,3,5,2,4,0,0,0,1,1,2,2,0,1,4,12
19785,Whit Moreman,2017,2018,Troy,Sun Belt,16,28,5,12,5,12,0,0,2,5,2,3,5,1,0,1,2,1,12
19786,Matt Morris,2008,2008,Clemson,ACC,16,58,5,12,3,6,2,6,0,1,1,6,7,7,2,0,5,2,12
19787,Robbie Myers,2008,2010,Rider,MAAC,35,116,3,18,2,16,1,2,5,8,10,16,26,3,2,1,8,23,12
19788,Joe Nardi,2011,2011,Hartford,AEC,20,109,5,26,3,4,2,22,0,0,5,4,9,4,2,0,2,4,12
19789,Jake Ness,2013,2015,Boise State,MWC,48,188,2,9,2,7,0,2,8,10,10,18,28,3,5,4,5,24,12
19790,Dean Noll,2019,2019,Cornell,Ivy,14,82,4,17,2,8,2,9,2,3,0,9,9,8,5,1,9,8,12
19791,Daniel Nyman,2018,2018,Utah Valley,WAC,13,51,3,9,1,3,2,6,4,4,0,4,4,2,2,0,2,1,12
19792,Justin Omogun,2013,2013,Cal State Bakersfield,Ind,13,52,5,9,5,9,0,0,2,3,5,6,11,0,0,0,2,9,12
19793,Tracy Parks,2009,2009,South Alabama,Sun Belt,10,23,4,10,2,3,2,7,2,2,0,0,0,1,0,0,3,3,12
19794,Jerrod Patton,2015,2015,Fresno State,MWC,9,27,6,8,6,8,0,0,0,1,1,7,8,1,1,1,2,1,12
19795,Josh Peterson,2017,2019,Coastal Carolina,Sun Belt,17,66,5,11,5,11,0,0,2,7,0,6,6,9,2,1,5,8,12
19796,Alex Pickert,2010,2012,Denver,Sun Belt,20,40,5,10,4,8,1,2,1,3,0,1,1,1,2,0,5,5,12
19797,Christian Pino,2015,2017,Buffalo,MAC,28,50,3,20,3,11,0,9,6,8,0,4,4,6,2,1,8,9,12
19798,Kenny Pittman,2019,2019,Oakland,Horizon,23,110,2,11,0,2,2,9,6,6,3,7,10,8,2,0,8,13,12
19799,Aleksa Popovic,2019,2019,Cleveland State,Horizon,12,64,5,13,4,8,1,5,1,2,4,9,13,1,0,1,5,14,12
19800,A.J. Price,2013,2013,Texas-San Antonio,WAC,15,150,4,12,0,2,4,10,0,0,2,3,5,7,3,0,17,13,12
19801,Robert Puleikis,2013,2014,Drake,MVC,9,23,5,6,5,6,0,0,2,5,3,2,5,0,1,0,0,3,12
19802,Peter Rehnquist,2010,2012,Boston College,ACC,24,41,6,14,6,12,0,2,0,0,2,5,7,2,0,1,4,5,12
19803,Scott Renkin,2009,2009,James Madison,CAA,16,63,3,13,3,7,0,6,6,6,2,9,11,6,4,0,3,14,12
19804,Troy Rike,2015,2018,Wake Forest,ACC,23,31,5,11,4,8,1,3,1,3,2,10,12,2,0,0,2,2,12
19805,Juan Ramon Rivas,2015,2015,Missouri-Kansas City,WAC,8,57,4,19,3,12,1,7,3,3,4,2,6,2,2,0,4,3,12
19806,KC Rodenburg,2011,2011,South Dakota,GWC,9,17,4,11,0,2,4,9,0,0,0,3,3,2,0,0,1,1,12
19807,Christian Romine,2016,2016,Texas-El Paso,CUSA,14,50,5,10,5,10,0,0,2,4,2,3,5,0,0,0,8,11,12
19808,Seth Rouse,2016,2018,Robert Morris,NEC,11,37,4,9,2,7,2,2,2,2,5,3,8,0,1,0,0,5,12
19809,Evan Salzano,2010,2011,East Carolina,CUSA,15,19,5,12,5,10,0,2,2,2,0,1,1,2,0,0,3,1,12
19810,Terrell Scruggs,2016,2017,Texas-San Antonio,CUSA,16,82,4,14,4,10,0,4,4,10,4,11,15,3,4,0,11,12,12
19811,Derek Sebastian,2010,2012,Creighton,MVC,25,51,5,9,5,9,0,0,2,6,4,3,7,4,1,0,3,6,12
19812,Rob Sikes,2008,2008,North Carolina-Wilmington,CAA,11,53,3,6,3,6,0,0,6,9,3,3,6,0,0,0,2,8,12
19813,Tre Smith,2008,2010,Utah,MWC,18,55,4,12,1,4,3,8,1,4,0,2,2,8,2,0,4,11,12
19814,Alex Sokol,2018,2019,Cal State Northridge,Big West,14,84,3,24,0,4,3,20,3,4,0,4,4,5,2,0,3,8,12
19815,Josh Sparks,2010,2010,Jacksonville,A-Sun,12,63,3,9,3,9,0,0,6,8,3,6,9,4,4,4,7,16,12
19816,Nikola Stojiljkovic,2010,2010,San Francisco,WCC,15,98,3,26,2,13,1,13,5,8,9,13,22,8,2,1,7,6,12
19817,Chris Summers,2009,2009,Liberty,Big South,7,28,5,8,4,6,1,2,1,2,2,3,5,1,1,0,3,3,12
19818,D.J. Suter,2014,2016,Georgia Southern,Total,10,31,5,11,3,4,2,7,0,0,1,4,5,1,0,2,0,3,12
19819,Cheick Sy-Savane,2017,2018,Grand Canyon,WAC,8,18,4,13,0,5,4,8,0,0,1,0,1,0,0,0,1,4,12
19820,Fabrice Tafo,2008,2008,Hartford,AEC,2,34,4,7,4,7,0,0,4,5,1,3,4,0,0,0,2,4,12
19821,Jeremiah Taylor,2017,2018,Louisiana Tech,CUSA,22,62,4,16,1,4,3,12,1,2,2,7,9,3,1,0,2,8,12
19822,Larry Taylor,2013,2013,Liberty,Big South,27,127,5,14,5,9,0,5,2,8,2,7,9,12,6,4,15,16,12
19823,Denzel Tchougang,2019,2019,Siena,MAAC,20,112,4,16,4,16,0,0,4,5,4,12,16,1,1,3,8,20,12
19824,Drake Thomas,2013,2014,Southern Utah,Big Sky,37,198,5,25,4,19,1,6,1,6,2,9,11,22,2,0,14,28,12
19825,Will Thomas,2008,2009,West Virginia,Big East,36,107,4,14,4,13,0,1,4,7,6,8,14,6,3,3,13,19,12
19826,Donell Tuff,2014,2014,Gardner-Webb,Big South,7,40,6,11,6,10,0,1,0,6,4,2,6,0,0,1,1,4,12
19827,Ran Tut,2017,2017,South Carolina,SEC,12,73,6,15,6,14,0,1,0,0,4,11,15,2,3,3,1,3,12
19828,Mike VanKirk,2013,2014,San Jose State,Total,20,65,4,9,4,9,0,0,4,7,5,8,13,0,3,2,3,7,12
19829,Sergej Vucetic,2013,2014,Nebraska,Big Ten,18,34,6,8,6,8,0,0,0,5,2,4,6,0,0,1,0,1,12
19830,Tom Ward,2009,2009,St. Francis (NY),NEC,7,37,5,13,3,4,2,9,0,0,0,2,2,4,1,0,1,1,12
19831,Aaron Washington,2017,2017,Citadel,Southern,4,20,4,9,2,5,2,4,2,4,0,3,3,2,2,0,1,4,12
19832,Dion Watson,2014,2014,Grambling,SWAC,14,46,4,23,3,11,1,12,3,4,4,2,6,1,2,0,1,4,12
19833,Sean Watson,2009,2009,Binghamton,AEC,2,54,4,17,4,12,0,5,4,8,3,5,8,0,4,0,2,3,12
19834,Blake Williams,2014,2014,Fresno State,MWC,13,30,5,9,3,3,2,6,0,2,2,6,8,1,0,0,3,1,12
19835,Jordan Williams,2019,2019,St. Francis (NY),NEC,10,82,3,15,2,4,1,11,5,6,3,15,18,4,5,1,4,8,12
19836,Trevor Williams,2011,2013,Colorado State,MWC,17,103,5,14,5,14,0,0,2,6,7,10,17,1,0,2,8,17,12
19837,J.D. Wise,2010,2013,Wisconsin,Big Ten,17,26,4,6,2,4,2,2,2,2,0,3,3,0,1,0,3,2,12
19838,Jahmar Young Jr.,2019,2019,Southern Methodist,AAC,22,91,4,9,4,9,0,0,4,8,6,15,21,1,2,8,7,13,12
19839,Tyler Young,2010,2010,Boise State,WAC,10,24,3,7,3,7,0,0,6,8,1,7,8,1,0,0,1,1,12
19840,Stefan Zecevic,2014,2014,Bradley,MVC,22,78,5,12,5,11,0,1,2,10,4,10,14,2,0,4,8,8,12
19841,Andrew Zehnder,2008,2009,Colorado,Big 12,16,65,5,8,4,6,1,2,1,4,2,2,4,3,1,1,2,13,12
19842,Chier Ajou,2013,2015,Total,Total,18,70,3,11,2,10,1,1,4,5,5,9,14,3,1,1,4,12,11
19843,Clint Amberry,2009,2009,San Jose State,WAC,11,63,3,15,3,14,0,1,5,6,1,7,8,1,1,2,2,8,11
19844,Evan Anderson,2016,2016,Houston Baptist,Southland,7,21,3,6,2,4,1,2,4,6,2,4,6,3,0,1,4,2,11
19845,Blake Arnet,2009,2011,UCLA,Pac-10,20,35,2,5,0,0,2,5,5,6,0,3,3,0,0,0,3,2,11
19846,Chris Austin,2019,2019,Fordham,A-10,9,76,4,15,2,4,2,11,1,4,3,5,8,4,3,0,3,11,11
19847,David Bagga,2008,2009,Arizona,Pac-10,11,17,3,7,0,2,3,5,2,2,0,1,1,0,2,0,2,3,11
19848,Bitumba Baruti,2017,2017,Washington,Pac-12,17,71,4,14,4,8,0,6,3,3,4,3,7,2,2,0,5,12,11
19849,K.J. Bates,2015,2016,Chattanooga,Southern,14,46,3,12,2,7,1,5,4,7,1,11,12,3,5,0,3,2,11
19850,Hugh Baxter,2018,2019,Colgate,Patriot,15,55,5,13,4,4,1,9,0,0,2,5,7,2,1,1,5,9,11
19851,Keith Benford,2014,2014,Texas-San Antonio,CUSA,5,11,4,6,1,2,3,4,0,0,1,1,2,0,0,0,0,1,11
19852,Avery Benson,2019,2019,Texas Tech,Big 12,20,70,5,13,5,9,0,4,1,5,4,8,12,5,5,3,6,9,11
19853,Kevin Berardini,2011,2013,Illinois,Big Ten,28,33,1,1,1,1,0,0,9,12,1,4,5,3,1,0,3,8,11
19854,Steven Bjornstad,2010,2011,Washington State,Pac-10,14,37,5,7,5,7,0,0,1,5,2,2,4,0,0,3,4,4,11
19855,Jamell Bradley,2017,2018,Texas A&M-Corpus Christi,Southland,16,55,3,11,2,7,1,4,4,5,2,11,13,2,1,0,2,8,11
19856,Jeb Brannen,2009,2010,Georgia Southern,Southern,29,169,4,16,4,12,0,4,3,7,5,13,18,9,8,1,10,17,11
19857,Pierce Brooks,2008,2008,San Francisco,WCC,21,138,3,19,1,3,2,16,3,4,5,10,15,2,2,0,3,22,11
19858,Dylan Brossman,2013,2014,Boston University,Total,18,39,3,13,0,3,3,10,2,2,0,4,4,2,2,0,1,2,11
19859,Cannon Broussard,2018,2018,Lamar,Southland,5,15,3,9,0,3,3,6,2,2,0,0,0,0,1,0,1,1,11
19860,Alvin Brown,2010,2010,James Madison,CAA,12,52,3,10,3,10,0,0,5,10,8,6,14,0,0,12,2,13,11
19861,Mac Brydon,2018,2018,Mercer,Southern,13,37,3,4,3,4,0,0,5,7,3,4,7,1,0,1,1,3,11
19862,Brad Calipari,2017,2018,Kentucky,SEC,27,73,3,20,0,1,3,19,2,5,1,4,5,2,0,1,4,3,11
19863,Jose Campo,2016,2016,New Mexico State,WAC,12,48,5,7,5,7,0,0,1,4,5,5,10,2,1,0,3,11,11
19864,Quinn Cannington,2008,2010,Tennessee,SEC,20,33,4,9,3,7,1,2,2,2,0,0,0,4,1,0,1,0,11
19865,Jaekwon Carliyle,2018,2018,Hampton,MEAC,5,66,2,19,2,11,0,8,7,10,2,7,9,9,6,0,9,11,11
19866,Brandon Channer,2014,2014,Rider,MAAC,15,35,3,10,2,6,1,4,4,8,1,4,5,2,0,0,5,3,11
19867,Bubba Chisholm,2009,2010,Illinois,Big Ten,26,34,4,20,2,3,2,17,1,2,0,3,3,4,4,0,2,2,11
19868,Colton Christian,2011,2012,Michigan,Big Ten,46,177,5,21,5,21,0,0,1,6,16,26,42,3,2,2,11,21,11
19869,Jamelle Christian,2015,2017,Delaware State,MEAC,16,95,4,14,3,7,1,7,2,7,5,8,13,14,5,0,9,8,11
19870,Alex Christie,2019,2019,Stony Brook,AEC,20,61,5,12,5,12,0,0,1,2,7,8,15,1,1,1,7,16,11
19871,Kyle Church,2008,2010,Charlotte,A-10,24,42,3,10,1,2,2,8,3,4,0,2,2,1,0,0,6,2,11
19872,Matthew Citron,2013,2013,Presbyterian,Big South,8,30,5,8,5,8,0,0,1,5,5,5,10,0,0,1,5,3,11
19873,Kanler Coker,2016,2017,North Carolina,ACC,34,45,3,8,3,6,0,2,5,5,3,8,11,2,1,0,3,8,11
19874,Riley Court,2018,2018,Weber State,Big Sky,12,61,5,14,4,8,1,6,0,1,1,10,11,8,2,0,4,10,11
19875,Ben Cronin,2009,2010,Michigan,Big Ten,7,26,3,7,3,7,0,0,5,8,3,7,10,0,0,2,2,3,11
19876,Steven Cruz,2011,2014,Siena,MAAC,23,27,3,7,2,4,1,3,4,7,0,5,5,2,0,0,7,3,11
19877,Xavier Dade,2012,2012,Texas State,Southland,17,54,5,12,5,8,0,4,1,2,0,8,8,2,1,0,3,5,11
19878,Eric Dadika,2017,2019,Rhode Island,A-10,26,43,4,11,1,4,3,7,0,0,0,2,2,0,1,0,5,2,11
19879,Teo Davidian,2018,2018,UC-Irvine,Big West,10,16,3,12,2,9,1,3,4,6,3,2,5,3,1,0,1,1,11
19880,Jarrod Davis,2013,2013,Maryland-Eastern Shore,MEAC,8,62,4,15,2,10,2,5,1,2,1,2,3,1,2,0,9,7,11
19881,Madison Davis,2010,2012,North Carolina-Asheville,Big South,25,62,4,22,3,9,1,13,2,6,2,4,6,3,5,0,4,5,11
19882,Jake Desjardins,2017,2019,Arizona,Pac-12,17,42,2,10,2,10,0,0,7,14,4,7,11,2,2,1,3,11,11
19883,Jeremiah Dickerson,2019,2019,Cal State Bakersfield,WAC,17,69,3,6,3,5,0,1,5,10,2,0,2,7,4,0,2,11,11
19884,Alex Dorr,2010,2010,Iowa State,Big 12,17,40,4,7,4,6,0,1,3,4,6,3,9,1,0,0,2,4,11
19885,Matt Dorwart,2010,2012,Creighton,MVC,28,53,3,11,1,6,2,5,3,6,4,4,8,0,1,3,4,9,11
19886,Elishja Duplechan,2019,2019,Omaha,Summit,10,81,3,21,3,15,0,6,5,8,0,7,7,6,2,1,5,9,11
19887,Narbeh Ebrahimian,2012,2013,San Diego State,MWC,16,76,4,16,4,11,0,5,3,7,4,6,10,4,2,0,0,10,11
19888,Keith Edwards,2011,2012,Savannah State,Total,11,45,4,8,4,8,0,0,3,9,1,17,18,3,5,1,7,6,11
19889,Ben Eisenhardt,2011,2011,Cal Poly,Big West,18,82,3,12,2,5,1,7,4,7,5,3,8,2,1,3,0,13,11
19890,Craig Eubanks,2017,2018,Akron,MAC,10,59,4,10,1,2,3,8,0,0,0,8,8,2,0,2,5,1,11
19891,Patrick Farrell,2013,2016,Villanova,Big East,42,73,3,10,0,0,3,10,2,5,1,7,8,2,3,0,4,5,11
19892,Jared Fay,2013,2014,Fordham,A-10,11,32,4,9,1,3,3,6,0,2,2,5,7,0,0,1,2,1,11
19893,Carson Fields,2012,2014,Clemson,ACC,30,72,5,19,5,9,0,10,1,4,3,5,8,4,2,0,3,7,11
19894,Bryce Fluellen,2011,2011,Howard,MEAC,11,67,4,26,2,13,2,13,1,3,4,10,14,5,4,0,3,5,11
19895,Abdul Fofana,2018,2018,Missouri State,MVC,13,67,4,9,4,9,0,0,3,5,4,12,16,1,4,1,5,13,11
19896,Theo Friedman,2014,2015,Oregon,Pac-12,16,45,3,6,2,4,1,2,4,6,2,3,5,3,1,0,2,5,11
19897,Arthur Gage,2013,2014,Chicago State,Total,21,115,3,8,3,8,0,0,5,8,4,13,17,1,3,10,5,26,11
19898,Jamal Gaines,2017,2018,Bethune-Cookman,MEAC,15,52,4,23,4,16,0,7,3,4,2,2,4,1,1,1,4,6,11
19899,Josh Gentry,2012,2012,North Dakota,GWC,16,80,2,18,2,15,0,3,7,8,2,7,9,4,3,0,5,5,11
19900,Raef Gerdes,2019,2019,Grand Canyon,WAC,7,24,3,8,0,1,3,7,2,4,0,0,0,2,0,0,0,0,11
19901,Joe Gill,2008,2008,Pennsylvania,Ivy,9,29,3,4,1,1,2,3,3,5,1,2,3,2,1,0,2,2,11
19902,Jake Godino,2010,2012,Temple,A-10,15,26,4,9,2,4,2,5,1,6,0,2,2,1,1,1,2,2,11
19903,Da'Shawn Gomez,2010,2010,New Mexico State,WAC,7,57,3,9,1,1,2,8,3,4,0,7,7,3,2,0,7,6,11
19904,Dillon Graham,2013,2015,Florida,SEC,25,92,5,22,4,10,1,12,0,0,0,4,4,5,2,1,4,4,11
19905,Winston Graham,2012,2012,Norfolk State,MEAC,11,57,4,20,3,9,1,11,2,2,2,5,7,4,2,0,6,5,11
19906,Chris Grant,2008,2008,Utah,MWC,11,34,5,11,4,6,1,5,0,0,1,1,2,4,3,0,1,2,11
19907,Khadim Gueye,2017,2018,South Carolina,SEC,45,296,3,14,3,14,0,0,5,10,13,25,38,2,4,8,15,57,11
19908,Ryan Hage,2009,2012,Fordham,A-10,37,69,3,9,3,7,0,2,5,12,4,2,6,4,1,1,8,10,11
19909,Daren Hankins,2008,2009,Southeastern Louisiana,Southland,12,23,4,4,1,1,3,3,0,0,1,1,2,1,0,0,2,4,11
19910,D.J. Heath,2018,2018,Canisius,MAAC,20,104,4,17,3,7,1,10,2,5,2,6,8,4,2,0,6,13,11
19911,Ethan Henderson,2019,2019,Arkansas,SEC,12,51,5,10,5,10,0,0,1,3,3,9,12,2,3,2,3,6,11
19912,Zach Hopewell,2018,2018,Murray State,OVC,13,27,3,9,1,4,2,5,3,9,1,1,2,4,0,0,2,4,11
19913,Matt Horton,2019,2019,Western Kentucky,CUSA,10,42,3,3,3,3,0,0,5,12,2,8,10,0,1,3,4,12,11
19914,Tyrone Hughes,2014,2015,West Virginia,Big 12,15,35,4,11,3,3,1,8,2,5,1,1,2,3,1,0,3,5,11
19915,Collin Huun,2018,2018,Seattle,WAC,6,14,4,7,1,1,3,6,0,2,0,3,3,0,0,1,1,0,11
19916,Precious Ikediashi,2019,2019,Saint Francis (PA),NEC,6,28,5,10,5,10,0,0,1,3,7,4,11,0,1,0,3,6,11
19917,Paolo Ivis,2010,2011,Loyola (MD),MAAC,32,92,4,15,4,15,0,0,3,5,7,7,14,0,1,5,1,10,11
19918,Justin Jackson,2011,2011,Morgan State,MEAC,16,70,5,14,5,10,0,4,1,2,3,3,6,7,3,0,4,7,11
19919,Nino Jackson,2014,2014,Loyola Marymount,WCC,4,41,4,18,3,11,1,7,2,3,1,7,8,4,4,1,3,8,11
19920,Torey James,2019,2019,Ohio,MAC,14,67,4,22,2,7,2,15,1,3,2,7,9,5,1,0,4,9,11
19921,Josiah Jeffers,2019,2019,Radford,Big South,11,56,4,13,3,4,1,9,2,4,1,6,7,10,2,3,2,3,11
19922,Max Keenan,2013,2014,Tulane,CUSA,24,59,2,6,0,2,2,4,5,8,0,6,6,0,1,0,6,5,11
19923,Stephen Kendall,2008,2008,James Madison,CAA,13,67,4,20,1,2,3,18,0,1,1,3,4,1,1,0,2,7,11
19924,Kimani Key,2013,2013,Alabama State,SWAC,3,40,4,17,1,8,3,9,0,0,0,2,2,0,2,0,3,6,11
19925,Caid Kirven,2013,2016,Virginia,ACC,43,77,5,13,4,10,1,3,0,0,4,8,12,0,0,0,6,5,11
19926,Ibrahim Konate,2008,2008,Boston University,AEC,14,117,5,13,5,13,0,0,1,2,9,14,23,1,3,7,10,11,11
19927,Mark LaPorte,2011,2012,Central Connecticut State,NEC,19,32,3,14,1,7,2,7,3,6,1,1,2,0,0,0,1,5,11
19928,Malcolm Laws,2015,2018,Total,Total,24,61,4,20,3,12,1,8,2,7,2,4,6,0,2,0,2,5,11
19929,Brendan Leonard,2015,2017,Air Force,MWC,7,24,3,7,1,2,2,5,3,4,3,2,5,3,0,0,2,1,11
19930,Nicholas Livisay,2009,2009,Arkansas-Pine Bluff,SWAC,14,60,5,19,5,19,0,0,1,4,7,7,14,0,0,2,1,13,11
19931,Ben Mammel,2017,2017,Army,Patriot,2,10,4,7,1,2,3,5,0,0,1,2,3,1,1,0,2,1,11
19932,Connor Mannion,2018,2019,Navy,Patriot,12,44,2,10,2,4,0,6,7,7,3,10,13,0,0,1,2,4,11
19933,Jason Martin,2014,2015,Stephen F. Austin,Southland,28,50,4,11,3,4,1,7,2,2,3,4,7,2,0,0,3,3,11
19934,Victor Mbachu,2014,2016,Texas-El Paso,CUSA,12,36,2,7,2,6,0,1,7,10,0,2,2,2,1,0,2,2,11
19935,Lamine Mbodj,2016,2016,New Orleans,Southland,16,64,4,15,4,15,0,0,3,4,7,14,21,2,0,0,4,11,11
19936,Mike McCloskey,2012,2013,South Florida,Big East,19,65,4,11,2,4,2,7,1,2,0,2,2,6,3,0,5,6,11
19937,Devante McClung,2013,2013,Tennessee State,OVC,17,104,4,11,4,9,0,2,3,8,5,13,18,6,4,1,10,10,11
19938,Riley McGillan,2015,2017,Clemson,ACC,20,39,4,14,2,2,2,12,1,2,1,1,2,2,2,0,2,4,11
19939,Phillip McGloin,2015,2017,Vanderbilt,SEC,17,23,3,10,1,3,2,7,3,4,0,7,7,1,0,0,3,3,11
19940,Walt McGrory,2018,2019,Wisconsin,Big Ten,22,103,2,10,0,3,2,7,5,7,0,10,10,5,4,0,9,7,11
19941,Ryan McKeaney,2011,2012,Vermont,AEC,26,38,5,12,5,12,0,0,1,3,3,7,10,1,0,0,1,3,11
19942,Jean-Marc Melchior,2008,2008,Northwestern,Big Ten,15,57,4,10,4,9,0,1,3,5,1,3,4,3,4,1,2,9,11
19943,Corey Mendez,2015,2015,Stetson,A-Sun,9,82,3,18,0,3,3,15,2,2,0,5,5,6,0,1,8,10,11
19944,Shawn Meyer,2012,2015,Kansas State,Big 12,37,43,4,12,4,11,0,1,3,11,3,3,6,2,1,0,3,7,11
19945,Kortrijk Miles,2018,2018,New Mexico State,WAC,14,32,4,5,4,4,0,1,3,5,2,5,7,2,0,0,4,7,11
19946,Stetson Moore,2016,2016,East Tennessee State,Southern,10,36,4,12,1,2,3,10,0,0,1,1,2,2,2,0,0,7,11
19947,Alex Mortensen,2012,2013,Utah,Pac-12,21,87,2,13,2,11,0,2,7,13,0,7,7,2,3,0,13,15,11
19948,Yan Moukoury,2008,2009,Houston,CUSA,17,75,4,13,3,8,1,5,2,7,6,10,16,2,4,1,2,10,11
19949,Jorddan Myrick,2012,2012,Central Michigan,MAC,15,83,4,21,3,18,1,3,2,4,3,9,12,9,1,0,8,6,11
19950,Devonte' Neal,2013,2014,Alabama State,SWAC,9,54,3,10,3,10,0,0,5,10,6,4,10,1,0,3,1,6,11
19951,Joey Nebeker,2014,2014,Boise State,MWC,10,28,3,14,2,6,1,8,4,6,1,6,7,2,1,2,4,1,11
19952,Alex Nesbitt,2012,2015,Harvard,Ivy,38,126,3,11,3,8,0,3,5,9,1,3,4,8,2,0,5,14,11
19953,Matt Nichenko,2010,2011,Centenary (LA),Summit,20,88,4,10,4,9,0,1,3,7,4,9,13,2,0,2,9,28,11
19954,Harrison Niego,2016,2016,Indiana,Big Ten,23,110,4,13,2,5,2,8,1,3,5,10,15,6,7,0,4,17,11
19955,Milos Nikolic,2010,2011,Long Island University,NEC,17,42,5,11,4,6,1,5,0,2,4,3,7,0,1,3,2,6,11
19956,David Norris,2010,2010,Sacramento State,Big Sky,4,42,5,14,4,10,1,4,0,0,1,4,5,2,3,1,1,5,11
19957,Jamal Nwaniemeka,2013,2013,Rider,MAAC,13,41,4,17,3,9,1,8,2,2,3,3,6,1,1,0,0,3,11
19958,Grant O'Brien,2013,2016,Wake Forest,ACC,29,76,4,16,3,8,1,8,2,3,2,8,10,0,0,1,0,5,11
19959,Alex Okafor,2008,2008,Princeton,Ivy,8,59,4,10,3,9,1,1,2,4,3,9,12,2,0,4,10,11,11
19960,Andrew Okorodudu,2019,2019,Savannah State,MEAC,9,26,5,5,5,5,0,0,1,2,2,6,8,0,1,4,4,9,11
19961,Ryan Okwudibonye,2013,2014,Sacramento State,Big Sky,8,28,4,8,4,8,0,0,3,3,3,6,9,0,1,0,4,4,11
19962,C.J. Oldham,2011,2012,Akron,MAC,17,53,5,12,4,9,1,3,0,0,3,4,7,4,1,1,5,9,11
19963,Andrew Panayiotou,2017,2017,Columbia,Ivy,7,33,4,9,2,4,2,5,1,1,1,2,3,3,2,0,4,5,11
19964,Myles Parker,2019,2019,Auburn,SEC,13,27,4,14,3,9,1,5,2,4,0,1,1,0,1,0,3,6,11
19965,Raynell Pascal,2008,2008,Fairleigh Dickinson,NEC,17,115,4,23,1,6,3,17,0,0,0,9,9,1,3,0,7,8,11
19966,Devon Pekas,2017,2017,North Dakota,Big Sky,11,39,3,7,0,0,3,7,2,4,1,7,8,3,1,1,2,6,11
19967,Romone Penny,2008,2008,American,Patriot,21,73,4,8,3,6,1,2,2,3,1,4,5,2,5,0,5,7,11
19968,Jonathan Perry,2008,2009,Campbell,A-Sun,15,14,3,5,0,1,3,4,2,2,0,1,1,4,0,0,1,1,11
19969,Karolis Petrukonis,2008,2010,Clemson,ACC,20,75,5,14,5,14,0,0,1,6,4,13,17,4,1,1,13,8,11
19970,Andy Poling,2010,2010,Gonzaga,WCC,6,23,4,5,4,5,0,0,3,13,2,9,11,0,0,2,2,5,11
19971,Kyle Pressley,2009,2009,Wright State,Horizon,19,125,4,18,4,18,0,0,3,4,10,15,25,2,2,5,7,13,11
19972,TeAllen Price,2009,2010,Texas Southern,SWAC,10,63,4,13,4,13,0,0,3,9,7,4,11,0,2,0,6,7,11
19973,Domnique Quarles,2009,2009,Western Carolina,Southern,4,16,5,9,4,7,1,2,0,0,2,1,3,1,2,0,0,2,11
19974,Paddy Quinn,2013,2015,Columbia,Ivy,18,36,3,4,3,3,0,1,5,6,2,2,4,1,1,0,1,6,11
19975,Andre Rafus Jr.,2019,2019,Eastern Michigan,MAC,5,44,5,11,4,4,1,7,0,0,0,4,4,0,1,1,3,3,11
19976,Chano Rashiduddin,2009,2011,Total,Total,17,76,4,13,4,13,0,0,3,13,3,7,10,3,0,0,5,22,11
19977,Zack Riddle,2012,2012,Toledo,MAC,10,29,1,5,1,5,0,0,9,12,0,0,0,1,1,0,4,5,11
19978,David Robinson,2019,2019,Alcorn State,SWAC,5,35,4,10,4,8,0,2,3,4,5,0,5,3,4,0,3,2,11
19979,Deon Rodgers,2013,2013,Texas-Arlington,WAC,23,84,4,9,4,9,0,0,3,6,5,15,20,3,1,1,9,13,11
19980,Charlie Rose,2015,2018,Iowa,Big Ten,23,39,5,10,4,5,1,5,0,0,1,3,4,4,0,0,4,4,11
19981,Vaughn Rose,2012,2012,Florida A&M,MEAC,16,107,4,9,4,9,0,0,3,8,12,10,22,0,2,1,7,25,11
19982,Ernest Rouse,2011,2011,Harvard,Ivy,16,47,2,9,1,4,1,5,6,8,1,4,5,2,0,1,3,1,11
19983,A.J. Rutter,2014,2017,Drake,MVC,9,18,4,10,1,2,3,8,0,0,1,1,2,0,0,0,2,3,11
19984,Thomas Sanchez,2016,2018,Fordham,A-10,30,66,4,12,1,5,3,7,0,0,0,0,0,0,0,0,1,2,11
19985,Ramses Sandifer,2017,2017,Louisiana-Monroe,Sun Belt,10,57,3,17,2,11,1,6,4,4,3,8,11,3,0,1,3,6,11
19986,Quincy Sarpy,2008,2008,Gardner-Webb,A-Sun,9,69,3,24,2,15,1,9,4,12,3,4,7,4,4,0,5,10,11
19987,Matt Schaffer,2017,2019,Toledo,MAC,20,36,3,12,1,3,2,9,3,4,0,4,4,2,0,0,2,2,11
19988,Nigel Shadd,2018,2019,Kansas State,Big 12,21,70,4,11,4,11,0,0,3,6,8,14,22,1,0,0,4,9,11
19989,Jake Shaper,2018,2019,Brown,Ivy,11,36,4,10,3,5,1,5,2,3,1,4,5,4,1,0,4,2,11
19990,Shamiek Sheppard,2015,2015,South Carolina,SEC,7,48,5,18,4,17,1,1,0,2,6,3,9,1,5,4,2,6,11
19991,Brendan Sherrer,2010,2012,Washington,Total,31,70,4,11,4,10,0,1,3,6,2,8,10,1,2,0,5,10,11
19992,Jamin Shumate,2010,2010,Saint Peter's,MAAC,12,85,5,9,5,9,0,0,1,4,3,7,10,0,2,0,10,15,11
19993,John Sica,2016,2017,Columbia,Ivy,17,91,4,12,3,8,1,4,2,4,5,12,17,3,2,3,3,13,11
19994,Aaron Siler,2014,2016,Total,Total,13,43,3,9,0,2,3,7,2,3,0,2,2,4,2,0,2,3,11
19995,Mario Soto,2017,2017,Eastern Washington,Big Sky,20,78,3,18,0,3,3,15,2,2,0,5,5,6,2,0,2,11,11
19996,Adrian Spellman,2011,2011,Alabama State,SWAC,7,31,5,10,5,10,0,0,1,5,2,4,6,0,0,0,1,4,11
19997,Brett Staal,2009,2011,Lipscomb,A-Sun,18,41,4,8,3,7,1,1,2,7,3,8,11,7,3,0,4,4,11
19998,Ryan Staten,2012,2015,San Diego State,MWC,20,43,5,18,5,16,0,2,1,5,3,8,11,3,2,1,1,3,11
19999,Nathan Stegelmann,2012,2012,Valparaiso,Horizon,8,29,5,9,5,9,0,0,1,1,4,2,6,0,1,4,2,4,11
20000,James Stokes,2018,2018,Alcorn State,SWAC,12,53,5,13,5,13,0,0,1,5,1,8,9,2,5,1,1,7,11
